symbol,datetime,close,high,low,open,volume,change_in_price,down_days,up_days,RSI,low_14,high_14,k_percent,r_percent,MACD,MACD_EMA,Price_Rate_Of_Change,On Balance Volume,Prediction
AAPL,2020-01-22,79.42500305175781,79.99749755859375,79.32749938964844,79.6449966430664,101832400.0,0.282501220703125,0.0,0.282501220703125,70.31381938662963,73.1875,79.99749755859375,91.59332287698857,-8.406677123011427,0.5013223345231097,0.37061763605133446,0.04785781077471096,381313600.0,1.0
AAPL,2020-01-23,79.80750274658203,79.88999938964844,78.9124984741211,79.4800033569336,104472000.0,0.38249969482421875,0.0,0.38249969482421875,72.86170120668909,73.1875,79.99749755859375,97.21006049742326,-2.789939502576742,0.5360848098922304,0.40491790421741575,0.03100476682532438,485785600.0,1.0
AAPL,2020-01-24,79.57749938964844,80.8324966430664,79.37999725341797,80.0625,146537600.0,-0.23000335693359375,0.23000335693359375,0.0,68.76669917511451,73.1875,80.8324966430664,83.58407057567275,-16.41592942432725,0.5417747311926462,0.4330820189667771,0.02571459843269075,339248000.0,-1.0
AAPL,2020-01-27,77.23750305175781,77.94249725341797,76.22000122070312,77.51499938964844,161940000.0,-2.339996337890625,2.339996337890625,0.0,41.431798122368114,74.29000091552734,80.8324966430664,45.05164785700459,-54.94835214299542,0.3945810850460134,0.4252044449864116,-0.025271262821768836,177308000.0,-1.0
AAPL,2020-01-28,79.42250061035156,79.5999984741211,78.04750061035156,78.1500015258789,162234000.0,2.18499755859375,0.0,2.18499755859375,58.9937580684424,74.29000091552734,80.8324966430664,78.44865183816927,-21.55134816183073,0.4147743804533661,0.42308016444355756,0.016022802491299393,339542000.0,1.0
AAPL,2020-01-29,81.08499908447266,81.9625015258789,80.34500122070312,81.11250305175781,216229200.0,1.6624984741210938,0.0,1.6624984741210938,67.53910637308837,76.22000122070312,81.9625015258789,84.71915725254124,-15.28084274745875,0.5318954312760269,0.445161442564994,0.04175499503087088,555771200.0,1.0
AAPL,2020-01-30,80.96749877929688,81.02249908447266,79.6875,80.13500213623047,126743200.0,-0.11750030517578125,0.11750030517578125,0.0,66.4105007741141,76.22000122070312,81.9625015258789,82.67300489848954,-17.326995101510466,0.6080884577349366,0.47812691158035514,0.027375983854067032,429028000.0,-1.0
AAPL,2020-01-31,77.37750244140625,80.66999816894531,77.07250213623047,80.23249816894531,199588400.0,-3.589996337890625,3.589996337890625,0.0,41.791237966457345,76.22000122070312,81.9625015258789,20.156746350711657,-79.84325364928834,0.42215749204137865,0.46682882118150526,-0.028927308075481495,229439600.0,-1.0
AAPL,2020-02-03,77.16500091552734,78.37249755859375,75.55500030517578,76.07499694824219,173788400.0,-0.21250152587890625,0.21250152587890625,0.0,40.7592365714208,75.55500030517578,81.9625015258789,25.12680926457771,-74.87319073542228,0.25892378245427494,0.42493871903867914,-0.024986585839157693,55651200.0,-1.0
AAPL,2020-02-04,79.7125015258789,79.91000366210938,78.40750122070312,78.82749938964844,136616400.0,2.5475006103515625,0.0,2.5475006103515625,55.84261287738032,75.55500030517578,81.9625015258789,64.88490719705088,-35.11509280294912,0.3023307581825492,0.40027151740970457,0.003619747725206235,192267600.0,1.0
AAPL,2020-02-05,80.36250305175781,81.19000244140625,79.73750305175781,80.87999725341797,118826800.0,0.6500015258789062,0.0,0.6500015258789062,58.9218081056174,75.55500030517578,81.9625015258789,75.02929115407147,-24.97070884592853,0.3771611127607457,0.3956275057549283,0.006954237209227276,311094400.0,1.0
AAPL,2020-02-06,81.30249786376953,81.30500030517578,80.06500244140625,80.64250183105469,105425600.0,0.9399948120117188,0.0,0.9399948120117188,63.20335820320884,75.55500030517578,81.9625015258789,89.69951562433023,-10.300484375669768,0.49625203294309017,0.41582872925718467,0.021676962550364776,416520000.0,1.0
AAPL,2020-02-07,80.00749969482422,80.8499984741211,79.5,80.59249877929688,117684000.0,-1.2949981689453125,1.2949981689453125,0.0,54.219962537145285,75.55500030517578,81.9625015258789,69.48885745447964,-30.511142545520357,0.49221234203622544,0.4311517628403265,0.035863363439004425,298836000.0,-1.0
AAPL,2020-02-10,80.38749694824219,80.38749694824219,78.4625015258789,78.54499816894531,109348800.0,0.37999725341796875,0.0,0.37999725341796875,56.32191630694582,75.55500030517578,81.9625015258789,75.41936359609642,-24.580636403903583,0.5102482592056248,0.4470094035359364,0.012150163120963953,408184800.0,1.0
AAPL,2020-02-11,79.90249633789062,80.9749984741211,79.67749786376953,80.9000015258789,94323200.0,-0.4850006103515625,0.4850006103515625,0.0,52.75478875561564,75.55500030517578,81.9625015258789,67.85010073299327,-32.14989926700673,0.483684441963419,0.45435862668642607,-0.014583495836882565,313861600.0,-1.0
AAPL,2020-02-12,81.80000305175781,81.80500030517578,80.36750030517578,80.36750030517578,113730400.0,1.8975067138671875,0.0,1.8975067138671875,63.2593326334393,75.55500030517578,81.9625015258789,97.46393377817785,-2.5360662218221477,0.5941182903260653,0.4823538799705419,0.01028195615539751,427592000.0,1.0
AAPL,2020-02-13,81.21749877929688,81.55500030517578,80.8375015258789,81.04750061035156,94747600.0,-0.5825042724609375,0.5825042724609375,0.0,58.64100726470042,75.55500030517578,81.9625015258789,88.37295974014222,-11.627040259857784,0.6311269545025482,0.5121453749614224,0.049626780611049526,332844400.0,-1.0
AAPL,2020-02-14,81.23750305175781,81.49500274658203,80.7125015258789,81.18499755859375,80113600.0,0.0200042724609375,0.0,0.0200042724609375,58.7603090315074,75.55500030517578,81.9625015258789,88.68516057744057,-11.314839422559428,0.654182575848651,0.5405809763945123,0.052776544909118206,412958000.0,1.0
AAPL,2020-02-18,79.75,79.9375,78.65249633789062,78.83999633789062,152531200.0,-1.4875030517578125,1.4875030517578125,0.0,47.10278070155583,75.55500030517578,81.9625015258789,65.4701349298203,-34.529865070179696,0.555133726504323,0.5434938342202064,0.0004704214947879315,260426800.0,-1.0
AAPL,2020-02-19,80.90499877929688,81.14250183105469,80.0,80.0,93984000.0,1.154998779296875,0.0,1.154998779296875,55.08596332393549,75.55500030517578,81.80500030517578,85.5999755859375,-14.400024414062502,0.556831736658765,0.5461631065602601,0.006750607645827911,354410800.0,1.0
AAPL,2020-02-20,80.07499694824219,81.1624984741211,79.55249786376953,80.65750122070312,100566000.0,-0.8300018310546875,0.8300018310546875,0.0,48.959302030612506,75.55500030517578,81.80500030517578,72.3199462890625,-27.680053710937504,0.489930999153259,0.534910979572648,-0.01509794837526568,253844800.0,-1.0
AAPL,2020-02-21,78.26249694824219,80.11250305175781,77.625,79.65499877929688,129554000.0,-1.8125,1.8125,0.0,38.24229064340355,75.55500030517578,81.80500030517578,43.3199462890625,-56.68005371093749,0.2963093047183776,0.4871712790785984,-0.021810489682068113,124290800.0,-1.0
AAPL,2020-02-24,74.54499816894531,76.04499816894531,72.30750274658203,74.31500244140625,222195200.0,-3.717498779296875,3.717498779296875,0.0,25.191967059394273,72.30750274658203,81.80500030517578,23.558789129023758,-76.44121087097624,-0.1381142677252285,0.3620735731912525,-0.07267919765008468,-97904400.0,-1.0
AAPL,2020-02-25,72.0199966430664,75.63249969482422,71.53250122070312,75.23750305175781,230673600.0,-2.5250015258789062,2.5250015258789062,0.0,19.87616604599404,71.53250122070312,81.80500030517578,4.745636075063297,-95.2543639249367,-0.6671220711344148,0.15618099155587806,-0.09865148219513453,-328578000.0,-1.0
AAPL,2020-02-26,73.1624984741211,74.47000122070312,71.625,71.63249969482422,198054800.0,1.1425018310546875,0.0,1.1425018310546875,27.82719585789411,71.53250122070312,81.80500030517578,15.867582367388893,-84.13241763261111,-0.986755729179265,-0.07245383818747965,-0.10559296155736642,-130523200.0,1.0
AAPL,2020-02-27,68.37999725341797,71.5,68.23999786376953,70.2750015258789,320605600.0,-4.782501220703125,4.782501220703125,0.0,18.81105196454736,68.23999786376953,81.80500030517578,1.0320631363920647,-98.96793686360793,-1.5896390475442246,-0.37594130556357935,-0.15806324645337777,-451128800.0,-1.0
AAPL,2020-02-28,68.33999633789062,69.60250091552734,64.09249877929688,64.31500244140625,426510000.0,-0.04000091552734375,0.04000091552734375,0.0,18.752415018366506,64.09249877929688,81.80500030517578,23.98022409419658,-76.01977590580343,-2.0463298869876496,-0.7100634342971457,-0.15876296327879458,-877638800.0,-1.0
AAPL,2020-03-02,74.70249938964844,75.36000061035156,69.43000030517578,70.56999969482422,341397200.0,6.3625030517578125,0.0,6.3625030517578125,48.31873943975528,64.09249877929688,81.80500030517578,59.90119800328478,-40.09880199671522,-1.892741675212207,-0.9466242379395906,-0.0632915437034679,-536241600.0,1.0
AAPL,2020-03-03,72.33000183105469,76.0,71.44999694824219,75.9175033569336,319475600.0,-2.37249755859375,2.37249755859375,0.0,41.7775656901138,64.09249877929688,81.80500030517578,46.50671752785671,-53.49328247214329,-1.9331666241972272,-1.143949501768075,-0.10598846891567448,-855717200.0,-1.0
AAPL,2020-03-04,75.68499755859375,75.8499984741211,73.28250122070312,74.11000061035156,219178400.0,3.3549957275390625,0.0,3.3549957275390625,52.31144536755138,64.09249877929688,81.55500030517578,66.38509816086278,-33.614901839137204,-1.6840602891367666,-1.2519790113492568,-0.05482359733945397,-636538800.0,1.0
AAPL,2020-03-05,73.2300033569336,74.88749694824219,72.85250091552734,73.87999725341797,187572800.0,-2.4549942016601562,2.4549942016601562,0.0,45.37937572878111,64.09249877929688,81.49500274658203,52.5068380666038,-47.4931619333962,-1.659435519782079,-1.3334747500858806,-0.06430274764472133,-824111600.0,-1.0
AAPL,2020-03-06,72.25749969482422,72.70500183105469,70.30750274658203,70.5,226176800.0,-0.972503662109375,0.972503662109375,0.0,42.78773849112948,64.09249877929688,81.1624984741211,47.832460817225716,-52.16753918277428,-1.6964820584126983,-1.406079374128629,-0.030686143005018485,-1050288400.0,-1.0
AAPL,2020-03-09,66.5425033569336,69.52249908447266,65.75,65.9375,286744800.0,-5.714996337890625,5.714996337890625,0.0,30.84362886501556,64.09249877929688,81.1624984741211,14.352692568469013,-85.64730743153099,-2.1497292730870186,-1.554814536584307,-0.07605517274986084,-1337033200.0,-1.0
AAPL,2020-03-10,71.33499908447266,71.61000061035156,67.34249877929688,69.28500366210938,285290000.0,4.7924957275390625,0.0,4.7924957275390625,45.55054643709241,64.09249877929688,81.1624984741211,42.42823921884295,-57.571760781157046,-2.1072835293788614,-1.665311415346641,-0.0249786356092645,-1051743200.0,1.0
AAPL,2020-03-11,68.85749816894531,70.30500030517578,67.96499633789062,69.34750366210938,255598800.0,-2.4775009155273438,2.4775009155273438,0.0,40.422912014641184,64.09249877929688,80.11250305175781,29.74405817006973,-70.25594182993026,-2.243017501618226,-1.780855209313667,0.006983049644733397,-1307342000.0,-1.0
AAPL,2020-03-12,62.057498931884766,67.5,62.0,63.98500061035156,418474000.0,-6.799999237060547,6.799999237060547,0.0,29.799295110302538,62.0,76.04499816894531,0.40939081082901574,-99.59060918917099,-2.854542218028058,-1.9955964421681591,-0.09193002257336347,-1725816000.0,-1.0
AAPL,2020-03-13,69.49250030517578,69.9800033569336,63.23749923706055,66.22250366210938,370732000.0,7.435001373291016,0.0,7.435001373291016,47.27943659775524,62.0,76.0,53.517859322684146,-46.48214067731585,-2.719486699235503,-2.1403765599525184,-0.06974330346428281,-1355084000.0,1.0
AAPL,2020-03-16,60.5525016784668,64.7699966430664,60.0,60.48749923706055,322423600.0,-8.939998626708984,8.939998626708984,0.0,35.139771423354915,60.0,76.0,3.4531354904174805,-96.54686450958252,-3.282722502714577,-2.368848357191694,-0.16283008232320073,-1677507600.0,-1.0
AAPL,2020-03-17,63.21500015258789,64.40249633789062,59.59999847412109,61.87749862670898,324056000.0,2.6624984741210938,0.0,2.6624984741210938,40.39861874990232,59.59999847412109,76.0,22.042691110500172,-77.95730888949983,-3.477581454428929,-2.590597002176689,-0.16476181288572878,-1353451600.0,1.0
AAPL,2020-03-18,61.66749954223633,62.5,59.27999877929688,59.942501068115234,300233600.0,-1.5475006103515625,1.5475006103515625,0.0,38.315218269647964,59.27999877929688,76.0,14.279309740618821,-85.72069025938119,-3.711987708283459,-2.8148767823243723,-0.15789298490592651,-1653685200.0,-1.0
AAPL,2020-03-19,61.19499969482422,63.209999084472656,60.65250015258789,61.84749984741211,271857200.0,-0.4724998474121094,0.4724998474121094,0.0,37.63150102269563,59.27999877929688,76.0,11.453353921745743,-88.54664607825426,-3.890340732573037,-3.0299708298153156,-0.15309829494131255,-1925542400.0,-1.0
AAPL,2020-03-20,57.310001373291016,62.95750045776367,57.0,61.79499816894531,401693200.0,-3.884998321533203,3.884998321533203,0.0,32.183088092159636,57.0,76.0,1.6315861752158718,-98.36841382478413,-4.291354891881255,-3.282248822083539,-0.13874593707602934,-2327235600.0,-1.0
AAPL,2020-03-23,56.09249877929688,57.125,53.15250015258789,57.02000045776367,336752800.0,-1.2175025939941335,1.2175025939941335,0.0,30.582013675580072,53.15250015258789,75.8499984741211,12.95296329604661,-87.04703670395338,-4.652388986732923,-3.5562778802778436,-0.21367492115793096,-2663988400.0,-1.0
AAPL,2020-03-24,61.720001220703125,61.92250061035156,58.57500076293945,59.09000015258789,287531200.0,5.627502441406243,0.0,5.627502441406243,45.138198786109015,53.15250015258789,74.88749694824219,39.41800014356673,-60.58199985643328,-4.438355060020832,-3.7326938442668283,-0.10365605980528048,-2376457200.0,1.0
AAPL,2020-03-25,61.380001068115234,64.5625,61.07500076293945,62.6875,303602000.0,-0.3400001525878906,0.3400001525878906,0.0,44.48787661191764,53.15250015258789,72.70500183105469,42.07901909855507,-57.92098090144493,-4.246856789393654,-3.8355266795279137,-0.010917260209167723,-2680059200.0,-1.0
AAPL,2020-03-26,64.61000061035156,64.66999816894531,61.59000015258789,61.630001068115234,252087200.0,3.229999542236328,0.0,3.229999542236328,52.05903550056542,53.15250015258789,71.61000061035156,62.07503818830664,-37.924961811693365,-3.7932594766932866,-3.8270732227673823,-0.07025937580865216,-2427972000.0,1.0
AAPL,2020-03-27,61.935001373291016,63.96749877929688,61.76250076293945,63.1875,204216800.0,-2.674999237060547,2.674999237060547,0.0,46.05650216349148,53.15250015258789,71.61000061035156,47.58228905804519,-52.41771094195481,-3.6060642328541377,-3.7828713570455714,0.022831421601130275,-2632188800.0,-1.0
AAPL,2020-03-30,63.70249938964844,63.880001068115234,62.34999847412109,62.685001373291016,167976400.0,1.7674980163574219,0.0,1.7674980163574219,50.41532403919983,53.15250015258789,70.30500030517578,61.50706394524539,-38.49293605475461,-3.2784693005830547,-3.681990822073892,0.00771176518047656,-2464212400.0,1.0
AAPL,2020-03-31,63.5724983215332,65.62249755859375,63.0,63.900001525878906,197002000.0,-0.13000106811523438,0.13000106811523438,0.0,50.07195552983345,53.15250015258789,69.9800033569336,61.922425700411374,-38.07757429958862,-2.994715308429889,-3.544535584529387,0.030891454873926527,-2661214400.0,-1.0
AAPL,2020-04-01,60.227500915527344,62.18000030517578,59.782501220703125,61.625,176218400.0,-3.3449974060058594,3.3449974060058594,0.0,41.65005268977363,53.15250015258789,69.9800033569336,42.044269295472986,-57.95573070452702,-3.0031492451407686,-3.436258231693168,-0.015810095336575403,-2837432800.0,-1.0
AAPL,2020-04-02,61.23249816894531,61.28749847412109,59.22499847412109,60.084999084472656,165934000.0,1.0049972534179688,0.0,1.0049972534179688,44.864903399740086,53.15250015258789,65.62249755859375,64.79550679349695,-35.20449320650304,-2.895865503980332,-3.328179618308556,0.06844349505603664,-2671498800.0,1.0
AAPL,2020-04-03,60.352500915527344,61.42499923706055,59.74250030517578,60.70000076293945,129880000.0,-0.8799972534179688,0.8799972534179688,0.0,42.49917341821263,53.15250015258789,65.62249755859375,57.73859070308831,-42.26140929691169,-2.848544829514964,-3.232252612378351,0.07594602181999388,-2801378800.0,-1.0
AAPL,2020-04-06,65.61750030517578,65.77749633789062,62.345001220703125,62.72499847412109,201820400.0,5.2649993896484375,0.0,5.2649993896484375,57.84453785354826,53.15250015258789,65.77749633789062,98.7327043084488,-1.2672956915511908,-2.3614101549791755,-3.0580840509289944,0.06314807205747908,-2599558400.0,1.0
AAPL,2020-04-07,64.85749816894531,67.92500305175781,64.75,67.69999694824219,202887200.0,-0.7600021362304688,0.7600021362304688,0.0,55.382796642532426,53.15250015258789,67.92500305175781,79.23503617667345,-20.76496382332655,-2.0131483363157585,-2.849096840840448,0.05665521408139096,-2802445600.0,-1.0
AAPL,2020-04-08,66.51750183105469,66.84249877929688,65.30750274658203,65.68499755859375,168895200.0,1.660003662109375,0.0,1.660003662109375,59.704713682688066,53.15250015258789,67.92500305175781,90.47215471670536,-9.527845283294639,-1.5855865750149931,-2.5963947227030935,0.029523312222311082,-2633550400.0,1.0
AAPL,2020-04-09,66.99749755859375,67.51750183105469,66.17500305175781,67.17500305175781,161834800.0,0.4799957275390625,0.0,0.4799957275390625,60.966224204077754,53.15250015258789,67.92500305175781,93.72140591547165,-6.278594084528355,-1.1944259665452535,-2.316000913797864,0.0817388564309598,-2471715600.0,1.0
AAPL,2020-04-13,68.3125,68.42500305175781,66.4574966430664,67.07749938964844,131022800.0,1.31500244140625,0.0,1.31500244140625,64.48127122562423,58.57500076293945,68.42500305175781,98.85783730339307,-1.1421626966069343,-0.7699031497801627,-2.0067813101120975,0.07236765675634826,-2340692800.0,1.0
AAPL,2020-04-14,71.76249694824219,72.0625,69.51249694824219,70.0,194994800.0,3.4499969482421875,0.0,3.4499969482421875,72.08970219661964,59.22499847412109,72.0625,97.66307290283049,-2.336927097169501,-0.154407882089572,-1.6363065757381632,0.1288292711934349,-2145698000.0,1.0
AAPL,2020-04-15,71.10749816894531,71.5824966430664,70.15750122070312,70.5999984741211,131154400.0,-0.654998779296875,0.654998779296875,0.0,68.85849431595598,59.22499847412109,72.0625,92.56084348555275,-7.43915651444726,0.2774946618272196,-1.2535462879157235,0.18064832656227603,-2276852400.0,-1.0
AAPL,2020-04-16,71.67250061035156,72.05000305175781,70.5875015258789,71.84500122070312,157125200.0,0.56500244140625,0.0,0.56500244140625,70.1884406061238,59.22499847412109,72.0625,96.96203043199453,-3.0379695680054564,0.6576198467854795,-0.8713130287723945,0.17049773818800373,-2119727200.0,1.0
AAPL,2020-04-17,70.69999694824219,71.73750305175781,69.21499633789062,71.17250061035156,215250000.0,-0.972503662109375,0.972503662109375,0.0,64.70071482040579,59.22499847412109,72.0625,89.38654029359869,-10.613459706401315,0.8705920410749428,-0.5229319913220916,0.17145099002935704,-2334977200.0,-1.0
AAPL,2020-04-20,69.23249816894531,70.41999816894531,69.2125015258789,69.48750305175781,130015200.0,-1.467498779296875,1.467498779296875,0.0,56.94822176263687,59.22499847412109,72.0625,77.95519770455542,-22.04480229544458,0.9107914988031638,-0.2361872778357962,0.05509197770346019,-2464992400.0,-1.0
AAPL,2020-04-21,67.09249877929688,69.3125,66.35749816894531,69.06999969482422,180991600.0,-2.1399993896484375,2.1399993896484375,0.0,47.39319143912854,59.22499847412109,72.0625,61.2852920742858,-38.7147079257142,0.7616468668710183,-0.036620440285935286,0.034460173047835996,-2645984000.0,-1.0
AAPL,2020-04-22,69.0250015258789,69.4749984741211,68.05000305175781,68.40249633789062,116862400.0,1.9325027465820312,0.0,1.9325027465820312,55.221620982137495,59.22499847412109,72.0625,76.3388657208893,-23.661134279110694,0.7898937155677572,0.12868239658919442,0.03769684106888027,-2529121600.0,1.0
AAPL,2020-04-23,68.75749969482422,70.4375,68.71749877929688,68.96749877929688,124814400.0,-0.2675018310546875,0.2675018310546875,0.0,53.93960050187024,59.74250030517578,72.0625,73.17369815711723,-26.82630184288277,0.7817286110714718,0.2592916430913774,0.02626966976925127,-2653936000.0,-1.0
AAPL,2020-04-24,70.74250030517578,70.75250244140625,69.25,69.30000305175781,126161200.0,1.9850006103515625,0.0,1.9850006103515625,61.57719609342639,62.345001220703125,72.0625,86.41626076005817,-13.583739239941838,0.9244309272589106,0.3923195028628826,0.03557182514438462,-2527774800.0,1.0
AAPL,2020-04-27,70.7925033569336,71.13500213623047,69.98750305175781,70.44999694824219,117087600.0,0.0500030517578125,0.0,0.0500030517578125,61.76149114720667,64.75,72.0625,82.63252453926282,-17.367475460737182,1.0296746468657005,0.5197905339156643,-0.013516720188933684,-2410687200.0,1.0
AAPL,2020-04-28,69.6449966430664,71.4574966430664,69.55000305175781,71.2699966430664,112004800.0,-1.1475067138671875,1.1475067138671875,0.0,54.80128648268739,65.30750274658203,72.0625,64.21163079362677,-35.788369206373225,1.0090187849538808,0.6176361855063339,-0.020567472679240195,-2522692000.0,-1.0
AAPL,2020-04-29,71.93250274658203,72.4175033569336,70.97250366210938,71.18250274658203,137280800.0,2.287506103515625,0.0,2.287506103515625,64.1056260762856,66.17500305175781,72.4175033569336,92.23066741463451,-7.769332585365496,1.1635049918989324,0.7268099480193709,0.0036276414805724855,-2385411200.0,1.0
AAPL,2020-04-30,73.44999694824219,73.63249969482422,72.0875015258789,72.48999786376953,183064000.0,1.5174942016601562,0.0,1.5174942016601562,68.9916036710826,66.35749816894531,73.63249969482422,97.49137170716973,-2.508628292830258,1.3921405376920006,0.8598760671576473,0.03889674849651281,-2202347200.0,1.0
AAPL,2020-05-01,72.26750183105469,74.75,71.4625015258789,71.5625,240616800.0,-1.1824951171875,1.1824951171875,0.0,61.468486423543126,66.35749816894531,74.75,70.42004614453165,-29.579953855468343,1.4612053669832363,0.9801419279931298,0.04383784699929749,-2442964000.0,-1.0
AAPL,2020-05-04,73.29000091552734,73.42250061035156,71.58000183105469,72.2925033569336,133568000.0,1.0224990844726562,0.0,1.0224990844726562,65.24923218175036,66.35749816894531,74.75,82.60352974758686,-17.396470252413135,1.580117114266315,1.1001369659424904,0.09237250436322797,-2309396000.0,1.0
AAPL,2020-05-05,74.38999938964844,75.25,73.61499786376953,73.76499938964844,147751200.0,1.0999984741210938,0.0,1.0999984741210938,69.02224597678014,66.35749816894531,75.25,90.32892400035004,-9.671075999649952,1.7429097405327951,1.2286915214559755,0.07772542912234615,-2161644800.0,1.0
AAPL,2020-05-06,75.15750122070312,75.80999755859375,74.71749877929688,75.11499786376953,142333600.0,0.7675018310546875,0.0,0.7675018310546875,71.51234139261351,66.35749816894531,75.80999755859375,93.09710256522013,-6.902897434779871,1.911740882297181,1.3653013941304035,0.09308077743206056,-2019311200.0,1.0
AAPL,2020-05-07,75.93499755859375,76.2925033569336,75.49250030517578,75.80500030517578,115215200.0,0.777496337890625,0.0,0.777496337890625,73.95908849212448,66.35749816894531,76.2925033569336,96.40155398436954,-3.5984460156304596,2.0841807164675856,1.5090772590240316,0.07339996792618408,-1904096000.0,1.0
AAPL,2020-05-08,77.53250122070312,77.5875015258789,76.07250213623047,76.41000366210938,133838400.0,1.597503662109375,0.0,1.597503662109375,78.36453537455705,66.35749816894531,77.5875015258789,99.51023785632421,-0.4897621436757909,2.3228369812973853,1.6718292038646558,0.0952077909971154,-1770257600.0,1.0
AAPL,2020-05-11,78.75250244140625,79.26249694824219,76.80999755859375,77.0250015258789,145946400.0,1.220001220703125,0.0,1.220001220703125,81.17138120897471,68.05000305175781,79.26249694824219,95.4515515322078,-4.5484484677922,2.5805744707437412,1.853578257585276,0.13077042483060497,-1624311200.0,1.0
AAPL,2020-05-12,77.85250091552734,79.92250061035156,77.72750091552734,79.4574966430664,162301200.0,-0.9000015258789062,0.9000015258789062,0.0,73.09911727390187,68.71749877929688,79.92250061035156,81.52611016013215,-18.47388983986785,2.6813566453693625,2.019133935393359,0.08229934929139682,-1786612400.0,-1.0
AAPL,2020-05-13,76.9124984741211,78.98750305175781,75.80249786376953,78.0374984741211,200622400.0,-0.94000244140625,0.94000244140625,0.0,65.27600397210747,69.25,79.92250061035156,71.79665529078554,-28.203344709214463,2.6548282393023612,2.1462727963295274,0.04714093491819771,-1987234800.0,-1.0
AAPL,2020-05-14,77.38500213623047,77.44750213623047,75.38249969482422,76.12750244140625,158929200.0,0.472503662109375,0.0,0.472503662109375,67.30540358137452,69.55000305175781,79.92250061035156,75.53628275362915,-24.46371724637084,2.6414513859048583,2.2453085143407905,0.0708133002457918,-1828305600.0,1.0
AAPL,2020-05-15,76.92749786376953,76.9749984741211,75.05249786376953,75.0875015258789,166348400.0,-0.4575042724609375,0.4575042724609375,0.0,63.18009864695702,69.55000305175781,79.92250061035156,71.12553915136252,-28.874460848637483,2.5643941366053298,2.3091256388432884,0.04963155823172527,-1994654000.0,-1.0
AAPL,2020-05-18,78.73999786376953,79.125,77.58000183105469,78.2925033569336,135178400.0,1.8125,0.0,1.8125,71.23849318194445,70.97250366210938,79.92250061035156,86.78767430401997,-13.21232569598003,2.6192925180538964,2.371159014723973,0.05847558152724508,-1859475600.0,1.0
AAPL,2020-05-19,78.28500366210938,79.62999725341797,78.25250244140625,78.75749969482422,101729600.0,-0.45499420166015625,0.45499420166015625,0.0,66.99168577693655,71.4625015258789,79.92250061035156,80.64424201596402,-19.355757984035986,2.596176489263584,2.416162509654277,0.041612645319623054,-1961205200.0,-1.0
AAPL,2020-05-20,79.80750274658203,79.87999725341797,79.12999725341797,79.16999816894531,111504800.0,1.5224990844726562,0.0,1.5224990844726562,73.16765999495843,71.4625015258789,79.92250061035156,98.64068704238282,-1.3593129576171756,2.66986547088554,2.466903101920717,0.05099763366687582,-1849700400.0,1.0
AAPL,2020-05-21,79.2125015258789,80.22250366210938,78.96749877929688,79.66500091552734,102688800.0,-0.595001220703125,0.595001220703125,0.0,67.47477636228476,71.58000183105469,80.22250366210938,88.31354443453773,-11.686455565462266,2.6497292686877785,2.503468335285768,0.021668336229647922,-1952389200.0,-1.0
AAPL,2020-05-22,79.72250366210938,79.80750274658203,78.8375015258789,78.94249725341797,81803200.0,0.5100021362304688,0.0,0.5100021362304688,69.79879425734255,73.61499786376953,80.22250366210938,92.43284810850069,-7.567151891499309,2.644419931107919,2.531658654457376,0.012317084418045354,-1870586000.0,1.0
AAPL,2020-05-26,79.18250274658203,81.05999755859375,79.125,80.875,125522000.0,-0.5400009155273438,0.5400009155273438,0.0,64.19489787564714,74.71749877929688,81.05999755859375,70.39818410150555,-29.60181589849445,2.567063498663231,2.538739623299989,0.017083610872023147,-1996108000.0,-1.0
AAPL,2020-05-27,79.52749633789062,79.67749786376953,78.27249908447266,79.03500366210938,112945200.0,0.34499359130859375,0.0,0.34499359130859375,66.19558874758104,75.05249786376953,81.05999755859375,74.49019894210804,-25.509801057891963,2.504710868560423,2.531933872350967,0.033999647855015525,-1883162800.0,1.0
AAPL,2020-05-28,79.5625,80.86000061035156,78.90750122070312,79.19249725341797,133560800.0,0.035003662109375,0.0,0.035003662109375,66.4152872387482,75.05249786376953,81.05999755859375,75.07286500765163,-24.92713499234838,2.4301052331119593,2.5115681445005102,0.02813849975653171,-1749602000.0,1.0
AAPL,2020-05-29,79.48500061035156,80.2874984741211,79.11750030517578,79.8125,153532400.0,-0.0774993896484375,0.0774993896484375,0.0,65.33060363647596,75.05249786376953,81.05999755859375,73.7828210029019,-26.217178997098102,2.337778547252327,2.4768102250472483,0.03324562500539274,-1903134400.0,-1.0
AAPL,2020-06-01,80.4625015258789,80.5875015258789,79.30249786376953,79.4375,80791200.0,0.9775009155273438,0.0,0.9775009155273438,71.98851426739188,75.05249786376953,81.05999755859375,90.05416457649396,-9.94583542350603,2.3167535040331586,2.444798880841759,0.02187584085396521,-1822343200.0,1.0
AAPL,2020-06-02,80.83499908447266,80.86000061035156,79.73249816894531,80.1875,87642800.0,0.37249755859375,0.0,0.37249755859375,74.16961963809575,75.05249786376953,81.05999755859375,96.25470685724808,-3.7452931427519163,2.3035843363194175,2.4165559719354057,0.03257322990453537,-1734700400.0,1.0
AAPL,2020-06-03,81.27999877929688,81.55000305175781,80.57499694824219,81.16500091552734,104491200.0,0.44499969482421875,0.0,0.44499969482421875,76.67329538249857,75.05249786376953,81.55000305175781,95.84449316085065,-4.155506839149361,2.3025029447059495,2.393745366488296,0.018450596523369,-1630209200.0,1.0
AAPL,2020-06-04,80.58000183105469,81.40499877929688,80.19499969482422,81.09750366210938,87560400.0,-0.6999969482421875,0.6999969482421875,0.0,65.20244753635791,75.05249786376953,81.55000305175781,85.07117435633089,-14.928825643669105,2.2195888442453082,2.358914062038211,0.017263692963023214,-1717769600.0,-1.0
AAPL,2020-06-05,82.875,82.9375,80.80750274658203,80.8375015258789,137250400.0,2.2949981689453125,0.0,2.2949981689453125,77.77876858281772,77.58000183105469,82.9375,98.83341070721627,-1.1665892927837225,2.3123674679157915,2.349604743213409,0.03954336847287143,-1580519200.0,1.0
AAPL,2020-06-08,83.36499786376953,83.4000015258789,81.83000183105469,82.5625,95654400.0,0.48999786376953125,0.0,0.48999786376953125,79.59549960696603,78.25250244140625,83.4000015258789,99.31998701631704,-0.6800129836829492,2.397784293827968,2.359240653336584,0.052820951246934866,-1484864800.0,1.0
AAPL,2020-06-09,85.99749755859375,86.40249633789062,83.00250244140625,83.03500366210938,147712400.0,2.6324996948242188,0.0,2.6324996948242188,86.45847179229712,78.27249908447266,86.40249633789062,95.01846351637317,-4.981536483626826,2.6473390013696303,2.4168603229444536,0.08135552505279242,-1337152400.0,1.0
AAPL,2020-06-10,88.20999908447266,88.69249725341797,86.52249908447266,86.9749984741211,166651600.0,2.2125015258789062,0.0,2.2125015258789062,89.78902653886708,78.27249908447266,88.69249725341797,95.36949852464178,-4.630501475358223,2.989152506359247,2.5313187596294147,0.10868812674906714,-1170500800.0,1.0
AAPL,2020-06-11,83.9749984741211,87.76499938964844,83.87000274658203,87.32749938964844,201662400.0,-4.2350006103515625,4.2350006103515625,0.0,58.18333420374778,78.27249908447266,88.69249725341797,54.72649128330539,-45.27350871669461,2.8851110085307425,2.6020772094106706,0.05648861834675234,-1372163200.0,-1.0
AAPL,2020-06-12,84.69999694824219,86.94999694824219,83.55500030517578,86.18000030517578,200146000.0,0.7249984741210938,0.0,0.7249984741210938,60.901837795134824,78.27249908447266,88.69249725341797,61.68425137468241,-38.31574862531759,2.828543248820168,2.6473704172930774,0.05266422671435822,-1172017200.0,1.0
AAPL,2020-06-15,85.74749755859375,86.41999816894531,83.1449966430664,83.3125,138808800.0,1.0475006103515625,0.0,1.0475006103515625,64.72491983347533,78.27249908447266,88.69249725341797,71.73704210811484,-28.262957891885165,2.835538288303468,2.685003991495493,0.060771924658371335,-1033208400.0,1.0
AAPL,2020-06-16,88.0199966430664,88.30000305175781,86.18000030517578,87.86499786376953,165428800.0,2.2724990844726562,0.0,2.2724990844726562,71.661321150624,78.90750122070312,88.69249725341797,93.12722654047947,-6.872773459520529,2.989962048564408,2.745995602909713,0.08292320330947511,-867779600.0,1.0
AAPL,2020-06-17,87.89749908447266,88.8499984741211,87.77249908447266,88.7874984741211,114406400.0,-0.12249755859375,0.12249755859375,0.0,70.79546988865266,79.11750030517578,88.8499984741211,90.21320761520721,-9.78679238479279,3.0671041240859154,2.810217307145322,0.09081033863414345,-982186000.0,-1.0
AAPL,2020-06-18,87.93250274658203,88.36250305175781,87.30500030517578,87.85250091552734,96820400.0,0.035003662109375,0.0,0.035003662109375,70.91135188761847,79.30249786376953,88.8499984741211,90.39019985456406,-9.609800145435948,3.09538157518665,2.8672501607538488,0.06102567416690241,-885365600.0,1.0
AAPL,2020-06-19,87.43000030517578,89.13999938964844,86.2874984741211,88.66000366210938,264476000.0,-0.50250244140625,0.50250244140625,0.0,66.53805976489836,79.73249816894531,89.13999938964844,81.82302564352099,-18.176974356479004,3.0421792017871354,2.902235968960635,0.04876150117641753,-1149841600.0,-1.0
AAPL,2020-06-22,89.71749877929688,89.86499786376953,87.7874984741211,87.83499908447266,135445200.0,2.2874984741210938,0.0,2.2874984741210938,74.72546719862284,80.19499969482422,89.86499786376953,98.4746730878777,-1.5253269121222977,3.1482878835761454,2.9514463518838814,0.04325708684916707,-1014396400.0,1.0
AAPL,2020-06-23,91.63249969482422,93.09500122070312,90.56749725341795,91.0,212155600.0,1.9150009155273438,0.0,1.9150009155273438,79.55709951947047,80.19499969482422,93.09500122070312,88.66278021018093,-11.337219789819077,3.3482926836585563,3.0308156182390023,0.038799463166007575,-802240800.0,1.0
AAPL,2020-06-24,90.01499938964844,92.19750213623048,89.62999725341797,91.25,192623200.0,-1.6175003051757812,1.6175003051757812,0.0,67.06270778033064,80.80750274658203,93.09500122070312,74.93385787561617,-25.066142124383827,3.3378131840167953,3.0922151313946764,0.07192618071185453,-994864000.0,-1.0
AAPL,2020-06-25,91.20999908447266,91.25,89.39250183105469,90.1750030517578,137522400.0,1.1949996948242188,0.0,1.1949996948242188,70.95163013794546,81.83000183105469,93.09500122070312,83.26673556713529,-16.73326443286471,3.3868847285273347,3.1511490508212963,0.07685953212263463,-857341600.0,1.0
AAPL,2020-06-26,88.40750122070312,91.33000183105467,88.25499725341797,91.10250091552734,205256800.0,-2.8024978637695312,2.8024978637695312,0.0,53.77172530925853,83.00250244140625,93.09500122070312,53.55461414951422,-46.44538585048577,3.163188620307608,3.1535569647185615,0.031021356166011982,-1062598400.0,-1.0
AAPL,2020-06-29,90.44499969482422,90.5425033569336,87.81999969482422,88.3125,130646000.0,2.0374984741210938,0.0,2.0374984741210938,61.576422869941844,83.1449966430664,93.09500122070312,73.36683108834988,-26.633168911650117,3.1144048347331506,3.1457265387214717,0.027550592413580155,-931952400.0,1.0
AAPL,2020-06-30,91.1999969482422,91.49500274658205,90.0,90.0199966430664,140223200.0,0.754997253417983,0.0,0.754997253417983,64.16328105170277,83.1449966430664,93.09500122070312,80.95473969207946,-19.045260307920543,3.1009157899466544,3.1367643889665016,0.037572148220004875,-791729200.0,1.0
AAPL,2020-07-01,91.02749633789062,91.83999633789062,90.97750091552734,91.27999877929688,110737200.0,-0.1725006103515767,0.1725006103515767,0.0,63.04432255190873,83.1449966430664,93.09500122070312,79.22106601378505,-20.778933986214955,3.041249110373329,3.1176613332478547,0.03519737861013961,-902466400.0,-1.0
AAPL,2020-07-06,93.4625015258789,93.94499969482422,92.46749877929688,92.5,118655600.0,2.4350051879882812,0.0,2.4350051879882812,72.16652830573588,86.18000030517578,93.94499969482422,93.78624331138347,-6.21375668861653,3.0565691697856323,3.0801920209949274,0.041742166216589105,-783810800.0,1.0
AAPL,2020-07-07,93.17250061035156,94.65499877929688,93.05750274658205,93.85250091552734,112424400.0,-0.29000091552734375,0.29000091552734375,0.0,69.79889401255058,86.2874984741211,94.65499877929688,82.2826637003132,-17.7173362996868,3.074385591011321,3.0790307349982053,0.0168062742002697,-896235200.0,-1.0
AAPL,2020-07-08,95.34249877929688,95.375,94.08999633789062,94.18000030517578,117092000.0,2.1699981689453125,0.0,2.1699981689453125,76.46534331796651,86.2874984741211,95.375,99.6423525144885,-0.3576474855114989,3.226406350265364,3.108505858051645,0.05918457396846999,-779143200.0,1.0
AAPL,2020-07-09,95.75250244140624,96.31749725341795,94.67250061035156,96.2624969482422,125642800.0,0.4100036621093608,0.0,0.4100036621093608,77.54589076051404,86.2874984741211,96.31749725341795,94.36695034123098,-5.63304965876902,3.341448051413309,3.155094296723987,0.04980269052219399,-653500400.0,1.0
AAPL,2020-07-10,95.91999816894533,95.9800033569336,94.70500183105467,95.33499908447266,90257200.0,0.16749572753909092,0.0,0.16749572753909092,78.02155107310725,87.7874984741211,96.31749725341795,95.33998661948935,-4.660013380510638,3.406861994699142,3.2054478363190264,0.08497578649449422,-563243200.0,1.0
AAPL,2020-07-13,95.47750091552734,99.95500183105467,95.25749969482422,97.26499938964844,191649200.0,-0.44249725341798296,0.44249725341798296,0.0,73.28900691181542,87.81999969482422,99.95500183105467,63.102594748135786,-36.89740525186421,3.383989613311698,3.2411561917175655,0.055641563797706795,-754892400.0,-1.0
AAPL,2020-07-14,97.05750274658205,97.25499725341795,93.87750244140624,94.83999633789062,170989200.0,1.5800018310547017,0.0,1.5800018310547017,78.62958204267855,87.81999969482422,99.95500183105467,76.12279707951754,-23.877202920482468,3.453541631213909,3.2836332796168377,0.06422703941167995,-583903200.0,1.0
AAPL,2020-07-15,97.7249984741211,99.24749755859376,96.48999786376952,98.98999786376952,153198000.0,0.6674957275390483,0.0,0.6674957275390483,80.52742465554597,87.81999969482422,99.95500183105467,81.62337895041941,-18.376621049580585,3.5219231518224916,3.3312912540579718,0.07357669282004187,-430705200.0,1.0
AAPL,2020-07-16,96.52249908447266,97.40499877929688,95.90499877929688,96.5625,110577600.0,-1.2024993896484375,1.2024993896484375,0.0,67.97858477889659,87.81999969482422,99.95500183105467,71.71403261369124,-28.28596738630875,3.4394390080586277,3.3529208048581047,0.06036640540111948,-541282800.0,-1.0
AAPL,2020-07-17,96.32749938964844,97.14749908447266,95.83999633789062,96.9875030517578,92186800.0,-0.19499969482421875,0.19499969482421875,0.0,66.05262668144786,87.81999969482422,99.95500183105467,70.10711328532932,-29.892886714670674,3.320063506526253,3.3463493451917343,0.030653982260214097,-633469600.0,-1.0
AAPL,2020-07-20,98.35749816894533,98.5,96.0625,96.4175033569336,90318000.0,2.029998779296889,0.0,2.029998779296889,74.67214324082607,90.0,99.95500183105467,83.95275370893528,-16.047246291064727,3.3506336525680354,3.3472062066669945,0.05564944081813894,-543151600.0,1.0
AAPL,2020-07-21,97.0,99.25,96.74250030517578,99.17250061035156,103433200.0,-1.3574981689453267,1.3574981689453267,0.0,62.439329921425546,90.91000366210938,99.95500183105467,67.32998972625282,-32.67001027374718,3.2281124455010684,3.3233874544338082,0.017384705057290173,-646584800.0,-1.0
AAPL,2020-07-22,97.27249908447266,97.9749984741211,96.60250091552734,96.69249725341795,89001600.0,0.27249908447265625,0.0,0.27249908447265625,63.81242592577645,90.91000366210938,99.95500183105467,70.34269442096732,-29.657305579032673,3.117069744682695,3.282123912483585,0.015874223694535283,-557583200.0,1.0
AAPL,2020-07-23,92.84500122070312,97.07749938964844,92.01000213623048,96.99749755859376,197004400.0,-4.427497863769531,4.427497863769531,0.0,37.863139738346405,92.01000213623048,99.95500183105467,10.509743442993539,-89.49025655700646,2.641363873250924,3.15397190463705,-0.03205793376711874,-754587600.0,-1.0
AAPL,2020-07-24,92.61499786376952,92.97000122070312,89.1449966430664,90.9875030517578,185438800.0,-0.23000335693360796,0.23000335693360796,0.0,36.962187948060816,89.1449966430664,99.95500183105467,32.099903379869474,-67.90009662013054,2.2202112888773655,2.96721978148511,-0.029980917224576187,-940026400.0,-1.0
AAPL,2020-07-27,94.80999755859376,94.90499877929688,93.4800033569336,93.70999908447266,121214000.0,2.194999694824247,0.0,2.194999694824247,50.05003743083261,89.1449966430664,99.95500183105467,52.40516370724897,-47.59483629275103,2.0400438773372116,2.7817846006555276,-0.023156429172266457,-818812400.0,1.0
AAPL,2020-07-28,93.25250244140624,94.5500030517578,93.24749755859376,94.36750030517578,103625600.0,-1.5574951171875284,1.5574951171875284,0.0,42.77840547276959,89.1449966430664,99.95500183105467,37.99726019469407,-62.00273980530593,1.751395832078117,2.5757068469400433,-0.04576614072702423,-922438000.0,-1.0
AAPL,2020-07-29,95.04000091552734,95.2300033569336,93.7125015258789,93.75,90329200.0,1.787498474121108,0.0,1.787498474121108,52.01121952849834,89.1449966430664,99.95500183105467,54.532853314550465,-45.46714668544953,1.6478787329591853,2.39014122414387,-0.015359094335590018,-832108800.0,1.0
AAPL,2020-07-30,96.19000244140624,96.29750061035156,93.76750183105467,94.1875,158130000.0,1.150001525878892,0.0,1.150001525878892,57.144355917110836,89.1449966430664,99.95500183105467,65.17116019674084,-34.82883980325916,1.639733213412626,2.24005962199762,-0.0014273904037104268,-673978800.0,1.0
AAPL,2020-07-31,106.26000213623048,106.41500091552734,100.8249969482422,102.88500213623048,374336800.0,10.069999694824247,0.0,10.069999694824247,79.40367251065693,89.1449966430664,106.41500091552734,99.10249715720092,-0.8975028427990874,2.4179606554044994,2.275639828678996,0.08034470288895812,-299642000.0,1.0
AAPL,2020-08-03,108.9375,111.6374969482422,107.89250183105467,108.1999969482422,308151200.0,2.677497863769517,0.0,2.677497863769517,82.23458665812834,89.1449966430664,111.6374969482422,87.9960123969815,-12.003987603018503,3.2137151033203537,2.4632548836072683,0.12306701030927836,8509200.0,1.0
AAPL,2020-08-04,109.66500091552734,110.79000091552734,108.3874969482422,109.13249969482422,173071600.0,0.7275009155273438,0.0,0.7275009155273438,82.96849569726565,89.1449966430664,111.6374969482422,91.23042789395467,-8.769572106045333,3.8585794687662656,2.742319800639069,0.1273998503964917,181580800.0,1.0
AAPL,2020-08-05,110.0625,110.39250183105467,108.89749908447266,109.37750244140624,121776800.0,0.39749908447265625,0.0,0.39749908447265625,83.4008145670731,89.1449966430664,111.6374969482422,92.99767955152689,-7.002320448473111,4.351551586549036,3.064166157821063,0.1854434654846837,303357600.0,1.0
AAPL,2020-08-06,113.90249633789062,114.4124984741211,109.79750061035156,110.40499877929688,202428800.0,3.839996337890625,0.0,3.839996337890625,87.0616004371174,89.1449966430664,114.4124984741211,97.9815886048392,-2.0184113951607885,4.994514803326098,3.450235886922071,0.22984936527703215,505786400.0,1.0
AAPL,2020-08-07,111.1125030517578,113.6750030517578,110.2925033569336,113.20500183105467,198045600.0,-2.7899932861328267,2.7899932861328267,0.0,73.47667392324662,89.1449966430664,114.4124984741211,86.93976379450588,-13.060236205494125,5.218781393769078,3.8039449882914735,0.17194922384729394,307740800.0,-1.0
AAPL,2020-08-10,112.72750091552734,113.7750015258789,110.0,112.5999984741211,212403600.0,1.6149978637695455,0.0,1.6149978637695455,75.9800152819542,89.1449966430664,114.4124984741211,93.33136465227115,-6.66863534772886,5.4638462764783355,4.1359252459288465,0.20884156418598976,520144400.0,1.0
AAPL,2020-08-11,109.375,112.48249816894533,109.10749816894533,111.97000122070312,187902400.0,-3.3525009155273438,3.3525009155273438,0.0,61.97053050342244,89.1449966430664,114.4124984741211,80.06332993343321,-19.936670066566784,5.326148338027224,4.373969864348522,0.15083121787018672,332242000.0,-1.0
AAPL,2020-08-12,113.01000213623048,113.2750015258789,110.29750061035156,110.49749755859376,165598000.0,3.635002136230483,0.0,3.635002136230483,69.09876923827632,89.1449966430664,114.4124984741211,94.4494064064264,-5.5505935935735895,5.447538342839849,4.588683560046787,0.17486224418249785,497840000.0,1.0
AAPL,2020-08-13,115.01000213623048,116.0425033569336,113.92749786376952,114.43000030517578,210082000.0,2.0,0.0,2.0,72.38487958313044,93.24749755859376,116.0425033569336,95.47049371323999,-4.529506286760007,5.640107453139592,4.7989683386653486,0.08234518938539148,707922000.0,1.0
AAPL,2020-08-14,114.90750122070312,115.0,113.04499816894533,114.83000183105467,165565200.0,-0.10250091552735796,0.10250091552735796,0.0,71.93252672710626,93.24749755859376,116.0425033569336,95.0208297981081,-4.979170201891905,5.718529225245518,4.982880515981383,0.05480207661001146,542356800.0,-1.0
AAPL,2020-08-17,114.60749816894533,116.0875015258789,113.9625015258789,116.0625,119561600.0,-0.3000030517577983,0.3000030517577983,0.0,70.44580244126425,93.7125015258789,116.0875015258789,93.3854598572801,-6.614540142719909,5.690870553789807,5.124478523543068,0.04506904857662919,422795200.0,-1.0
AAPL,2020-08-18,115.5625,116.0,114.00749969482422,114.35250091552734,105633600.0,0.9550018310546733,0.0,0.9550018310546733,72.53112138561832,93.76750183105467,116.0875015258789,97.6478425938301,-2.3521574061698955,5.680529521723372,5.23568872317913,0.04997160704145376,528428800.0,1.0
AAPL,2020-08-19,115.7074966430664,117.1624984741211,115.61000061035156,115.98249816894533,145538000.0,0.14499664306640625,0.0,0.14499664306640625,72.86651938994636,100.8249969482422,117.1624984741211,91.09409826986128,-8.905901730138718,5.619258786348411,5.312402735812986,0.015846889780372075,673966800.0,1.0
AAPL,2020-08-20,118.2750015258789,118.39250183105467,115.73249816894533,115.75,126907200.0,2.5675048828125,0.0,2.5675048828125,78.28403243319987,107.89250183105467,118.39250183105467,98.8809494745165,-1.1190505254834957,5.712031887620171,5.392328566174424,0.06446167872561293,800874000.0,1.0
AAPL,2020-08-21,124.37000274658205,124.86750030517578,119.25,119.2624969482422,338054800.0,6.095001220703139,0.0,6.095001220703139,85.96158684827881,108.3874969482422,124.86750030517578,96.98120474966757,-3.0187952503324293,6.2058321298268595,5.555029278904912,0.1032800491140049,1138928800.0,1.0
AAPL,2020-08-24,125.85749816894533,128.78500366210938,123.9375,128.69749450683594,345937600.0,1.4874954223632812,0.0,1.4874954223632812,87.2326689039866,108.89749908447266,128.78500366210938,85.27967407003895,-14.720325929961048,6.640651083730532,5.772153639870036,0.15069712611607167,1484866400.0,1.0
AAPL,2020-08-25,124.8249969482422,125.18000030517578,123.05249786376952,124.69750213623048,211495600.0,-1.032501220703125,1.032501220703125,0.0,81.33455056487023,109.10749816894533,128.78500366210938,79.87546381200158,-20.124536187998405,6.823279700091163,5.982378851914262,0.10454822218098059,1273370800.0,-1.0
AAPL,2020-08-26,126.52249908447266,126.99250030517578,125.0824966430664,126.18000030517578,163022400.0,1.6975021362304545,0.0,1.6975021362304545,83.45647553034175,109.10749816894533,128.78500366210938,88.50207624933601,-11.49792375066398,7.024019475510087,6.190706976633428,0.10009996291109968,1436393200.0,1.0
AAPL,2020-08-27,125.01000213623048,127.48500061035156,123.8324966430664,127.14250183105467,155552400.0,-1.5124969482421733,1.5124969482421733,0.0,74.72316479490033,109.10749816894533,128.78500366210938,80.81564999592898,-19.184350004071018,6.980593672420113,6.3486843157907655,0.08791855020955897,1280840800.0,-1.0
AAPL,2020-08-28,124.80750274658205,126.44249725341795,124.57749938964844,126.0124969482422,187630000.0,-0.2024993896484375,0.2024993896484375,0.0,73.53442529547272,109.10749816894533,128.78500366210938,79.78655924192672,-20.213440758073276,6.850865893632346,6.449120631359082,0.08899945239709073,1093210800.0,-1.0
AAPL,2020-08-31,129.0399932861328,131.0,126.0,127.58000183105467,225702700.0,4.232490539550767,0.0,4.232490539550767,80.87283829568065,110.29750061035156,131.0,90.53251166935321,-9.467488330646784,7.008788561525989,6.5610542173924635,0.11662514471504859,1318913500.0,1.0
AAPL,2020-09-01,134.17999267578125,134.8000030517578,130.52999877929688,132.75999450683594,151948100.0,5.1399993896484375,0.0,5.1399993896484375,86.22498384731834,113.04499816894533,134.8000030517578,97.15003338626505,-2.849966613734943,7.462672468876235,6.741377867689219,0.1596482213222421,1470861600.0,1.0
AAPL,2020-09-02,131.39999389648438,137.97999572753906,127.0,137.58999633789062,200119000.0,-2.779998779296875,2.779998779296875,0.0,73.40638220840961,113.04499816894533,137.97999572753906,73.61137968595101,-26.388620314048993,7.511468926394002,6.895396079430176,0.11097013063858374,1270742600.0,-1.0
AAPL,2020-09-03,120.87999725341795,128.83999633789062,120.5,126.91000366210938,257599600.0,-10.51999664306642,10.51999664306642,0.0,44.51239829239222,113.9625015258789,137.97999572753906,28.801904434563752,-71.19809556543625,6.624898446875534,6.841296552919249,-0.02806147315342089,1013143000.0,-1.0
AAPL,2020-09-04,120.95999908447266,123.6999969482422,110.88999938964844,120.06999969482422,332607200.0,0.08000183105470171,0.0,0.08000183105470171,44.70338554485729,110.88999938964844,137.97999572753906,37.17239223373156,-62.82760776626844,5.861176424133689,6.645272527162137,-0.038913049724685345,1345750200.0,1.0
AAPL,2020-09-08,112.81999969482422,118.98999786376952,112.68000030517578,113.9499969482422,231366600.0,-8.139999389648438,8.139999389648438,0.0,31.837920843571084,110.88999938964844,137.97999572753906,7.124402237280117,-92.87559776271989,4.546680990661301,6.225554219861971,-0.09617462485014738,1114383600.0,-1.0
AAPL,2020-09-09,117.31999969482422,119.13999938964844,115.26000213623048,117.26000213623048,176940500.0,4.5,0.0,4.5,42.4101600795041,110.88999938964844,137.97999572753906,23.735700163909495,-76.26429983609052,3.82396547921212,5.745236471732001,-0.07273409438035516,1291324100.0,1.0
AAPL,2020-09-10,113.48999786376952,120.5,112.5,120.36000061035156,182274400.0,-3.8300018310547017,3.8300018310547017,0.0,36.8041338115456,110.88999938964844,137.97999572753906,9.597633169423785,-90.40236683057621,2.9086306137661495,5.177915300138832,-0.09215266039198178,1109049700.0,-1.0
AAPL,2020-09-11,112.0,115.2300033569336,110.0,114.56999969482422,180860300.0,-1.489997863769517,1.489997863769517,0.0,34.7426374531301,110.0,137.97999572753906,7.147963922065641,-92.85203607793436,2.039481046289467,4.550228449368959,-0.10261805151720171,928189400.0,-1.0
AAPL,2020-09-14,115.36000061035156,115.93000030517578,112.8000030517578,114.72000122070312,140150100.0,3.3600006103515625,0.0,3.3600006103515625,43.04362777966791,110.0,137.97999572753906,19.156545492521392,-80.84345450747861,1.6033153991737237,3.9608458393299117,-0.10601358793817728,1068339500.0,1.0
AAPL,2020-09-15,115.54000091552734,118.83000183105467,113.61000061035156,118.33000183105467,184642000.0,0.18000030517578125,0.0,0.18000030517578125,43.487975593177154,110.0,137.97999572753906,19.799863336200037,-80.20013666379995,1.2576777617801156,3.4202122238199526,-0.1389178176905529,1252981500.0,1.0
AAPL,2020-09-16,112.12999725341795,116.0,112.04000091552734,115.2300033569336,154679000.0,-3.410003662109389,3.410003662109389,0.0,37.15226246459807,110.0,137.97999572753906,7.612571760765223,-92.38742823923478,0.700523712682724,2.876274521592507,-0.14665142723101754,1098302500.0,-1.0
AAPL,2020-09-17,110.33999633789062,112.1999969482422,108.70999908447266,109.72000122070312,178011000.0,-1.7900009155273295,1.7900009155273295,0.0,34.1397237896998,108.70999908447266,137.97999572753906,5.568833072634086,-94.43116692736592,0.11323186715567601,2.3236659907051407,-0.08719392087204325,920291500.0,-1.0
AAPL,2020-09-18,106.83999633789062,110.87999725341795,106.08999633789062,110.4000015258789,287104900.0,-3.5,3.5,0.0,28.86004946497789,106.08999633789062,137.97999572753906,2.351834475868481,-97.64816552413151,-0.62738950647622,1.7334548912688685,-0.11673282782286809,633186600.0,-1.0
AAPL,2020-09-21,110.08000183105467,110.19000244140624,103.0999984741211,104.54000091552734,195713800.0,3.2400054931640483,0.0,3.2400054931640483,38.94540264322745,103.0999984741211,137.97999572753906,20.011479089923363,-79.98852091007664,-0.9420368943074351,1.1983565341536078,-0.02428645516026573,828900400.0,1.0
AAPL,2020-09-22,111.80999755859376,112.86000061035156,109.16000366210938,112.68000030517578,183055400.0,1.729995727539091,0.0,1.729995727539091,43.84970030980393,103.0999984741211,137.97999572753906,24.97132961677386,-75.02867038322614,-1.0398147771010713,0.7507222719026718,-0.046965582599413636,1011955800.0,1.0
AAPL,2020-09-23,107.12000274658205,112.11000061035156,106.7699966430664,111.62000274658205,150718700.0,-4.689994812011719,4.689994812011719,0.0,35.0442680182488,103.0999984741211,128.83999633789062,15.617733512399898,-84.3822664876001,-1.4787020317649109,0.3048374111691552,-0.05612825127403609,861237100.0,-1.0
AAPL,2020-09-24,108.22000122070312,110.25,105.0,105.16999816894533,167743300.0,1.0999984741210795,0.0,1.0999984741210795,38.392278629797,103.0999984741211,123.6999969482422,24.85438410597006,-75.14561589402994,-1.7179591452496652,-0.099721900114609,-0.03374998910086491,1028980400.0,1.0
AAPL,2020-09-25,112.27999877929688,112.44000244140624,107.66999816894533,108.43000030517578,149981400.0,4.05999755859375,0.0,4.05999755859375,49.48150701078535,103.0999984741211,120.5,52.75861781691472,-47.241382183085285,-1.5619591479422468,-0.39216934968013667,-0.02669904485747987,1178961800.0,1.0
AAPL,2020-09-28,114.95999908447266,115.31999969482422,112.77999877929688,115.01000213623048,137672400.0,2.6800003051757812,0.0,2.6800003051757812,55.572338861319565,103.0999984741211,120.5,68.16091707068107,-31.83908292931893,-1.208147736336116,-0.5553650270113327,-0.005019922333900029,1316634200.0,1.0
AAPL,2020-09-29,114.08999633789062,115.30999755859376,113.56999969482422,114.5500030517578,99382200.0,-0.8700027465820312,0.8700027465820312,0.0,53.171098983654936,103.0999984741211,120.5,63.16090172419917,-36.839098275800836,-0.986578893682065,-0.6416078003454793,0.017479703312959227,1217252000.0,-1.0
AAPL,2020-09-30,115.80999755859376,117.26000213623048,113.62000274658205,113.79000091552734,142675200.0,1.7200012207031392,0.0,1.7200012207031392,57.37275218833455,103.0999984741211,118.83000183105467,80.80099410068003,-19.19900589931998,-0.6645339937724373,-0.6461930390308709,0.04957405657285441,1359927200.0,1.0
AAPL,2020-10-01,116.79000091552734,117.72000122070312,115.83000183105467,117.63999938964844,116120400.0,0.9800033569335795,0.0,0.9800033569335795,59.74712988870202,103.0999984741211,118.83000183105467,87.03114761492962,-12.968852385070367,-0.3264697038088826,-0.5822483719864733,0.09312995992782502,1476047600.0,1.0
AAPL,2020-10-02,113.0199966430664,115.37000274658205,112.22000122070312,112.88999938964844,144712000.0,-3.7700042724609375,3.7700042724609375,0.0,47.90334442402326,103.0999984741211,118.83000183105467,63.064183419723854,-36.935816580276146,-0.3586250341918884,-0.5375237044275564,0.026707801263701647,1331335600.0,-1.0
AAPL,2020-10-05,116.5,116.6500015258789,113.5500030517578,113.91000366210938,106243800.0,3.4800033569335938,0.0,3.4800033569335938,56.98524365612107,103.0999984741211,117.72000122070312,91.65525997600551,-8.344740023994493,-0.10212405473207298,-0.4504437744884597,0.041946181413235806,1437579400.0,1.0
AAPL,2020-10-06,113.16000366210938,116.12000274658205,112.25,115.6999969482422,161498200.0,-3.339996337890625,3.339996337890625,0.0,47.76413772242485,103.0999984741211,117.72000122070312,68.80987207981326,-31.19012792018674,-0.16643630947551458,-0.39364228148587066,0.05638536931161586,1276081200.0,-1.0
AAPL,2020-10-07,115.08000183105467,115.5500030517578,114.12999725341795,114.62000274658205,96849000.0,1.9199981689452983,0.0,1.9199981689452983,52.82721808820526,103.0999984741211,117.72000122070312,81.9425520267727,-18.057447973227294,-0.06176449281853991,-0.3272667237524045,0.06338939690419432,1372930200.0,1.0
AAPL,2020-10-08,114.97000122070312,116.4000015258789,114.58999633789062,116.25,83477200.0,-0.11000061035154829,0.11000061035154829,0.0,52.49088304546612,103.0999984741211,117.72000122070312,81.19015401250239,-18.809845987497607,0.012172234349577593,-0.2593789321320081,0.023957984241644414,1289453000.0,-1.0
AAPL,2020-10-09,116.97000122070312,117.0,114.91999816894533,115.27999877929688,100506900.0,2.0,0.0,2.0,58.08880943274608,105.0,117.72000122070312,94.10377415075011,-5.8962258492498965,0.2295052723624167,-0.16160209123312308,0.017484361101582024,1389959900.0,1.0
AAPL,2020-10-12,124.4000015258789,125.18000030517578,119.27999877929688,120.05999755859376,240226800.0,7.430000305175781,0.0,7.430000305175781,72.15344411131315,105.0,125.18000030517578,96.1347930252666,-3.8652069747333964,0.9898714330297764,0.06869261361945689,0.09036730229575962,1630186700.0,1.0
AAPL,2020-10-13,121.0999984741211,125.38999938964844,119.6500015258789,125.2699966430664,262330500.0,-3.3000030517578125,3.3000030517578125,0.0,61.56554897908832,105.0,125.38999938964844,78.96026952455288,-21.03973047544712,1.3110712704333878,0.31716834498224317,0.04567827499392596,1367856200.0,-1.0
AAPL,2020-10-14,121.19000244140624,123.02999877929688,119.62000274658205,121.0,150712000.0,0.09000396728514204,0.0,0.09000396728514204,61.74222090306292,107.66999816894533,125.38999938964844,76.29798725219528,-23.70201274780471,1.554962382541376,0.5647271524940699,0.037674471199476756,1518568200.0,1.0
AAPL,2020-10-15,120.70999908447266,121.1999969482422,118.1500015258789,118.72000122070312,112559200.0,-0.48000335693357954,0.48000335693357954,0.0,60.04379913235283,112.22000122070312,125.38999938964844,64.46468522515696,-35.535314774843044,1.6900339338858856,0.7897885087724331,0.06804107830309358,1406009000.0,-1.0
AAPL,2020-10-16,119.0199966430664,121.5500030517578,118.80999755859376,121.27999877929688,115393800.0,-1.69000244140625,1.69000244140625,0.0,54.00828024374746,112.22000122070312,125.38999938964844,51.63247052226312,-48.36752947773688,1.641784591010392,0.9601877252200249,0.021630872472673035,1290615200.0,-1.0
AAPL,2020-10-19,115.9800033569336,120.41999816894533,115.66000366210938,119.95999908447266,120639300.0,-3.0399932861328125,3.0399932861328125,0.0,44.68548536853682,112.22000122070312,125.38999938964844,28.549754434260333,-71.45024556573966,1.3427660559380854,1.0367033913636372,0.024920463092636513,1169975900.0,-1.0
AAPL,2020-10-20,117.51000213623048,118.9800033569336,115.62999725341795,116.1999969482422,124423700.0,1.5299987792968892,0.0,1.5299987792968892,49.725163641970894,112.22000122070312,125.38999938964844,40.16705885351687,-59.83294114648313,1.2152412637892098,1.0724109658487517,0.02111574788418258,1294399600.0,1.0
AAPL,2020-10-21,116.87000274658205,118.70999908447266,116.4499969482422,116.66999816894533,89946000.0,-0.6399993896484375,0.6399993896484375,0.0,47.63063427599551,112.22000122070312,125.38999938964844,35.307533579188835,-64.69246642081117,1.0504256987580334,1.068013912430608,0.016526063370492228,1204453600.0,-1.0
AAPL,2020-10-22,115.75,118.04000091552734,114.58999633789062,117.4499969482422,101988000.0,-1.1200027465820455,1.1200027465820455,0.0,43.89699419063429,112.25,125.38999938964844,26.636226503612058,-73.36377349638794,0.8199810947708102,1.0184073488986485,-0.010430035119869618,1102465600.0,-1.0
AAPL,2020-10-23,115.04000091552734,116.5500030517578,114.27999877929688,116.38999938964844,82572600.0,-0.7099990844726562,0.7099990844726562,0.0,41.516571013947285,112.25,125.38999938964844,21.232884666077528,-78.76711533392248,0.5734507175585719,0.9294160226306332,-0.07524116153973204,1019893000.0,-1.0
AAPL,2020-10-26,115.0500030517578,116.5500030517578,112.87999725341795,114.01000213623048,111850700.0,0.01000213623045454,0.0,0.01000213623045454,41.568076377148756,112.87999725341795,125.38999938964844,17.346166489094706,-82.6538335109053,0.37456297749204737,0.8184454136029159,-0.049958674637441636,1131743700.0,1.0
AAPL,2020-10-27,116.5999984741211,117.27999877929688,114.54000091552734,115.48999786376952,92276800.0,1.5499954223632955,0.0,1.5499954223632955,49.51766439923148,112.87999725341795,125.38999938964844,29.736215711183334,-70.26378428881667,0.33811707135835434,0.7223797451540037,-0.03787444405329021,1224020500.0,1.0
AAPL,2020-10-28,111.1999969482422,115.43000030517578,111.0999984741211,115.0500030517578,143937800.0,-5.400001525878892,5.400001525878892,0.0,32.0109570735671,111.0999984741211,125.38999938964844,0.6997793401989976,-99.300220659801,-0.1250599106670478,0.5528918139897935,-0.07878388044370188,1080082700.0,-1.0
AAPL,2020-10-29,115.31999969482422,116.93000030517578,112.1999969482422,112.37000274658205,146129200.0,4.120002746582017,0.0,4.120002746582017,48.14906005812541,111.0999984741211,125.38999938964844,29.531147308169324,-70.46885269183068,-0.1578615163901418,0.4107411479138064,-0.031087187469331257,1226211900.0,1.0
AAPL,2020-10-30,108.86000061035156,111.98999786376952,107.72000122070312,111.05999755859376,190272600.0,-6.459999084472656,6.459999084472656,0.0,33.68400396039584,107.72000122070312,125.38999938964844,6.451610117605812,-93.54838988239419,-0.6970893083241378,0.18917505666621753,-0.06138991671409,1035939300.0,-1.0
AAPL,2020-11-02,108.7699966430664,110.68000030517578,107.31999969482422,109.11000061035156,122866900.0,-0.09000396728515625,0.09000396728515625,0.0,33.52210624866352,107.31999969482422,123.02999877929688,9.229771055017602,-90.7702289449824,-1.1187969899720542,-0.07241935266143688,-0.07437669419009718,913072400.0,-1.0
AAPL,2020-11-03,110.44000244140624,111.48999786376952,108.7300033569336,109.66000366210938,107624400.0,1.6700057983398295,0.0,1.6700057983398295,39.724535242238616,107.31999969482422,121.5500030517578,21.925523615999666,-78.07447638400033,-1.3032250961854572,-0.31858050136624105,-0.055018397827186316,1020696800.0,1.0
AAPL,2020-11-04,114.9499969482422,115.58999633789062,112.3499984741211,114.13999938964844,138235500.0,4.509994506835966,0.0,4.509994506835966,53.30127549828823,107.31999969482422,121.5500030517578,53.61908259635274,-46.38091740364727,-1.0730968648008172,-0.4694837740531564,-0.006911473449311423,1158932300.0,1.0
AAPL,2020-11-05,119.02999877929688,119.62000274658205,116.87000274658205,117.9499969482422,126387100.0,4.080001831054673,0.0,4.080001831054673,62.1909019286486,107.31999969482422,120.41999816894533,89.3893164003463,-10.610683599653688,-0.5550977324898696,-0.4866065657404991,0.03468356947162521,1285319400.0,1.0
AAPL,2020-11-06,118.69000244140624,119.1999969482422,116.12999725341795,118.31999969482422,114457900.0,-0.3399963378906392,0.3399963378906392,0.0,61.073035821817896,107.31999969482422,119.62000274658205,92.43902378509652,-7.560976214903466,-0.17005427008545837,-0.423296106609491,0.031638411934773236,1170861500.0,-1.0
AAPL,2020-11-09,116.31999969482422,121.98999786376952,116.0500030517578,120.5,154515300.0,-2.370002746582017,2.370002746582017,0.0,53.35882182962709,107.31999969482422,121.98999786376952,61.34970090897466,-38.65029909102534,-0.055504139848920886,-0.34973771325737696,-0.002401361774966193,1016346200.0,-1.0
AAPL,2020-11-10,115.97000122070312,117.58999633789062,114.12999725341795,115.5500030517578,138023400.0,-0.34999847412109375,0.34999847412109375,0.0,52.23456543131962,107.31999969482422,121.98999786376952,58.96388960831616,-41.03611039168385,0.006955534087452975,-0.278399063788411,0.04289572305187295,878322800.0,-1.0
AAPL,2020-11-11,119.48999786376952,119.62999725341795,116.44000244140624,117.19000244140624,112295000.0,3.519996643066392,0.0,3.519996643066392,61.61884922890983,107.31999969482422,121.98999786376952,82.95841641417371,-17.041583585826295,0.3366093512083381,-0.15539738078906115,0.036160233957514,990617800.0,1.0
AAPL,2020-11-12,119.20999908447266,120.52999877929688,118.56999969482422,119.62000274658205,103162300.0,-0.2799987792968608,0.2799987792968608,0.0,60.527405737723456,107.31999969482422,121.98999786376952,81.049767373647,-18.95023262635301,0.5687130456474989,-0.010575295501749097,0.0950762301680248,887455500.0,-1.0
AAPL,2020-11-13,119.26000213623048,119.66999816894533,117.87000274658205,119.44000244140624,81581900.0,0.05000305175782671,0.0,0.05000305175782671,60.67095117566182,107.31999969482422,121.98999786376952,81.39061984807795,-18.609380151922046,0.7480684562974744,0.14115345485809566,0.09644208712801094,969037400.0,1.0
AAPL,2020-11-16,120.3000030517578,120.98999786376952,118.1500015258789,118.91999816894533,91183000.0,1.0400009155273153,0.0,1.0400009155273153,63.82779986825183,107.31999969482422,121.98999786376952,88.4799248605958,-11.5200751394042,0.9630271134784465,0.3055281865821659,0.08927925020268601,1060220400.0,1.0
AAPL,2020-11-17,119.38999938964844,120.66999816894533,118.95999908447266,119.5500030517578,74271000.0,-0.9100036621093608,0.9100036621093608,0.0,59.04297668783873,107.31999969482422,121.98999786376952,82.27676347209791,-17.72323652790208,1.0478744653838987,0.4539974423425125,0.0386255116074985,985949400.0,-1.0
AAPL,2020-11-18,118.02999877929688,119.81999969482422,118.0,118.61000061035156,76322100.0,-1.3600006103515625,1.3600006103515625,0.0,52.28416887469134,107.31999969482422,121.98999786376952,73.00613784086555,-26.99386215913445,0.9939186475636319,0.5619816833867365,-0.00840124347017912,909627300.0,-1.0
AAPL,2020-11-19,118.63999938964844,119.05999755859376,116.80999755859376,117.58999633789062,74113000.0,0.6100006103515625,0.0,0.6100006103515625,54.95291707139352,107.31999969482422,121.98999786376952,77.16428839635003,-22.83571160364997,0.9889798786396682,0.6473813224373228,-0.0004212911848450185,983740300.0,1.0
AAPL,2020-11-20,117.33999633789062,118.7699966430664,117.29000091552734,118.63999938964844,73604300.0,-1.3000030517578125,1.3000030517578125,0.0,48.30885260591118,108.7300033569336,121.98999786376952,64.93210066202005,-35.067899337979945,0.8701361023155698,0.6919322784129723,0.008768884506038965,910136000.0,-1.0
AAPL,2020-11-23,113.8499984741211,117.62000274658205,113.75,117.18000030517578,127959300.0,-3.4899978637695312,3.4899978637695312,0.0,35.14605139672997,112.3499984741211,121.98999786376952,15.560166960287598,-84.4398330397124,0.48870441929612696,0.6512867065896033,-0.018280613298843007,782176700.0,-1.0
AAPL,2020-11-24,115.16999816894533,115.8499984741211,112.58999633789062,113.91000366210938,113874200.0,1.319999694824233,0.0,1.319999694824233,42.03827669563342,112.58999633789062,121.98999786376952,27.446823534568242,-72.55317646543176,0.2895917701473536,0.5789477193011534,-0.03615365111772295,896050900.0,1.0
AAPL,2020-11-25,116.02999877929688,116.75,115.16999816894533,115.5500030517578,76499200.0,0.8600006103515483,0.0,0.8600006103515483,46.32630251822496,112.58999633789062,121.98999786376952,36.59576471275746,-63.404235287242535,0.19889567615369685,0.5029373106716621,-0.02667561722672629,972550100.0,1.0
AAPL,2020-11-27,116.58999633789062,117.48999786376952,116.22000122070312,116.56999969482422,46691300.0,0.55999755859375,0.0,0.55999755859375,49.15261395118073,112.58999633789062,121.98999786376952,42.553184581807855,-57.446815418192145,0.17024303453678158,0.43639845544468603,-0.022388107919786182,1019241400.0,1.0
AAPL,2020-11-30,119.0500030517578,120.97000122070312,116.80999755859376,116.97000122070312,169410200.0,2.4600067138671733,0.0,2.4600067138671733,59.86487576229575,112.58999633789062,120.98999786376952,76.90482786181711,-23.095172138182882,0.3420941404886122,0.4175375924534712,-0.010390689678222209,1188651600.0,1.0
AAPL,2020-12-01,122.72000122070312,123.47000122070312,120.01000213623048,121.01000213623048,127728200.0,3.6699981689453267,0.0,3.6699981689453267,70.54631269279588,112.58999633789062,123.47000122070312,93.10662074072413,-6.893379259275881,0.765600193512725,0.487150112665322,0.02789179871076719,1316379800.0,1.0
AAPL,2020-12-02,123.08000183105467,123.37000274658205,120.88999938964844,122.0199966430664,89004200.0,0.3600006103515483,0.0,0.3600006103515483,71.40758638685024,112.58999633789062,123.47000122070312,96.41544839502282,-3.584551604977186,1.117400138567632,0.6132001178457841,0.04278575873918933,1405384000.0,1.0
AAPL,2020-12-03,122.94000244140624,123.77999877929688,122.20999908447266,123.5199966430664,78967600.0,-0.1399993896484375,0.1399993896484375,0.0,70.48277048321431,112.58999633789062,123.77999877929688,92.49333195154266,-7.506668048457339,1.369124929031173,0.764385080082862,0.0362441257070083,1326416400.0,-1.0
AAPL,2020-12-04,122.25,122.86000061035156,121.5199966430664,122.5999984741211,78260400.0,-0.6900024414062358,0.6900024414062358,0.0,65.6476996581277,112.58999633789062,123.77999877929688,86.32709163998538,-13.672908360014619,1.4956997140152453,0.9106480068693388,0.041844245912285416,1248156000.0,-1.0
AAPL,2020-12-07,123.75,124.56999969482422,122.25,122.30999755859376,86712000.0,1.5,0.0,1.5,70.69094630462142,112.58999633789062,124.56999969482422,93.15526322995868,-6.844736770041325,1.69748110003421,1.0680146255023133,0.08695653630710631,1334868000.0,1.0
AAPL,2020-12-08,124.37999725341795,124.9800033569336,123.08999633789062,124.37000274658205,82225500.0,0.6299972534179545,0.0,0.6299972534179545,72.63766351058376,112.58999633789062,124.9800033569336,95.15733846967599,-4.842661530324016,1.8864836061143109,1.231708421624713,0.07996873518190295,1417093500.0,1.0
AAPL,2020-12-09,121.77999877929688,125.9499969482422,121.0,124.52999877929688,115089200.0,-2.5999984741210795,2.5999984741210795,0.0,55.18369490278133,112.58999633789062,125.9499969482422,68.78744028114538,-31.212559718854614,1.8056568203666643,1.3464981013731034,0.049556149793099635,1302004300.0,-1.0
AAPL,2020-12-10,123.23999786376952,123.87000274658205,120.1500015258789,120.5,81312200.0,1.459999084472642,0.0,1.459999084472642,61.22115882425234,112.58999633789062,125.9499969482422,79.71557664171867,-20.28442335828134,1.8382208676735274,1.4448426546331885,0.057037496652855735,1383316500.0,1.0
AAPL,2020-12-11,122.41000366210938,122.76000213623048,120.5500030517578,122.43000030517578,86939800.0,-0.829994201660142,0.829994201660142,0.0,56.250486179181515,112.58999633789062,125.9499969482422,73.50304547598617,-26.496954524013827,1.7765752610805379,1.5111891759226586,0.02822343993465326,1296376700.0,-1.0
AAPL,2020-12-14,121.77999877929688,123.3499984741211,121.54000091552734,122.5999984741211,79184500.0,-0.6300048828125,0.6300048828125,0.0,52.516070938124905,112.58999633789062,125.9499969482422,68.78744028114538,-31.212559718854614,1.6577747498567987,1.5405062907094869,-0.007659732986114665,1217192200.0,-1.0
AAPL,2020-12-15,127.87999725341795,127.9000015258789,124.12999725341795,124.33999633789062,157243700.0,6.0999984741210795,0.0,6.0999984741210795,72.73706902430496,115.16999816894533,127.9000015258789,99.8428572884071,-0.15714271159289284,2.032414967495015,1.6388880260665928,0.03899898725181994,1374435900.0,1.0
AAPL,2020-12-16,127.80999755859376,128.3699951171875,126.55999755859376,127.41000366210938,98208600.0,-0.06999969482419033,0.06999969482419033,0.0,72.32923436074968,116.22000122070312,128.3699951171875,95.39096428060122,-4.609035719398774,2.29719106014592,1.7705486328824582,0.03961277875774072,1276227300.0,-1.0
AAPL,2020-12-17,128.6999969482422,129.5800018310547,128.0399932861328,128.89999389648438,94359800.0,0.8899993896484233,0.0,0.8899993896484233,74.43233866641467,116.80999755859376,129.5800018310547,93.10881293352212,-6.891187066477881,2.5494550030828975,1.9263299069225461,0.05276071123306503,1370587100.0,1.0
AAPL,2020-12-18,126.66000366210938,129.10000610351562,126.12000274658205,128.9600067138672,192541500.0,-2.0399932861328125,2.0399932861328125,0.0,61.974573996922246,120.01000213623048,129.5800018310547,69.4880014413736,-30.511998558626402,2.555309568927811,2.0521258393235993,0.023515181107954586,1178045600.0,-1.0
AAPL,2020-12-21,128.22999572753906,128.30999755859375,123.4499969482422,125.0199966430664,121251600.0,1.5699920654296875,0.0,1.5699920654296875,66.89486162796337,120.1500015258789,129.5800018310547,85.68392301350556,-14.316076986494435,2.65601767408333,2.1729042062755455,0.030953517921992857,1299297200.0,1.0
AAPL,2020-12-22,131.8800048828125,134.41000366210938,129.64999389648438,131.61000061035156,168904800.0,3.6500091552734375,0.0,3.6500091552734375,75.42497458238564,120.1500015258789,134.41000366210938,82.25807573430237,-17.741924265697637,2.995820847962392,2.3374875346129147,0.0829364937161805,1468202000.0,1.0
AAPL,2020-12-23,130.9600067138672,132.42999267578125,130.77999877929688,132.16000366210938,88223700.0,-0.9199981689453125,0.9199981689453125,0.0,70.16683424332871,120.1500015258789,134.41000366210938,75.80647663805912,-24.193523361940883,3.154517830304883,2.5008935937513086,0.06264207224858476,1379978300.0,-1.0
AAPL,2020-12-24,131.97000122070312,133.4600067138672,131.10000610351562,131.32000732421875,54930100.0,1.0099945068359375,0.0,1.0099945068359375,72.58755518149007,120.1500015258789,134.41000366210938,82.88918600364778,-17.11081399635223,3.323473513717417,2.6654095777445304,0.07809817231100147,1434908400.0,1.0
AAPL,2020-12-28,136.69000244140625,137.33999633789062,133.50999450683594,133.99000549316406,124486200.0,4.720001220703125,0.0,4.720001220703125,80.93098546343445,120.1500015258789,137.33999633789062,96.21876618583862,-3.7812338141613853,3.794496170444461,2.891226896284517,0.12243392849043233,1559394600.0,1.0
AAPL,2020-12-29,134.8699951171875,138.7899932861328,134.33999633789062,138.0500030517578,121047300.0,-1.82000732421875,1.82000732421875,0.0,71.2785940008257,120.1500015258789,138.7899932861328,78.96995760854394,-21.030042391456057,3.9751031249097366,3.1080021420095614,0.0546606037996511,1438347300.0,-1.0
AAPL,2020-12-30,133.72000122070312,135.99000549316406,133.39999389648438,135.5800018310547,96452100.0,-1.149993896484375,1.149993896484375,0.0,65.57644847532175,120.1500015258789,138.7899932861328,72.80045972852605,-27.19954027147395,3.9795665749904288,3.282315028605735,0.04624054279791334,1341895200.0,-1.0
AAPL,2020-12-31,132.69000244140625,134.74000549316406,131.72000122070312,134.0800018310547,99116600.0,-1.029998779296875,1.029998779296875,0.0,60.568976912236636,120.5500030517578,138.7899932861328,66.55704983201942,-33.4429501679806,3.855547249455128,3.3969614727756143,0.031002374419392353,1242778600.0,-1.0
AAPL,2021-01-04,129.41000366210938,133.61000061035156,126.76000213623048,133.52000427246094,143301900.0,-3.279998779296875,3.279998779296875,0.0,47.29811068235492,121.54000091552734,138.7899932861328,45.62322450642218,-54.37677549357781,3.452790927317295,3.408127363683951,0.021711668407464746,1099476700.0,-1.0
AAPL,2021-01-05,131.00999450683594,131.74000549316406,128.42999267578125,128.88999938964844,97664900.0,1.5999908447265625,0.0,1.5999908447265625,53.08390051987546,123.4499969482422,138.7899932861328,49.28291631934838,-50.71708368065162,3.2255276544631215,3.371607421839785,0.021679785322646028,1197141600.0,1.0
AAPL,2021-01-06,126.5999984741211,131.0500030517578,126.37999725341795,127.72000122070312,155088000.0,-4.409996032714844,4.409996032714844,0.0,39.34634470213973,123.4499969482422,138.7899932861328,20.534565044831336,-79.46543495516866,2.6589196793812846,3.229069873348085,-0.040036443836828584,1042053600.0,-1.0
AAPL,2021-01-07,130.9199981689453,131.6300048828125,127.86000061035156,128.36000061035156,109578200.0,4.319999694824219,0.0,4.319999694824219,53.072954288804624,123.4499969482422,138.7899932861328,48.69623861807456,-51.30376138192544,2.5293103326633144,3.0891179652111314,-0.00030550200726009447,1151631800.0,1.0
AAPL,2021-01-08,132.0500030517578,132.6300048828125,130.22999572753906,132.42999267578125,105158200.0,1.1300048828125,0.0,1.1300048828125,56.073352336189274,123.4499969482422,138.7899932861328,56.06263465834823,-43.93736534165177,2.4890833382704045,2.9691110398229865,0.0006062122475918308,1256790000.0,1.0
AAPL,2021-01-11,128.97999572753906,130.1699981689453,128.5,129.19000244140625,100384500.0,-3.07000732421875,3.07000732421875,0.0,46.71105670947734,123.4499969482422,138.7899932861328,36.04954432510175,-63.95045567489825,2.1842999715571807,2.8121488261698255,-0.05640505213372993,1156405500.0,-1.0
AAPL,2021-01-12,128.8000030517578,129.69000244140625,126.86000061035156,128.5,91951100.0,-0.17999267578125,0.17999267578125,0.0,46.18934455203352,126.37999725341795,138.7899932861328,19.50045585800601,-80.499544141994,1.9062588870975787,2.6309708383553763,-0.045006245163392467,1064454400.0,-1.0
AAPL,2021-01-13,130.88999938964844,131.4499969482422,128.49000549316406,128.75999450683594,88636800.0,2.089996337890625,0.0,2.089996337890625,53.193503579447274,126.37999725341795,138.7899932861328,36.341688783311064,-63.65831121668894,1.8334200369068299,2.471460678065667,-0.021163638986091637,1153091200.0,1.0
AAPL,2021-01-14,128.91000366210938,131.0,128.75999450683594,130.8000030517578,90221800.0,-1.9799957275390625,1.9799957275390625,0.0,46.56769222630465,126.37999725341795,138.7899932861328,20.38684300963428,-79.61315699036572,1.5975105091785622,2.296670644288246,-0.028487442231874716,1062869400.0,-1.0
AAPL,2021-01-15,127.13999938964844,130.22000122070312,127.0,128.77999877929688,111598500.0,-1.7700042724609375,1.7700042724609375,0.0,41.26582366377742,126.37999725341795,138.7899932861328,6.124112644572877,-93.87588735542712,1.2532789373362903,2.087992302897855,-0.01754118080691769,951270900.0,-1.0
AAPL,2021-01-19,127.83000183105467,128.7100067138672,126.94000244140624,127.77999877929688,90757300.0,0.6900024414062358,0.0,0.6900024414062358,44.12716186457217,126.37999725341795,138.7899932861328,11.68416632700172,-88.31583367299828,1.0243423855615958,1.8752623194306033,-0.024272901374828626,1042028200.0,1.0
AAPL,2021-01-20,132.02999877929688,132.49000549316406,128.5500030517578,128.66000366210938,104319500.0,4.199996948242202,0.0,4.199996948242202,58.37084148600598,126.37999725341795,135.99000549316406,58.79288950566176,-41.20711049433823,1.1683452149604534,1.7338788985365734,0.04289099818816933,1146347700.0,1.0
AAPL,2021-01-21,136.8699951171875,139.6699981689453,133.58999633789062,133.8000030517578,120150900.0,4.839996337890625,0.0,4.839996337890625,68.90964142144841,126.37999725341795,139.6699981689453,78.93150595282178,-21.06849404717822,1.653950042659659,1.7178931273611908,0.04544757891429252,1266498600.0,1.0
AAPL,2021-01-22,139.07000732421875,139.85000610351562,135.02000427246094,136.27999877929688,114459400.0,2.20001220703125,0.0,2.20001220703125,72.55384776723042,126.37999725341795,139.85000610351562,94.20936698722942,-5.790633012770583,2.1910607810422107,1.8125266580973949,0.053161712307643105,1380958000.0,1.0
AAPL,2021-01-25,142.9199981689453,145.08999633789062,136.5399932861328,143.07000732421875,157611700.0,3.8499908447265625,0.0,3.8499908447265625,77.80656739942302,126.37999725341795,145.08999633789062,88.40193332373714,-11.598066676262867,2.8940264604426886,2.028826618566454,0.10807879441129375,1538569700.0,1.0
AAPL,2021-01-26,143.16000366210938,144.3000030517578,141.3699951171875,143.60000610351562,98390600.0,0.2400054931640625,0.0,0.2400054931640625,78.10793658335328,126.37999725341795,145.08999633789062,89.68469925055773,-10.315300749442263,3.430948425660347,2.3092509799852325,0.11149068532693307,1636960300.0,1.0
AAPL,2021-01-27,142.05999755859375,144.3000030517578,140.41000366210938,143.42999267578125,140843800.0,-1.100006103515625,1.100006103515625,0.0,72.87467083053016,126.86000061035156,145.08999633789062,83.37904833011221,-16.62095166988778,3.724764881093847,2.5923537602069557,0.08533882054421271,1496116500.0,-1.0
AAPL,2021-01-28,137.08999633789062,141.99000549316406,136.6999969482422,139.52000427246094,142621100.0,-4.970001220703125,4.970001220703125,0.0,54.009617628984245,126.86000061035156,145.08999633789062,56.116281541883,-43.883718458117,3.5160481621491897,2.7770926405954026,0.06345506511055676,1353495400.0,-1.0
AAPL,2021-01-29,131.9600067138672,136.74000549316406,130.2100067138672,135.8300018310547,177523800.0,-5.1299896240234375,5.1299896240234375,0.0,41.28193422672951,126.86000061035156,145.08999633789062,27.97590399766975,-72.02409600233025,2.9032248011118895,2.8023190726987,0.03791102208083852,1175971600.0,-1.0
AAPL,2021-02-01,134.13999938964844,135.3800048828125,130.92999267578125,133.75,106239800.0,2.17999267578125,0.0,2.17999267578125,47.36395582995085,126.86000061035156,145.08999633789062,39.93417710076243,-60.06582289923757,2.5639099047866694,2.754637239116294,0.049362414677372124,1282211400.0,1.0
AAPL,2021-02-02,134.99000549316406,136.30999755859375,134.61000061035156,135.72999572753906,83305400.0,0.850006103515625,0.0,0.850006103515625,49.707609386267436,126.94000244140624,145.08999633789062,44.35264880897339,-55.64735119102661,2.3366533087017842,2.671040453033392,0.022419198221876657,1365516800.0,1.0
AAPL,2021-02-03,133.94000244140625,135.77000427246094,133.61000061035156,135.75999450683594,89880900.0,-1.0500030517578125,1.0500030517578125,0.0,46.741229761347306,126.94000244140624,145.08999633789062,38.5675060825001,-61.4324939174999,2.048213814142713,2.5464751252552564,-0.021407121942779384,1275635900.0,-1.0
AAPL,2021-02-04,137.38999938964844,137.39999389648438,134.58999633789062,136.3000030517578,84183100.0,3.4499969482421875,0.0,3.4499969482421875,56.56761132569588,126.94000244140624,145.08999633789062,57.57576012334826,-42.42423987665174,2.0741004188061254,2.4520001839654304,-0.012080303775735435,1359819000.0,1.0
AAPL,2021-02-05,136.75999450683594,137.4199981689453,135.86000061035156,137.35000610351562,75693800.0,-0.6300048828125,0.6300048828125,0.0,54.4508107183625,126.94000244140624,145.08999633789062,54.104657673366,-45.895342326634,2.0204886749222624,2.365697882156797,-0.04310106172005157,1284125200.0,-1.0
AAPL,2021-02-08,136.91000366210938,136.9600067138672,134.9199981689453,136.02999877929688,71297200.0,0.1500091552734375,0.0,0.1500091552734375,54.91433485026963,128.5500030517578,145.08999633789062,50.54415963615061,-49.45584036384938,1.9674262022082303,2.286043546167084,-0.04365744509724545,1355422400.0,1.0
AAPL,2021-02-09,136.00999450683594,137.8800048828125,135.85000610351562,136.6199951171875,76774200.0,-0.9000091552734375,0.9000091552734375,0.0,51.30032849159983,130.2100067138672,145.08999633789062,38.97843976722127,-61.021560232778725,1.8316366263043733,2.1951621621945416,-0.04258766123983948,1278648200.0,-1.0
AAPL,2021-02-10,135.38999938964844,136.99000549316406,134.39999389648438,136.47999572753906,73046600.0,-0.6199951171875,0.6199951171875,0.0,48.75016221372928,130.2100067138672,145.08999633789062,34.8118030097162,-65.1881969902838,1.6549171301412287,2.087113155783879,-0.012400590806437406,1205601600.0,-1.0
AAPL,2021-02-11,135.1300048828125,136.38999938964844,133.77000427246094,135.89999389648438,64280000.0,-0.2599945068359375,0.2599945068359375,0.0,47.605108855156516,130.2100067138672,145.08999633789062,33.064526879790805,-66.93547312020918,1.476861927422533,1.96506291011161,0.02402241594166421,1141321600.0,-1.0
AAPL,2021-02-12,135.3699951171875,135.52999877929688,133.69000244140625,134.35000610351562,60145100.0,0.239990234375,0.0,0.239990234375,48.88385706859358,130.2100067138672,144.3000030517578,36.62164474410928,-63.37835525589072,1.3396741727294454,1.839985162635177,0.00916949256847821,1201466700.0,1.0
AAPL,2021-02-16,133.19000244140625,136.00999450683594,132.7899932861328,135.49000549316406,80576300.0,-2.17999267578125,2.17999267578125,0.0,38.926376861273184,130.2100067138672,144.3000030517578,21.14972677122207,-78.85027322877794,1.043021397419409,1.6805924095920235,-0.01333434312549131,1120890400.0,-1.0
AAPL,2021-02-17,130.83999633789062,132.22000122070312,129.47000122070312,131.25,97918500.0,-2.350006103515625,2.350006103515625,0.0,31.057505876975114,129.47000122070312,141.99000549316406,10.942449278559337,-89.05755072144066,0.611249973833651,1.466723922440349,-0.023144736800133736,1022971900.0,-1.0
AAPL,2021-02-18,129.7100067138672,130.0,127.41000366210938,129.1999969482422,96856700.0,-1.1299896240234375,1.1299896240234375,0.0,27.92549868001359,127.41000366210938,137.8800048828125,21.967552851950416,-78.03244714804958,0.17586008538637543,1.2085511550295545,-0.05589921180507618,926115200.0,-1.0
AAPL,2021-02-19,129.8699951171875,130.7100067138672,128.8000030517578,130.24000549316406,87668800.0,0.1599884033203125,0.0,0.1599884033203125,29.093660998970194,127.41000366210938,137.8800048828125,23.49561765297408,-76.50438234702592,-0.15449884444939244,0.9359411551337651,-0.05038022569753786,1013784000.0,1.0
AAPL,2021-02-22,126.0,129.72000122070312,125.5999984741211,128.00999450683594,103916400.0,-3.8699951171875,3.8699951171875,0.0,20.031886975832677,125.5999984741211,137.8800048828125,3.257339716010226,-96.74266028398978,-0.7202839543704158,0.6046961332329288,-0.07968741049072647,909867600.0,-1.0
AAPL,2021-02-23,125.86000061035156,126.70999908447266,118.38999938964844,123.76000213623048,158273000.0,-0.1399993896484375,0.1399993896484375,0.0,19.774793858296803,118.38999938964844,137.8800048828125,38.327342818467436,-61.672657181532564,-1.16652256496738,0.250452393592867,-0.07462682381017394,751594600.0,-1.0
AAPL,2021-02-24,125.3499984741211,125.55999755859376,122.2300033569336,124.94000244140624,111039900.0,-0.5100021362304688,0.5100021362304688,0.0,18.76261841776588,118.38999938964844,137.8800048828125,35.71060606890958,-64.28939393109042,-1.5435299366635888,-0.10834407245842431,-0.07415614861355091,640554700.0,-1.0
AAPL,2021-02-25,120.98999786376952,126.45999908447266,120.54000091552734,124.68000030517578,148199500.0,-4.360000610351577,4.360000610351577,0.0,12.467675634958837,118.38999938964844,137.8800048828125,13.340162859538468,-86.65983714046152,-2.1691223142596527,-0.5204997208186701,-0.10464002448090992,492355200.0,-1.0
AAPL,2021-02-26,121.26000213623048,124.8499984741211,121.1999969482422,122.58999633789062,164560400.0,0.2700042724609659,0.0,0.2700042724609659,14.51699716785319,118.38999938964844,137.8800048828125,14.72551019848954,-85.27448980151046,-2.6130006474609218,-0.9389999061471206,-0.10423279522720108,656915600.0,1.0
AAPL,2021-03-01,127.79000091552734,127.93000030517578,122.79000091552734,123.75,116307900.0,6.529998779296861,0.0,6.529998779296861,48.29643896282658,118.38999938964844,137.8800048828125,48.22985570309803,-51.770144296901975,-2.410079203726397,-1.233215765662976,-0.04054359506641281,773223500.0,1.0
AAPL,2021-03-02,125.12000274658205,128.72000122070312,125.01000213623048,128.41000366210938,102260900.0,-2.6699981689452983,2.6699981689452983,0.0,40.707325600803735,118.38999938964844,136.99000549316406,36.182801873713125,-63.81719812628687,-2.4366211834337292,-1.473896849217127,-0.043717469821207056,670962600.0,-1.0
AAPL,2021-03-03,122.05999755859376,125.70999908447266,121.83999633789062,124.80999755859376,112966300.0,-3.0600051879882812,3.0600051879882812,0.0,33.7038375919463,118.38999938964844,136.38999938964844,20.388878716362928,-79.61112128363708,-2.673751396930456,-1.7138677587597932,-0.05897778705808643,557996300.0,-1.0
AAPL,2021-03-04,120.12999725341795,123.5999984741211,118.62000274658205,121.75,178155000.0,-1.9300003051758097,1.9300003051758097,0.0,29.953483476486014,118.38999938964844,136.00999450683594,9.875132496899665,-90.12486750310033,-2.9830272136300096,-1.9676996497338366,-0.07499806136883824,379841300.0,-1.0
AAPL,2021-03-05,121.41999816894533,121.94000244140624,117.56999969482422,120.9800033569336,153766600.0,1.2900009155273722,0.0,1.2900009155273722,35.48957632070582,117.56999969482422,136.00999450683594,20.87852254499138,-79.12147745500862,-3.0884366583793366,-2.191847051462937,-0.03634922088138626,533607900.0,1.0
AAPL,2021-03-08,116.36000061035156,121.0,116.20999908447266,120.93000030517578,154376600.0,-5.059997558593764,5.059997558593764,0.0,26.13938680450819,116.20999908447266,132.22000122070312,0.9369238342539279,-99.06307616574607,-3.5394730751808794,-2.4613722562065257,-0.07548069246726719,379231300.0,-1.0
AAPL,2021-03-09,121.08999633789062,122.05999755859376,118.79000091552734,119.02999877929688,129525800.0,4.7299957275390625,0.0,4.7299957275390625,42.48376480263549,116.20999908447266,130.7100067138672,33.65513576368884,-66.34486423631117,-3.475191713248364,-2.6641361476148937,-0.03398485989698641,508757100.0,1.0
AAPL,2021-03-10,119.9800033569336,122.16999816894533,119.4499969482422,121.69000244140624,111943300.0,-1.1099929809570312,1.1099929809570312,0.0,40.08209502503228,116.20999908447266,130.7100067138672,26.000015784945894,-73.9999842150541,-3.473771947092345,-2.8260633075103843,-0.00834775208421068,396813800.0,-1.0
AAPL,2021-03-11,121.95999908447266,123.20999908447266,121.26000213623048,122.54000091552734,103026500.0,1.9799957275390625,0.0,1.9799957275390625,46.32715792686894,116.20999908447266,129.72000122070312,42.56105914728118,-57.43894085271882,-3.2751240728823063,-2.915875460584769,0.005772694506930298,499840300.0,1.0
AAPL,2021-03-12,121.02999877929688,121.16999816894533,119.16000366210938,120.4000015258789,88105100.0,-0.9300003051757812,0.9300003051757812,0.0,43.85020059080421,116.20999908447266,128.72000122070312,38.52916763990727,-61.47083236009272,-3.1563529812680855,-2.9639709647214327,-0.05289930423194078,411735200.0,-1.0
AAPL,2021-03-15,123.98999786376952,124.0,120.41999816894533,121.41000366210938,92403800.0,2.959999084472642,0.0,2.959999084472642,53.06589031853596,116.20999908447266,128.72000122070312,62.19022742422281,-37.80977257577718,-2.7912035895924703,-2.9294174896956404,-0.009031368750057056,504139000.0,1.0
AAPL,2021-03-16,125.56999969482422,127.22000122070312,124.72000122070312,125.6999969482422,115227900.0,1.5800018310547017,0.0,1.5800018310547017,57.37473327118323,116.20999908447266,128.72000122070312,74.82013598737826,-25.17986401262174,-2.3472692638498387,-2.8129878445264804,0.028756367413046213,619366900.0,1.0
AAPL,2021-03-17,124.76000213623048,125.86000061035156,122.33999633789062,124.0500030517578,111932600.0,-0.8099975585937358,0.8099975585937358,0.0,54.41944263831326,116.20999908447266,128.72000122070312,68.34533646477958,-31.654663535220422,-2.037323152751682,-2.657854906171521,0.03854162148231288,507434300.0,-1.0
AAPL,2021-03-18,120.52999877929688,123.18000030517578,120.31999969482422,122.87999725341795,121229700.0,-4.230003356933608,4.230003356933608,0.0,41.52972323123547,116.20999908447266,128.72000122070312,34.53236576445484,-65.46763423554516,-2.1087066878630765,-2.548025262509832,-0.00732992425522927,386204600.0,-1.0
AAPL,2021-03-19,119.98999786376952,121.43000030517578,119.68000030517578,119.9000015258789,185549500.0,-0.540000915527358,0.540000915527358,0.0,40.12963229174751,116.20999908447266,128.72000122070312,30.21581242060327,-69.78418757939673,-2.1836801096238503,-2.475156231932636,0.031196263616167563,200655100.0,-1.0
AAPL,2021-03-22,123.38999938964844,123.87000274658205,120.26000213623048,120.33000183105467,111912300.0,3.4000015258789205,0.0,3.4000015258789205,51.90838039377706,116.20999908447266,127.22000122070312,65.21343244383803,-34.78656755616196,-1.9463095336291616,-2.369386892271941,0.01899416236944851,312567400.0,1.0
AAPL,2021-03-23,122.54000091552734,124.23999786376952,122.13999938964844,123.33000183105467,95467100.0,-0.8499984741210938,0.8499984741210938,0.0,49.12072602112361,116.20999908447266,127.22000122070312,57.49319348653561,-42.50680651346439,-1.8059614160826953,-2.256701797034092,0.021336868536150133,217100300.0,-1.0
AAPL,2021-03-24,120.08999633789062,122.9000015258789,120.06999969482422,122.81999969482422,88530500.0,-2.4500045776367188,2.4500045776367188,0.0,41.676939287634156,116.20999908447266,127.22000122070312,35.24065849769559,-64.75934150230441,-1.870863268450762,-2.1795340913174264,-0.015332918666937867,128569800.0,-1.0
AAPL,2021-03-25,120.58999633789062,121.66000366210938,119.0,119.54000091552734,98844700.0,0.5,0.0,0.5,43.68646224339592,116.20999908447266,127.22000122070312,39.78198368377032,-60.218016316229686,-1.8605058790716527,-2.1157284488682717,-0.003635482490656039,227414500.0,1.0
AAPL,2021-03-26,121.20999908447266,121.4800033569336,118.91999816894533,120.3499984741211,94071200.0,0.6200027465820312,0.0,0.6200027465820312,46.3321487818091,118.79000091552734,127.22000122070312,28.70697605383836,-71.29302394616164,-1.781729860555302,-2.048928731205678,-0.022421153538137006,321485700.0,1.0
AAPL,2021-03-29,121.38999938964844,122.58000183105467,120.7300033569336,121.6500015258789,80819200.0,0.18000030517578125,0.0,0.18000030517578125,47.163693409826024,118.91999816894533,127.22000122070312,29.75903990999144,-70.24096009000857,-1.685347145230537,-1.9762124140106496,-0.03328820829286083,402304900.0,1.0
AAPL,2021-03-30,119.9000015258789,120.4000015258789,118.86000061035156,120.11000061035156,85671900.0,-1.4899978637695312,1.4899978637695312,0.0,41.08372308558494,118.86000061035156,127.22000122070312,12.440201430602631,-87.55979856939737,-1.709487614999631,-1.9228674542084463,-0.03895479742814323,316633000.0,-1.0
AAPL,2021-03-31,122.1500015258789,123.5199966430664,121.1500015258789,121.6500015258789,118323800.0,2.25,0.0,2.25,51.889953180085506,118.86000061035156,127.22000122070312,39.3540750637456,-60.6459249362544,-1.5294325686416244,-1.844180477095082,0.013440660109425684,434956800.0,1.0
AAPL,2021-04-01,123.0,124.18000030517578,122.48999786376952,123.66000366210938,75089100.0,0.8499984741210938,0.0,0.8499984741210938,55.451628168808,118.86000061035156,127.22000122070312,49.521520184127574,-50.478479815872426,-1.3031282230639505,-1.7359700262888558,0.025085442035325922,510045900.0,1.0
AAPL,2021-04-05,125.9000015258789,126.16000366210938,123.06999969482422,123.87000274658205,88651200.0,2.9000015258789062,0.0,2.9000015258789062,65.50483684661253,118.86000061035156,127.22000122070312,84.21053111898387,-15.789468881016134,-0.879634631472328,-1.5647029473255503,0.020342022438173624,598697100.0,1.0
AAPL,2021-04-06,126.20999908447266,127.12999725341795,125.6500015258789,126.5,80171300.0,0.30999755859375,0.0,0.30999755859375,66.43898529856634,118.86000061035156,127.12999725341795,88.87547107148309,-11.124528928516913,-0.5130841817458673,-1.3543791942096137,0.029949389109889202,678868400.0,1.0
AAPL,2021-04-07,127.9000015258789,127.91999816894533,125.13999938964844,125.83000183105467,83466700.0,1.69000244140625,0.0,1.69000244140625,71.32387848955491,118.86000061035156,127.91999816894533,99.77928644089475,-0.22071355910524343,-0.08523865821287302,-1.1005510870102657,0.06503460259931804,762335100.0,1.0
AAPL,2021-04-08,130.36000061035156,130.38999938964844,128.52000427246094,128.9499969482422,88844600.0,2.4599990844726562,0.0,2.4599990844726562,76.95705638602685,118.86000061035156,130.38999938964844,99.73981975305374,-0.26018024694625674,0.4471785724658588,-0.7910051551150408,0.08101836445110755,851179700.0,1.0
AAPL,2021-04-09,133.0,133.0399932861328,129.47000122070312,129.8000030517578,106686700.0,2.6399993896484375,0.0,2.6399993896484375,81.46553402249472,118.86000061035156,133.0399932861328,99.71795975465405,-0.28204024534595934,1.0698167692052465,-0.41884077025098326,0.09726921049896853,957866400.0,1.0
AAPL,2021-04-12,131.24000549316406,132.85000610351562,130.6300048828125,132.52000427246094,91420000.0,-1.7599945068359375,1.7599945068359375,0.0,70.80857683741952,118.86000061035156,133.0399932861328,87.3061444097708,-12.693855590229205,1.4050486519286238,-0.05406288581506173,0.08114347271638245,866446400.0,-1.0
AAPL,2021-04-13,134.42999267578125,134.66000366210938,131.92999267578125,132.44000244140625,91266500.0,3.1899871826171875,0.0,3.1899871826171875,77.07924437383808,118.86000061035156,134.66000366210938,98.54423454492603,-1.455765455073981,1.9061546754415133,0.33798062643625343,0.12118424491234236,957712900.0,1.0
AAPL,2021-04-14,132.02999877929688,135.0,131.66000366210938,134.94000244140625,87222800.0,-2.399993896484375,2.399993896484375,0.0,64.96474783937902,118.86000061035156,135.0,81.59850475206358,-18.401495247936424,2.0855840448536895,0.6875013101197408,0.08088413532540795,870490100.0,-1.0
AAPL,2021-04-15,134.5,135.0,133.63999938964844,133.82000732421875,89347100.0,2.470001220703125,0.0,2.470001220703125,70.47522766121065,118.86000061035156,135.0,96.90210645038388,-3.0978935496161193,2.3994324055022247,1.029887529196238,0.0934959349593496,959837200.0,1.0
AAPL,2021-04-16,134.16000366210938,134.6699981689453,133.27999877929688,134.3000030517578,84922400.0,-0.339996337890625,0.339996337890625,0.0,68.75759679508809,118.86000061035156,135.0,94.79556152629493,-5.20443847370506,2.5908588217286876,1.342081787702728,0.06560764127181207,874914800.0,-1.0
AAPL,2021-04-19,134.83999633789062,135.47000122070312,133.33999633789062,133.50999450683594,94264200.0,0.67999267578125,0.0,0.67999267578125,70.42120744650366,118.86000061035156,135.47000122070312,96.20707489667475,-3.79292510332524,2.7655557564779656,1.6267765814577755,0.06837807872609125,969179000.0,1.0
AAPL,2021-04-20,133.11000061035156,135.52999877929688,131.80999755859375,135.02000427246094,94812300.0,-1.7299957275390625,1.7299957275390625,0.0,60.90149338379116,121.1500015258789,135.52999877929688,83.17108045086653,-16.82891954913347,2.7329049122031677,1.848002247606854,0.04073494153491852,874366700.0,-1.0
AAPL,2021-04-21,133.5,133.75,131.3000030517578,132.36000061035156,68847100.0,0.3899993896484375,0.0,0.3899993896484375,62.22961738319056,122.48999786376952,135.52999877929688,84.43252579162278,-15.567474208377222,2.707290613301865,2.0198599207458563,0.024087138500666017,943213800.0,1.0
AAPL,2021-04-22,131.94000244140625,134.14999389648438,131.41000366210938,133.0399932861328,84566500.0,-1.55999755859375,1.55999755859375,0.0,53.79562322001645,123.06999969482422,135.52999877929688,71.18782823696681,-28.812171763033195,2.531925866033191,2.122273109803323,-0.007969906455592146,858647300.0,-1.0
AAPL,2021-04-23,134.32000732421875,135.1199951171875,132.16000366210938,132.16000366210938,78657500.0,2.3800048828125,0.0,2.3800048828125,62.695752007694075,125.13999938964844,135.52999877929688,88.35426827566863,-11.645731724331382,2.555535916617657,2.20892567116619,0.023468467709071517,937304800.0,1.0
AAPL,2021-04-26,134.72000122070312,135.05999755859375,133.55999755859375,134.8300018310547,66905100.0,0.399993896484375,0.0,0.399993896484375,64.03903624878444,125.13999938964844,135.52999877929688,92.2040653881005,-7.795934611899506,2.5768192480869345,2.282504386550339,0.002157320246392702,1004209900.0,1.0
AAPL,2021-04-27,134.38999938964844,135.41000366210938,134.11000061035156,135.00999450683594,66015800.0,-0.3300018310546875,0.3300018310546875,0.0,61.91663322708231,128.52000427246094,135.52999877929688,83.73751379495741,-16.26248620504259,2.537803828976479,2.333564275035567,0.01787473022927588,938194100.0,-1.0
AAPL,2021-04-28,133.5800018310547,135.02000427246094,133.0800018310547,134.30999755859375,107760100.0,-0.80999755859375,0.80999755859375,0.0,56.60360160803273,129.47000122070312,135.52999877929688,67.82181957355948,-32.17818042644052,2.4137001617065152,2.349591452369757,-0.006840135085095289,830434000.0,-1.0
AAPL,2021-04-29,133.47999572753906,137.07000732421875,132.4499969482422,136.47000122070312,151101000.0,-0.100006103515625,0.100006103515625,0.0,55.920015771461976,130.6300048828125,137.07000732421875,44.25449944556595,-55.745500554434045,2.2809836943432913,2.335869900764464,-0.005068633840253578,679333000.0,-1.0
AAPL,2021-04-30,131.4600067138672,133.55999755859375,131.07000732421875,131.77999877929688,109839500.0,-2.019989013671875,2.019989013671875,0.0,43.637678115954856,131.07000732421875,137.07000732421875,6.499989827473958,-93.50001017252603,1.9898707151844803,2.2666700636484673,-0.025066669503265526,569493500.0,-1.0
AAPL,2021-05-03,132.5399932861328,134.07000732421875,131.8300018310547,132.0399932861328,75135100.0,1.079986572265625,0.0,1.079986572265625,50.36331984976042,131.07000732421875,137.07000732421875,24.49976603190104,-75.50023396809897,1.8252669314062757,2.178389437200029,-0.004282227643340741,644628600.0,1.0
AAPL,2021-05-04,127.8499984741211,131.49000549316406,126.6999969482422,131.19000244140625,137564700.0,-4.689994812011719,4.689994812011719,0.0,31.51794826845719,126.6999969482422,137.07000732421875,11.089685392630052,-88.91031460736994,1.3013724499239743,2.002986039744818,-0.04232210880808174,507063900.0,-1.0
AAPL,2021-05-05,128.10000610351562,130.4499969482422,127.97000122070312,129.1999969482422,84000900.0,0.25000762939453125,0.0,0.25000762939453125,33.05863285942597,126.6999969482422,137.07000732421875,13.500556937886223,-86.49944306211378,0.896026983871792,1.7815942285702127,-0.029104109950247592,591064800.0,1.0
AAPL,2021-05-06,129.74000549316406,129.75,127.12999725341795,127.88999938964844,78128300.0,1.6399993896484375,0.0,1.6399993896484375,42.79906901390096,126.6999969482422,137.07000732421875,29.31538575857579,-70.68461424142421,0.699063655695511,1.5650881139952724,-0.03409768896155263,669193100.0,1.0
AAPL,2021-05-07,130.2100067138672,131.25999450683594,129.47999572753906,130.85000610351562,78973300.0,0.470001220703125,0.0,0.470001220703125,45.42498539930619,126.6999969482422,137.07000732421875,33.84769772030673,-66.15230227969326,0.5742740953205043,1.366925310260319,-0.0334767997770985,748166400.0,1.0
AAPL,2021-05-10,126.8499984741211,129.5399932861328,126.80999755859376,129.41000366210938,88071200.0,-3.3600082397460938,3.3600082397460938,0.0,32.948282364864596,126.6999969482422,137.07000732421875,1.446493498467366,-98.55350650153262,0.20192521726650625,1.1339252916615565,-0.05610537204979049,660095200.0,-1.0
AAPL,2021-05-11,125.91000366210938,126.2699966430664,122.7699966430664,123.5,126142800.0,-0.9399948120117188,0.9399948120117188,0.0,30.264929825127652,122.7699966430664,137.07000732421875,21.958074641031917,-78.04192535896807,-0.1670875948991295,0.8737227143494193,-0.05741876077113661,533952400.0,-1.0
AAPL,2021-05-12,122.7699966430664,124.63999938964844,122.25,123.4000015258789,112172300.0,-3.1400070190429688,3.1400070190429688,0.0,23.034339097589708,122.25,137.07000732421875,3.5087475443863743,-96.49125245561363,-0.7047809552947797,0.5580219804205794,-0.0802367352957819,421780100.0,-1.0
AAPL,2021-05-13,124.97000122070312,126.1500015258789,124.26000213623048,124.58000183105467,105861300.0,2.2000045776367188,0.0,2.2000045776367188,35.49325150525762,122.25,137.07000732421875,18.353575414622895,-81.6464245853771,-0.9425200496366131,0.2579135744091408,-0.04936866850532007,527641400.0,1.0
AAPL,2021-05-14,127.4499969482422,127.88999938964844,125.8499984741211,126.25,81918000.0,2.4799957275390767,0.0,2.4799957275390767,46.71292601753368,122.25,137.07000732421875,35.087681365341865,-64.91231863465813,-0.9202074866011003,0.022289362207092506,-0.03840347514506148,609559400.0,1.0
AAPL,2021-05-17,126.2699966430664,126.93000030517578,125.16999816894533,126.81999969482422,74244600.0,-1.1800003051757955,1.1800003051757955,0.0,42.64115659924099,122.25,137.07000732421875,27.125470015773583,-72.87452998422641,-0.9863705172668489,-0.17944261368769585,-0.012358246772873449,535314800.0,-1.0
AAPL,2021-05-18,124.8499984741211,126.98999786376952,124.77999877929688,126.55999755859376,63342900.0,-1.4199981689453125,1.4199981689453125,0.0,38.03741753802917,122.25,137.07000732421875,17.543840682670883,-82.45615931732911,-1.1402431671084088,-0.3716027243718385,-0.025370862408611083,471971900.0,-1.0
AAPL,2021-05-19,124.69000244140624,124.91999816894533,122.86000061035156,123.16000366210938,92612000.0,-0.15999603271485796,0.15999603271485796,0.0,37.51090513766435,122.25,134.07000732421875,20.642985866910273,-79.35701413308973,-1.2605676541568158,-0.549395710328834,-0.03892402372392312,379359900.0,-1.0
AAPL,2021-05-20,127.30999755859376,127.72000122070312,125.0999984741211,125.2300033569336,76857100.0,2.6199951171875284,0.0,2.6199951171875284,50.465989533817485,122.25,134.07000732421875,42.80875146520442,-57.19124853479558,-1.1314710730758435,-0.665810782878236,-0.02227178408527475,456217000.0,1.0
AAPL,2021-05-21,125.43000030517578,128.0,125.20999908447266,127.81999969482422,79295400.0,-1.879997253417983,1.879997253417983,0.0,43.07262685618023,122.25,131.49000549316406,34.415567258357235,-65.58443274164276,-1.1674040616970274,-0.7661294386419943,-0.011194309704583905,376921600.0,-1.0
AAPL,2021-05-24,127.0999984741211,127.94000244140624,125.94000244140624,126.01000213623048,63092900.0,1.6699981689453125,0.0,1.6699981689453125,50.50475788201961,122.25,131.25999450683594,53.82909468414626,-46.17090531585374,-1.0490337109666825,-0.8227102931069321,0.009451153819399316,440014500.0,1.0
AAPL,2021-05-25,126.9000015258789,128.32000732421875,126.31999969482422,127.81999969482422,72009500.0,-0.1999969482421875,0.1999969482421875,0.0,49.60977495460109,122.25,131.25999450683594,51.60937137476523,-48.39062862523477,-0.9602927800722654,-0.8502267904999989,0.03364018079123854,368005000.0,-1.0
AAPL,2021-05-26,126.8499984741211,127.38999938964844,126.41999816894533,126.95999908447266,56575900.0,-0.0500030517578125,0.0500030517578125,0.0,49.3574523026007,122.25,131.25999450683594,51.05439820891174,-48.94560179108825,-0.8838117496818398,-0.856943782336367,0.015043588341635772,311429100.0,-1.0
AAPL,2021-05-27,125.27999877929688,127.63999938964844,125.08000183105467,126.44000244140624,94625600.0,-1.5699996948242188,1.5699996948242188,0.0,41.67775257414815,122.25,129.5399932861328,41.563807542328,-58.436192457672,-0.9390609266018402,-0.8733672111894616,-0.017026270858418013,216803500.0,-1.0
AAPL,2021-05-28,124.61000061035156,125.8000030517578,124.5500030517578,125.56999969482422,71311100.0,-0.6699981689453125,0.6699981689453125,0.0,38.711846795773695,122.25,128.32000732421875,38.87969955053242,-61.12030044946758,-1.025092917134728,-0.9037123523785149,-0.013146401178794953,145492400.0,-1.0
AAPL,2021-06-01,124.27999877929688,125.3499984741211,123.94000244140624,125.08000183105467,67637100.0,-0.3300018310546875,0.3300018310546875,0.0,37.20707970965809,122.25,128.32000732421875,33.443102633457684,-66.55689736654232,-1.1071398601475977,-0.9443978539323314,-0.004565476185747541,77855300.0,-1.0
AAPL,2021-06-02,125.05999755859376,125.23999786376952,124.0500030517578,124.27999877929688,59278900.0,0.7799987792968892,0.0,0.7799987792968892,43.225771627815554,122.86000061035156,128.32000732421875,40.29293485399395,-59.70706514600606,-1.0965825497990522,-0.9748347931056756,0.00296731983273002,137134200.0,1.0
AAPL,2021-06-03,123.54000091552734,124.8499984741211,123.12999725341795,124.68000030517578,76229200.0,-1.5199966430664205,1.5199966430664205,0.0,35.56154024265169,122.86000061035156,128.32000732421875,12.454202729251845,-87.54579727074815,-1.1970677790320252,-1.0192813902909457,-0.029612730463931536,60905000.0,-1.0
AAPL,2021-06-04,125.88999938964844,126.16000366210938,123.8499984741211,124.06999969482422,75169300.0,2.3499984741210938,0.0,2.3499984741210938,51.045751809805445,122.86000061035156,128.32000732421875,55.49441489881982,-44.50558510118018,-1.0746894589397442,-1.0303630040207055,0.003667376890325036,136074300.0,1.0
AAPL,2021-06-07,125.9000015258789,126.31999969482422,124.83000183105467,126.16999816894533,71057600.0,0.01000213623046875,0.0,0.01000213623046875,51.103454387713256,122.86000061035156,128.32000732421875,55.67760398181244,-44.32239601818756,-0.9657639441944639,-1.0174431920554572,-0.00944136083909175,207131900.0,1.0
AAPL,2021-06-08,126.73999786376952,128.4600067138672,126.20999908447266,126.5999984741211,74403800.0,0.8399963378906108,0.0,0.8399963378906108,56.11584704213157,122.86000061035156,128.4600067138672,69.28558972430643,-30.714410275693577,-0.8024093294006036,-0.9744364195244865,-0.001260864146457541,281535700.0,1.0
AAPL,2021-06-09,127.12999725341795,127.75,126.5199966430664,127.20999908447266,56877900.0,0.3899993896484375,0.0,0.3899993896484375,58.40034650756721,123.12999725341795,128.4600067138672,75.0467711114131,-24.953228888586903,-0.6341696163064086,-0.9063830588808709,0.0022073218972404884,338413600.0,1.0
AAPL,2021-06-10,126.11000061035156,128.19000244140625,125.94000244140624,127.0199966430664,71186400.0,-1.019996643066392,1.019996643066392,0.0,50.4714642781952,123.12999725341795,128.4600067138672,55.909907459759786,-44.090092540240214,-0.576498124681649,-0.8404060720410266,0.0066251743226537485,267227200.0,-1.0
AAPL,2021-06-11,127.3499984741211,127.44000244140624,126.0999984741211,126.52999877929688,53522400.0,1.2399978637695312,0.0,1.2399978637695312,58.394895028483695,123.12999725341795,128.4600067138672,79.17436642499808,-20.825633575001913,-0.4258269198923159,-0.7574902416112844,0.021988587194837983,320749600.0,1.0
AAPL,2021-06-14,130.47999572753906,130.5399932861328,127.06999969482422,127.81999969482422,96906500.0,3.1299972534179688,0.0,3.1299972534179688,71.61879457326451,123.12999725341795,130.5399932861328,99.19031591476077,-0.8096840852392229,-0.053240560655012814,-0.6166403054200301,0.04988732707708232,417656100.0,1.0
AAPL,2021-06-15,129.63999938964844,130.60000610351562,129.38999938964844,129.94000244140625,62746300.0,-0.839996337890625,0.839996337890625,0.0,65.20150169197142,123.12999725341795,130.60000610351562,87.14851972558726,-12.851480274412733,0.17227030422233724,-0.45885818349155666,0.036622436594154095,354909800.0,-1.0
AAPL,2021-06-16,130.14999389648438,130.88999938964844,128.4600067138672,130.3699951171875,91815000.0,0.5099945068359375,0.0,0.5099945068359375,67.25683171496932,123.12999725341795,130.88999938964844,90.46384936275895,-9.536150637241054,0.38767273389692036,-0.2895520000138612,0.05350488045954216,446724800.0,1.0
AAPL,2021-06-17,131.7899932861328,132.5500030517578,129.64999389648438,129.8000030517578,96721700.0,1.6399993896484375,0.0,1.6399993896484375,73.14268854298142,123.12999725341795,132.5500030517578,91.93196074508849,-8.06803925491151,0.6828435604925573,-0.09507288791257745,0.04686626360385482,543446500.0,1.0
AAPL,2021-06-18,130.4600067138672,131.50999450683594,130.24000549316406,130.7100067138672,108953300.0,-1.329986572265625,1.329986572265625,0.0,62.61114316221537,123.12999725341795,132.5500030517578,77.81321601459145,-22.186783985408557,0.8002252671831371,0.08398674310656552,0.03621926237269313,434493200.0,-1.0
AAPL,2021-06-21,132.3000030517578,132.41000366210938,129.2100067138672,130.3000030517578,79663300.0,1.839996337890625,0.0,1.839996337890625,69.59877318644794,123.12999725341795,132.5500030517578,97.34607382042101,-2.6539261795789866,1.0298519501805572,0.27315978452136397,0.04386938047738198,514156500.0,1.0
AAPL,2021-06-22,133.97999572753906,134.0800018310547,131.6199951171875,132.1300048828125,74783600.0,1.67999267578125,0.0,1.67999267578125,74.59983853253904,123.12999725341795,134.0800018310547,99.08670263280193,-0.9132973671980753,1.3320392007373414,0.4849356677645595,0.053881842382695,588940100.0,1.0
AAPL,2021-06-23,133.6999969482422,134.32000732421875,133.22999572753906,133.77000427246094,60214200.0,-0.279998779296875,0.279998779296875,0.0,72.31223958327467,123.8499984741211,134.32000732421875,94.07822491028,-5.9217750897200006,1.5312795747539951,0.6942044491624467,0.06018552296531832,528725900.0,-1.0
AAPL,2021-06-24,133.41000366210938,134.63999938964844,132.92999267578125,134.4499969482422,68711000.0,-0.2899932861328125,0.2899932861328125,0.0,69.75599019746406,124.83000183105467,134.63999938964844,87.46181413203757,-12.53818586796243,1.6467957358476042,0.8847227064994783,0.047585435890050265,460014900.0,-1.0
AAPL,2021-06-25,133.11000061035156,133.88999938964844,132.80999755859375,133.4600067138672,70783700.0,-0.3000030517578125,0.3000030517578125,0.0,66.93170260925552,125.94000244140624,134.63999938964844,82.4138009656888,-17.58619903431121,1.6946010803152092,1.0466983812626247,0.020156383882049766,389231200.0,-1.0
AAPL,2021-06-28,134.77999877929688,135.25,133.35000610351562,133.41000366210938,62111300.0,1.6699981689453125,0.0,1.6699981689453125,73.7564704498107,125.94000244140624,135.25,94.95165044088243,-5.048349559117572,1.8459629439556409,1.206551293801228,0.03964825218950785,451342500.0,1.0
AAPL,2021-06-29,136.3300018310547,136.49000549316406,134.35000610351562,134.8000030517578,64556100.0,1.5500030517578125,0.0,1.5500030517578125,78.50695993431191,125.94000244140624,136.49000549316406,98.48337804904507,-1.5166219509549375,2.0671616510054776,1.378673365242078,0.04748373587697308,515898600.0,1.0
AAPL,2021-06-30,136.9600067138672,137.41000366210938,135.8699951171875,136.1699981689453,63261400.0,0.6300048828125,0.0,0.6300048828125,80.18880526242802,126.0999984741211,137.41000366210938,96.0212489670641,-3.978751032935899,2.2671648833514553,1.5563716688639535,0.03922918044702839,579160000.0,1.0
AAPL,2021-07-01,137.27000427246094,137.3300018310547,135.75999450683594,136.60000610351562,52485800.0,0.30999755859375,0.0,0.30999755859375,81.031524480664,127.06999969482422,137.41000366210938,98.64604123855868,-1.3539587614413204,2.4227550856373625,1.7296483522186357,0.05219988661758879,631645800.0,1.0
AAPL,2021-07-02,139.9600067138672,140.0,137.75,137.89999389648438,78852600.0,2.69000244140625,0.0,2.69000244140625,86.69725399825262,128.4600067138672,140.0,99.65343752685826,-0.3465624731417389,2.7316335860517142,1.9300453989852513,0.057898741386367636,710498400.0,1.0
AAPL,2021-07-06,142.02000427246094,143.14999389648438,140.07000732421875,140.07000732421875,108181800.0,2.05999755859375,0.0,2.05999755859375,89.47507550584608,128.4600067138672,143.14999389648438,92.30775622894643,-7.692243771053564,3.1068329732607083,2.1654029138403432,0.06000902225188898,818680200.0,1.0
AAPL,2021-07-07,144.57000732421875,144.88999938964844,142.66000366210938,143.5399932861328,104911600.0,2.5500030517578125,0.0,2.5500030517578125,91.89301019267494,129.2100067138672,144.88999938964844,97.95923332334246,-2.040766676657545,3.568806150008953,2.446083561074065,0.08130150055414398,923591800.0,1.0
AAPL,2021-07-08,143.24000549316406,144.05999755859375,140.6699981689453,141.5800018310547,105575500.0,-1.3300018310546875,1.3300018310546875,0.0,80.73138521625634,129.2100067138672,144.88999938964844,89.47707482648958,-10.522925173510417,3.783983778887034,2.7136636046366593,0.07368264418874726,818016300.0,-1.0
AAPL,2021-07-09,145.11000061035156,145.64999389648438,142.64999389648438,142.75,99890800.0,1.8699951171875,0.0,1.8699951171875,83.90327820336962,129.2100067138672,145.64999389648438,96.71536674490979,-3.2846332550902115,4.058621317653888,2.9826551472401053,0.09015100251653663,917907100.0,1.0
AAPL,2021-07-12,144.5,146.32000732421875,144.0,146.2100067138672,76299700.0,-0.6100006103515625,0.6100006103515625,0.0,79.00800609162467,131.6199951171875,146.32000732421875,87.61900807573335,-12.380991924266645,4.178880066373068,3.221900131066698,0.07211753456549364,841607400.0,-1.0
AAPL,2021-07-13,145.63999938964844,147.4600067138672,143.6300048828125,144.02999877929688,100827100.0,1.1399993896484375,0.0,1.1399993896484375,81.35389906791036,132.80999755859375,147.4600067138672,87.57674957790988,-12.423250422090131,4.316417441137844,3.4408035930809273,0.06829015941869532,942434500.0,1.0
AAPL,2021-07-14,149.14999389648438,149.57000732421875,147.67999267578125,148.10000610351562,127050800.0,3.5099945068359375,0.0,3.5099945068359375,86.6528750773177,132.80999755859375,149.57000732421875,97.49395475534968,-2.5060452446503225,4.654984263038557,3.6836397270724532,0.08900399083715116,1069485300.0,1.0
AAPL,2021-07-15,148.47999572753906,150.0,147.08999633789062,149.24000549316406,106820300.0,-0.6699981689453125,0.6699981689453125,0.0,81.54858399757816,132.80999755859375,150.0,91.15762619789022,-8.842373802109778,4.813747767996034,3.9096613352571694,0.08166380932594652,962665000.0,-1.0
AAPL,2021-07-16,146.38999938964844,149.75999450683594,145.8800048828125,148.4600067138672,93251400.0,-2.089996337890625,2.089996337890625,0.0,67.28332347895358,133.35000610351562,150.0,78.31830670452192,-21.681693295478084,4.716554250418795,4.071039918289495,0.04594164309327775,869413600.0,-1.0
AAPL,2021-07-19,142.4499969482422,144.07000732421875,141.6699981689453,143.75,121434600.0,-3.94000244140625,3.94000244140625,0.0,48.73814085987241,134.35000610351562,150.0,51.75715018359304,-48.24284981640696,4.2723533880405,4.111302612239696,0.003027690908643521,747979000.0,-1.0
AAPL,2021-07-20,146.14999389648438,147.10000610351562,142.9600067138672,143.4600067138672,96350000.0,3.6999969482421875,0.0,3.6999969482421875,60.527100678428376,135.75999450683594,150.0,72.96345071380887,-27.036549286191125,4.170801433181765,4.123202376428109,0.010928868314451057,844329000.0,1.0
AAPL,2021-07-21,145.39999389648438,146.1300048828125,144.6300048828125,145.52999877929688,74993500.0,-0.75,0.75,0.0,57.43762073311763,135.75999450683594,150.0,67.69659881294382,-32.30340118705618,3.983878375293216,4.09533757620113,0.01507950516954848,769335500.0,-1.0
AAPL,2021-07-22,146.8000030517578,148.1999969482422,145.80999755859375,145.94000244140625,77338200.0,1.4000091552734375,0.0,1.4000091552734375,61.65341773597508,137.75,150.0,73.87757593271684,-26.122424067283163,3.903710004715265,4.057012061903957,0.011646354036922935,846673700.0,1.0
AAPL,2021-07-23,148.55999755859375,148.72000122070312,146.9199981689453,147.5500030517578,71447400.0,1.7599945068359375,0.0,1.7599945068359375,66.47074392859707,140.07000732421875,150.0,85.49845414369395,-14.50154585630605,3.936811726263983,4.032971994775962,0.028096868917603768,918121100.0,1.0
AAPL,2021-07-26,148.99000549316406,149.8300018310547,147.6999969482422,148.27000427246094,72434100.0,0.4300079345703125,0.0,0.4300079345703125,67.61758105250874,140.6699981689453,150.0,89.17476625273325,-10.825233747266747,3.9521847994514587,4.016814555711061,0.023001964553384546,990555200.0,1.0
AAPL,2021-07-27,146.77000427246094,149.2100067138672,145.5500030517578,149.1199951171875,104818600.0,-2.220001220703125,2.220001220703125,0.0,56.172338951676785,140.6699981689453,150.0,65.38054562017234,-34.61945437982766,3.742095972525732,3.9618708390739954,-0.015957021263274362,885736600.0,-1.0
AAPL,2021-07-28,144.97999572753906,146.97000122070312,142.5399932861328,144.80999755859375,118931200.0,-1.790008544921875,1.790008544921875,0.0,48.53001296988519,141.6699981689453,150.0,39.73585631462774,-60.26414368537226,3.392058791464507,3.8479084295520978,-0.023572198954143975,766805400.0,-1.0
AAPL,2021-07-29,145.63999938964844,146.5500030517578,144.5800018310547,144.69000244140625,56699500.0,0.660003662109375,0.0,0.660003662109375,51.34618449257225,141.6699981689453,150.0,47.6590678035958,-52.3409321964042,3.131807060927116,3.704688155827102,-0.005123300793271501,823504900.0,1.0
AAPL,2021-07-30,145.86000061035156,146.3300018310547,144.11000061035156,144.3800048828125,70440600.0,0.220001220703125,0.0,0.220001220703125,52.34896081774183,141.6699981689453,150.0,50.30013829991849,-49.69986170008151,2.909765978414839,3.5457037203446493,0.02393825015909523,893945500.0,1.0
AAPL,2021-08-02,145.52000427246094,146.9499969482422,145.25,146.36000061035156,62880000.0,-0.339996337890625,0.339996337890625,0.0,50.493220123180315,141.6699981689453,150.0,46.218550506947054,-53.781449493052946,2.6755202260915496,3.371667021494029,-0.004310568938303505,831065500.0,-1.0
AAPL,2021-08-03,147.36000061035156,148.0399932861328,145.17999267578125,145.80999755859375,64786600.0,1.839996337890625,0.0,1.839996337890625,59.46586978581034,141.6699981689453,150.0,68.30733722282773,-31.69266277717227,2.608284427423939,3.2189905026800116,0.013480101761645047,895852100.0,1.0
AAPL,2021-08-04,146.9499969482422,147.7899932861328,146.27999877929688,147.27000427246094,56368300.0,-0.410003662109375,0.410003662109375,0.0,56.81820950823687,141.6699981689453,149.8300018310547,64.70583835414587,-35.29416164585414,2.493175923485609,3.0738275868411313,0.0010217567667998306,839483800.0,-1.0
AAPL,2021-08-05,147.05999755859375,147.83999633789062,146.1699981689453,146.97999572753906,46397700.0,0.1100006103515625,0.0,0.1100006103515625,57.40530035619801,141.6699981689453,149.8300018310547,66.05388444464391,-33.946115555356094,2.3833539144054328,2.935732852353992,-0.010096930699048934,885881500.0,1.0
AAPL,2021-08-06,146.13999938964844,147.11000061035156,145.6300048828125,146.35000610351562,54126800.0,-0.9199981689453125,0.9199981689453125,0.0,50.74711614759153,142.5399932861328,149.8300018310547,49.38274189024569,-50.61725810975432,2.1967601341058867,2.7879383087043714,-0.019128840851317275,831754700.0,-1.0
AAPL,2021-08-09,146.08999633789062,146.6999969482422,145.52000427246094,146.1999969482422,48908700.0,-0.0500030517578125,0.0500030517578125,0.0,50.38065739626948,142.5399932861328,149.8300018310547,48.696829775744206,-51.30317022425579,2.0215452749377505,2.6346597019510476,-0.004633153333619577,782846000.0,-1.0
AAPL,2021-08-10,145.60000610351562,147.7100067138672,145.3000030517578,146.44000244140625,69023100.0,-0.489990234375,0.489990234375,0.0,46.577626086795554,142.5399932861328,149.8300018310547,41.975435262203874,-58.024564737796126,1.8221435828195638,2.472156478124751,0.004276523618760075,713822900.0,-1.0
AAPL,2021-08-11,145.86000061035156,146.72000122070312,145.52999877929688,146.0500030517578,48493500.0,0.2599945068359375,0.0,0.2599945068359375,48.93752077351038,142.5399932861328,149.8300018310547,45.541885222225474,-54.458114777774526,1.665892319365497,2.3109036463729002,0.001510582406104799,762316400.0,1.0
AAPL,2021-08-12,148.88999938964844,149.0500030517578,145.83999633789062,146.19000244140625,72282600.0,3.029998779296875,0.0,3.029998779296875,67.96607472414031,142.5399932861328,149.8300018310547,87.1056057669364,-12.894394233063602,1.7661980147870793,2.2019625200557362,0.020773335846824503,834599000.0,1.0
AAPL,2021-08-13,149.10000610351562,149.44000244140625,148.27000427246094,148.97000122070312,59375000.0,0.2100067138671875,0.0,0.2100067138671875,68.8931159163342,142.5399932861328,149.44000244140625,95.07252338019323,-4.927476619806766,1.841410157721782,2.1298520475889453,0.024601441217330988,893974000.0,1.0
AAPL,2021-08-16,151.1199951171875,151.19000244140625,146.47000122070312,148.5399932861328,103296000.0,2.019989013671875,0.0,2.019989013671875,76.45528055859344,142.5399932861328,151.19000244140625,99.19066762864557,-0.8093323713544323,2.0404910439296486,2.111979846857086,0.025515706373930414,997270000.0,1.0
AAPL,2021-08-17,150.19000244140625,151.67999267578125,149.08999633789062,150.22999572753906,92229700.0,-0.92999267578125,0.92999267578125,0.0,67.71094312351194,144.11000061035156,151.67999267578125,80.31714932464166,-19.682850675358342,2.099025188116485,2.109388915108966,0.022048353592720726,905040300.0,-1.0
AAPL,2021-08-18,146.36000061035156,150.72000122070312,146.14999389648438,149.8000030517578,86326000.0,-3.8300018310546875,3.8300018310546875,0.0,43.868897951613356,144.11000061035156,151.67999267578125,29.722620321825737,-70.27737967817427,1.8154375460349286,2.0505986412941586,-0.004759941247539312,818714300.0,-1.0
AAPL,2021-08-19,146.6999969482422,148.0,144.5,145.02999877929688,86960300.0,0.339996337890625,0.0,0.339996337890625,45.822893692731185,144.5,151.67999267578125,30.640657276197114,-69.35934272380288,1.5996869639961062,1.960416305834548,0.003831925283512838,905674600.0,1.0
AAPL,2021-08-20,148.19000244140625,148.5,146.77999877929688,147.44000244140625,60549600.0,1.4900054931640625,0.0,1.4900054931640625,53.93212614571587,144.5,151.67999267578125,51.39284408816954,-48.60715591183046,1.5312823938876363,1.874589523445166,0.01437474266655836,966224200.0,1.0
AAPL,2021-08-23,149.7100067138672,150.19000244140625,147.88999938964844,148.30999755859375,60131800.0,1.5200042724609375,0.0,1.5200042724609375,60.832797494189954,144.5,151.67999267578125,72.56284162295876,-27.437158377041236,1.5814924601939992,1.8159701107949326,0.028228024986685307,1026356000.0,1.0
AAPL,2021-08-24,149.6199951171875,150.86000061035156,149.14999389648438,149.4499969482422,48606400.0,-0.0900115966796875,0.0900115966796875,0.0,60.21647212159404,144.5,151.67999267578125,71.30919693633805,-28.69080306366194,1.5956277128619263,1.7719016312083316,0.02577810565680938,977749600.0,-1.0
AAPL,2021-08-25,148.36000061035156,150.32000732421875,147.8000030517578,149.80999755859375,58991300.0,-1.2599945068359375,1.2599945068359375,0.0,51.74835426349696,144.5,151.67999267578125,53.76050902352151,-46.239490976478486,1.4880061671092903,1.7151225383885231,-0.0035596667437002294,918758300.0,-1.0
AAPL,2021-08-26,147.5399932861328,149.1199951171875,147.50999450683594,148.35000610351562,48597200.0,-0.82000732421875,0.82000732421875,0.0,46.80562707662458,144.5,151.67999267578125,42.33978255140814,-57.66021744859186,1.3213162673128807,1.6363612841733945,-0.010462862196663814,870161100.0,-1.0
AAPL,2021-08-27,148.60000610351562,148.75,146.8300018310547,147.47999572753906,55802400.0,1.0600128173828125,0.0,1.0600128173828125,53.43899030852909,144.5,151.67999267578125,57.103207324226226,-42.896792675773774,1.2602204592600401,1.5611331191907238,-0.016675417516508806,925963500.0,1.0
AAPL,2021-08-30,153.1199951171875,153.49000549316406,148.61000061035156,149.0,90956700.0,4.519989013671875,0.0,4.519989013671875,71.14355066668823,144.5,153.49000549316406,95.88420300457085,-4.115796995429156,1.5585608106311213,1.5606186574788035,0.019508573328137047,1016920200.0,1.0
AAPL,2021-08-31,151.8300018310547,152.8000030517578,151.2899932861328,152.66000366210938,86453100.0,-1.2899932861328125,1.2899932861328125,0.0,63.22655748320664,144.5,153.49000549316406,81.53500947945327,-18.46499052054674,1.671636427077857,1.5828222113986143,0.03737360752864238,930467100.0,-1.0
AAPL,2021-09-01,152.50999450683594,154.97999572753906,152.33999633789062,152.8300018310547,80313700.0,0.67999267578125,0.0,0.67999267578125,65.55776408084702,144.5,154.97999572753906,76.43127645355314,-23.568723546446872,1.7954228764693596,1.6253423444127637,0.039604619491870885,1010780800.0,1.0
AAPL,2021-09-02,153.64999389648438,154.72000122070312,152.39999389648438,153.8699951171875,71115500.0,1.1399993896484375,0.0,1.1399993896484375,69.32003160805115,144.5,154.97999572753906,87.30913765966771,-12.690862340332288,1.962886024580314,1.6928510804462737,0.03684453313398772,1081896300.0,1.0
AAPL,2021-09-03,154.3000030517578,154.6300048828125,153.08999633789062,153.75999450683594,57808700.0,0.6500091552734375,0.0,0.6500091552734375,71.37703813816385,144.5,154.97999572753906,93.51151762405415,-6.488482375945849,2.123572856431707,1.7789954356433604,0.030659248761261804,1139705000.0,1.0
AAPL,2021-09-07,156.69000244140625,157.25999450683594,154.38999938964844,154.97000122070312,82278300.0,2.3899993896484375,0.0,2.3899993896484375,77.7157954207243,144.5,157.25999450683594,95.53297562060608,-4.467024379393929,2.415922059404835,1.9063807603956555,0.04725309153152479,1221983300.0,1.0
AAPL,2021-09-08,155.11000061035156,157.0399932861328,153.97999572753906,156.97999572753906,74420200.0,-1.5800018310546875,1.5800018310546875,0.0,66.48476960147609,144.5,157.25999450683594,83.15051079894623,-16.849489201053768,2.4913986728249427,2.023384342881513,0.04549743847553622,1147563100.0,-1.0
AAPL,2021-09-09,154.07000732421875,156.11000061035156,153.9499969482422,155.49000549316406,57305700.0,-1.0399932861328125,1.0399932861328125,0.0,59.90932111620172,146.77999877929688,157.25999450683594,69.56117859633643,-30.438821403663567,2.4391783366070285,2.106543141626616,0.04425928111181299,1090257400.0,-1.0
AAPL,2021-09-10,148.97000122070312,155.47999572753906,148.6999969482422,155.0,140893200.0,-5.100006103515625,5.100006103515625,0.0,38.412829770543006,146.8300018310547,157.25999450683594,20.517745852473887,-79.4822541475261,1.9636299699267283,2.0779605072866385,0.002489872826315853,949364200.0,-1.0
AAPL,2021-09-13,149.5500030517578,151.4199981689453,148.75,150.6300048828125,102404300.0,0.5800018310546875,0.0,0.5800018310546875,41.182245763493974,146.8300018310547,157.25999450683594,26.078649384088713,-73.92135061591128,1.6149397435812318,1.9853563545455573,-0.02331499594613662,1051768500.0,1.0
AAPL,2021-09-14,148.1199951171875,151.07000732421875,146.91000366210938,150.35000610351562,109296300.0,-1.4300079345703125,1.4300079345703125,0.0,36.511515425710336,146.8300018310547,157.25999450683594,12.368113058489627,-87.63188694151037,1.2092708165518786,1.8301392469468218,-0.024435267530296234,942472200.0,-1.0
AAPL,2021-09-15,149.02999877929688,149.44000244140625,146.3699951171875,148.55999755859375,83281300.0,0.910003662109375,0.0,0.910003662109375,41.39222122413012,146.3699951171875,157.25999450683594,24.42611396872859,-75.57388603127141,0.9502510568361515,1.6541616089246878,-0.0228181486648934,1025753500.0,1.0
AAPL,2021-09-16,148.7899932861328,148.97000122070312,147.22000122070312,148.44000244140625,68034100.0,-0.2400054931640625,0.2400054931640625,0.0,40.44600743054449,146.3699951171875,157.25999450683594,22.222206653617064,-77.77779334638294,0.7173405384379805,1.4667973948273465,-0.03163033389787051,957719400.0,-1.0
AAPL,2021-09-17,146.05999755859375,148.82000732421875,145.75999450683594,148.82000732421875,129868800.0,-2.7299957275390625,2.7299957275390625,0.0,31.1116855098399,145.75999450683594,157.25999450683594,2.6087221891983696,-97.39127781080164,0.3089085296506653,1.2352196217920104,-0.053402497279277816,827850600.0,-1.0
AAPL,2021-09-20,142.94000244140625,144.83999633789062,141.27000427246094,143.8000030517578,123478900.0,-3.1199951171875,3.1199951171875,0.0,23.85258995215746,141.27000427246094,157.25999450683594,10.44402244446141,-89.55597755553859,-0.26349688293154827,0.9354763208472986,-0.08775288650047586,704371700.0,-1.0
AAPL,2021-09-21,143.42999267578125,144.60000610351562,142.77999877929688,143.92999267578125,75834000.0,0.489990234375,0.0,0.489990234375,26.941540125720607,141.27000427246094,157.25999450683594,13.508378502175738,-86.49162149782426,-0.6698723084753908,0.6144065949827606,-0.07530144986532106,780205700.0,1.0
AAPL,2021-09-22,145.85000610351562,146.42999267578125,143.6999969482422,144.4499969482422,76404300.0,2.420013427734375,0.0,2.420013427734375,40.659389616271866,141.27000427246094,157.25999450683594,28.64293075807314,-71.35706924192687,-0.7875742367206442,0.3340104286420796,-0.053352377685069396,856610000.0,1.0
AAPL,2021-09-23,146.8300018310547,147.0800018310547,145.63999938964844,146.64999389648438,64838200.0,0.9799957275390625,0.0,0.9799957275390625,45.445679364879176,141.27000427246094,157.25999450683594,34.771738300633636,-65.22826169936636,-0.7926393448388183,0.10868047394589997,-0.014365304236508503,921448200.0,1.0
AAPL,2021-09-24,146.9199981689453,147.47000122070312,145.55999755859375,145.66000366210938,53477900.0,0.089996337890625,0.0,0.089996337890625,45.907984484407606,141.27000427246094,157.25999450683594,35.334567524238494,-64.6654324757615,-0.7803956123379692,-0.06913474331087392,-0.017586123899324013,974926100.0,1.0
AAPL,2021-09-27,145.3699951171875,145.9600067138672,143.82000732421875,145.47000122070312,74150700.0,-1.5500030517578125,1.5500030517578125,0.0,39.29115466367953,141.27000427246094,157.0399932861328,25.998691826430914,-74.00130817356909,-0.8855565142243904,-0.23241909749357728,-0.018566028157267267,900775400.0,-1.0
AAPL,2021-09-28,141.91000366210938,144.75,141.69000244140625,143.25,108972300.0,-3.459991455078125,3.459991455078125,0.0,28.653787416720135,141.27000427246094,156.11000061035156,4.312665414979528,-95.68733458502047,-1.233866436458186,-0.43270856528649904,-0.04777558327522846,791803100.0,-1.0
AAPL,2021-09-29,142.8300018310547,144.4499969482422,142.02999877929688,142.47000122070312,74602000.0,0.9199981689453125,0.0,0.9199981689453125,34.12542159465137,141.27000427246094,155.47999572753906,10.978173797819313,-89.02182620218069,-1.4193075023783592,-0.6300283527048711,-0.040056399785008856,866405100.0,1.0
AAPL,2021-09-30,141.5,144.3800048828125,141.27999877929688,143.66000366210938,89056700.0,-1.3300018310546875,1.3300018310546875,0.0,30.255014254377826,141.27000427246094,151.4199981689453,2.265969121604354,-97.73403087839566,-1.6545186544811372,-0.8349264130601245,-0.031220030362964057,777348400.0,-1.0
AAPL,2021-10-01,142.64999389648438,142.9199981689453,139.11000061035156,141.89999389648438,94639600.0,1.149993896484375,0.0,1.149993896484375,37.34470998626015,139.11000061035156,151.07000732421875,29.59858945587648,-70.40141054412352,-1.728208577867946,-1.013582846021689,-0.002028883027623829,871988000.0,1.0
AAPL,2021-10-04,139.13999938964844,142.2100067138672,138.27000427246094,141.75999450683594,98322000.0,-3.5099945068359375,3.5099945068359375,0.0,27.499946879425863,138.27000427246094,149.44000244140625,7.788677348276112,-92.21132265172389,-2.0462477254785085,-1.220115821913053,-0.029910015374749466,773666000.0,-1.0
AAPL,2021-10-05,141.11000061035156,142.24000549316406,139.36000061035156,139.49000549316406,80861100.0,1.970001220703125,0.0,1.970001220703125,38.07224665599078,138.27000427246094,148.97000122070312,26.542029419524127,-73.45797058047587,-2.114953538901034,-1.3990833653106494,-0.032499179258174915,854527100.0,1.0
AAPL,2021-10-06,142.0,142.14999389648438,138.3699951171875,139.47000122070312,83221100.0,0.8899993896484375,0.0,0.8899993896484375,42.44715596060611,138.27000427246094,148.82000732421875,35.355399512586686,-64.6446004874133,-2.0736837429621175,-1.534003440840943,-0.03289519696807042,937748200.0,1.0
AAPL,2021-10-07,143.2899932861328,144.22000122070312,142.72000122070312,143.05999755859375,61732700.0,1.2899932861328125,0.0,1.2899932861328125,48.528457782014264,138.27000427246094,147.47000122070312,54.56511607464204,-45.43488392535796,-1.9148126863616142,-1.6101652899450776,-0.024707357256010254,999480900.0,1.0
AAPL,2021-10-08,142.89999389648438,144.17999267578125,142.55999755859375,144.02999877929688,58773200.0,-0.3899993896484375,0.3899993896484375,0.0,46.80329307848669,138.27000427246094,147.47000122070312,50.325990867943425,-49.67400913205657,-1.7996308960469776,-1.6480584111654577,-0.016991135059968743,940707700.0,-1.0
AAPL,2021-10-11,142.80999755859375,144.80999755859375,141.80999755859375,142.27000427246094,64452200.0,-0.089996337890625,0.089996337890625,0.0,46.3644312303455,138.27000427246094,147.47000122070312,49.34776947942633,-50.65223052057366,-1.6960593334835323,-1.6576585956290726,0.006342004603334894,876255500.0,-1.0
AAPL,2021-10-12,141.50999450683594,143.25,141.0399932861328,143.22999572753906,73035900.0,-1.3000030517578125,1.3000030517578125,0.0,40.09773430718856,138.27000427246094,147.47000122070312,35.217296838278344,-64.78270316172166,-1.699289158014409,-1.6659847081061399,-0.00924180709442346,803219600.0,-1.0
AAPL,2021-10-13,140.91000366210938,141.39999389648438,139.1999969482422,141.24000549316406,78762700.0,-0.5999908447265625,0.5999908447265625,0.0,37.405358180025615,138.27000427246094,147.47000122070312,28.69565505837318,-71.30434494162682,-1.730317046237417,-1.6788511757323954,-0.004169585426788913,724456900.0,-1.0
AAPL,2021-10-14,143.75999450683594,143.8800048828125,141.50999450683594,142.11000061035156,69907100.0,2.8499908447265625,0.0,2.8499908447265625,54.244103099853525,138.27000427246094,145.9600067138672,71.3912677688443,-28.6087322311557,-1.507558235479678,-1.644592587681852,0.0077812874717473335,794364000.0,1.0
AAPL,2021-10-15,144.83999633789062,144.89999389648438,143.50999450683594,143.77000427246094,67940300.0,1.0800018310546875,0.0,1.0800018310546875,59.0597236886575,138.27000427246094,144.89999389648438,99.09505803182026,-0.9049419681797365,-1.2296979586425607,-1.5616136618739938,0.0409659118387653,862304300.0,1.0
AAPL,2021-10-18,146.5500030517578,146.83999633789062,143.16000366210938,143.4499969482422,85589200.0,1.7100067138671875,0.0,1.7100067138671875,65.6620984436631,138.27000427246094,146.83999633789062,96.61617789236223,-3.3838221076377697,-0.8615767166110686,-1.421606272821409,0.0385515017920508,947893500.0,1.0
AAPL,2021-10-19,148.75999450683594,149.1699981689453,146.5500030517578,147.00999450683594,76378900.0,2.209991455078125,0.0,2.209991455078125,72.3189966458983,138.27000427246094,149.1699981689453,96.23849640648316,-3.761503593516831,-0.3870484853652272,-1.2146947153301726,0.04760559511856299,1024272400.0,1.0
AAPL,2021-10-20,149.25999450683594,149.75,148.1199951171875,148.6999969482422,58418800.0,0.5,0.0,0.5,73.65241461022214,138.27000427246094,149.75,95.73165787868196,-4.268342121318051,0.029029741227560635,-0.965949824018626,0.04166376928207227,1082691200.0,1.0
AAPL,2021-10-21,149.47999572753906,149.63999938964844,147.8699951171875,148.80999755859375,61421000.0,0.220001220703125,0.0,0.220001220703125,74.28139184729369,138.27000427246094,149.75,97.64804553181817,-2.351954468181824,0.37223608746060677,-0.6983126417227794,0.04604620092441136,1144112200.0,1.0
AAPL,2021-10-22,148.69000244140625,150.17999267578125,148.63999938964844,149.69000244140625,58883400.0,-0.7899932861328125,0.7899932861328125,0.0,67.5955173415968,138.3699951171875,150.17999267578125,87.38365332437532,-12.616346675624692,0.573868534333883,-0.4438764065114469,0.041173622178657165,1085228800.0,-1.0
AAPL,2021-10-25,148.63999938964844,149.3699951171875,147.6199951171875,148.67999267578125,50720600.0,-0.0500030517578125,0.0500030517578125,0.0,67.15407743413256,138.3699951171875,150.17999267578125,86.9602573709915,-13.039742629008503,0.7213140138313179,-0.21083832244289388,0.05038516825373818,1034508200.0,-1.0
AAPL,2021-10-26,149.32000732421875,150.83999633789062,149.00999450683594,149.3300018310547,60893400.0,0.6800079345703125,0.0,0.6800079345703125,70.20711171122763,139.1999969482422,150.83999633789062,86.94167445555352,-13.05832554444647,0.8828595208809986,0.007901246221884687,0.05968351035087527,1095401600.0,1.0
AAPL,2021-10-27,148.85000610351562,149.72999572753906,148.49000549316406,149.36000061035156,56094900.0,-0.470001220703125,0.470001220703125,0.0,65.36195153924967,139.1999969482422,150.83999633789062,82.90386306940259,-17.096136930597414,0.961872461551792,0.1986954892878662,0.03540631462974675,1039306700.0,-1.0
AAPL,2021-10-28,152.57000732421875,153.1699981689453,149.72000122070312,149.82000732421875,100077900.0,3.720001220703125,0.0,3.720001220703125,78.75303917570085,139.1999969482422,153.1699981689453,95.70514822978402,-4.294851770215982,1.3095679117453756,0.4208699737793682,0.053369312218809695,1139384600.0,1.0
AAPL,2021-10-29,149.8000030517578,149.94000244140625,146.41000366210938,147.22000122070312,124953200.0,-2.7700042724609375,2.7700042724609375,0.0,59.116789670846345,139.1999969482422,153.1699981689453,75.87691608649777,-24.123083913502224,1.3460860243588968,0.6059131838952739,0.0221767310291503,1014431400.0,-1.0
AAPL,2021-11-01,148.9600067138672,149.6999969482422,147.8000030517578,148.99000549316406,74588300.0,-0.839996337890625,0.839996337890625,0.0,54.373060780568316,139.1999969482422,153.1699981689453,69.86405807295819,-30.135941927041802,1.2923488147017963,0.7432003100565785,0.0013445295403131663,939843100.0,-1.0
AAPL,2021-11-02,150.02000427246094,151.57000732421875,148.64999389648438,148.66000366210938,69122000.0,1.05999755859375,0.0,1.05999755859375,59.146325517995805,141.50999450683594,153.1699981689453,72.98462343780672,-27.01537656219329,1.3200776002462362,0.8585757680945102,0.005091851759315036,1008965100.0,1.0
AAPL,2021-11-03,151.49000549316406,151.97000122070312,149.82000732421875,150.38999938964844,54511500.0,1.470001220703125,0.0,1.470001220703125,65.0045557326952,143.16000366210938,153.1699981689453,83.21684717575056,-16.783152824249445,1.44402386749249,0.9756653879741062,0.013446680646744813,1063476600.0,1.0
AAPL,2021-11-04,150.9600067138672,152.42999267578125,150.63999938964844,151.5800018310547,60394600.0,-0.529998779296875,0.529998779296875,0.0,61.34507000780502,143.16000366210938,153.1699981689453,77.92215117032384,-22.07784882967615,1.482397548980913,1.0770118201754677,0.01526669066641162,1003082000.0,-1.0
AAPL,2021-11-05,151.27999877929688,152.1999969482422,150.05999755859375,151.88999938964844,65463900.0,0.3199920654296875,0.0,0.3199920654296875,62.80383934087997,146.41000366210938,153.1699981689453,72.0414064281087,-27.9585935718913,1.5210954123581644,1.165828538612007,0.017761029335904954,1068545900.0,1.0
AAPL,2021-11-08,150.44000244140625,151.57000732421875,150.16000366210938,151.41000366210938,55020900.0,-0.839996337890625,0.839996337890625,0.0,56.36140988133702,146.41000366210938,153.1699981689453,59.61541500102704,-40.38458499897297,1.467071575658366,1.226077146021279,0.007500636634417246,1013525000.0,-1.0
AAPL,2021-11-09,150.80999755859375,151.42999267578125,150.05999755859375,150.1999969482422,56787900.0,0.3699951171875,0.0,0.3699951171875,58.52377584956057,146.41000366210938,153.1699981689453,65.08871999873595,-34.911280001264046,1.4375417234822407,1.2683700615134714,0.013167560461603722,1070312900.0,1.0
AAPL,2021-11-10,147.9199981689453,150.1300048828125,147.85000610351562,150.02000427246094,65187100.0,-2.8899993896484375,2.8899993896484375,0.0,40.45639116146233,146.41000366210938,153.1699981689453,22.337214997866926,-77.66278500213308,1.1674822956972832,1.2481925083502339,-0.030477872006599127,1005125800.0,-1.0
AAPL,2021-11-11,147.8699951171875,149.42999267578125,147.67999267578125,148.9600067138672,41000000.0,-0.0500030517578125,0.0500030517578125,0.0,40.20857575087837,146.41000366210938,153.1699981689453,21.597524282035018,-78.40247571796498,0.9386037849483557,1.1862747636698583,-0.012883897832121294,964125800.0,-1.0
AAPL,2021-11-12,149.99000549316406,150.39999389648438,147.47999572753906,148.42999267578125,63804000.0,2.1200103759765625,0.0,2.1200103759765625,53.994607952545294,146.41000366210938,153.1699981689453,52.95865000237008,-47.04134999762992,0.9177043118189943,1.1325606732996856,0.006914599441951941,1027929800.0,1.0
AAPL,2021-11-15,150.0,151.8800048828125,149.42999267578125,150.3699951171875,59222800.0,0.0099945068359375,0.0,0.0099945068359375,54.052236285764366,146.41000366210938,153.1699981689453,53.10649785677042,-46.89350214322958,0.8916691945356945,1.0843823775468875,-0.00013334403340370393,1087152600.0,1.0
AAPL,2021-11-16,151.0,151.49000549316406,149.33999633789062,149.94000244140625,59256200.0,1.0,0.0,1.0,59.85745705914481,146.41000366210938,153.1699981689453,67.89940928574815,-32.10059071425186,0.9408819180939361,1.0556822856562973,-0.0032345730767444625,1146408800.0,1.0
AAPL,2021-11-17,153.49000549316406,155.0,150.99000549316406,151.0,88807000.0,2.4900054931640625,0.0,2.4900054931640625,70.54831792004407,146.41000366210938,155.0,82.42147671035289,-17.578523289647112,1.1673495110134127,1.0780157307277205,0.016759397633654638,1235215800.0,1.0
AAPL,2021-11-18,157.8699951171875,158.6699981689453,153.0500030517578,153.7100067138672,137827700.0,4.3799896240234375,0.0,4.3799896240234375,80.88224467537401,147.47999572753906,158.6699981689453,92.85073389441301,-7.149266105586979,1.6808791391657394,1.1985884124153243,0.043561583759032185,1373043500.0,1.0
AAPL,2021-11-19,160.5500030517578,161.02000427246094,156.52999877929688,157.64999389648438,117305600.0,2.6800079345703125,0.0,2.6800079345703125,84.6778839202413,147.47999572753906,161.02000427246094,96.52879672015128,-3.47120327984872,2.277851655841488,1.4144410611005571,0.06720287454322027,1490349100.0,1.0
AAPL,2021-11-22,161.02000427246094,165.6999969482422,161.0,161.67999267578125,117467900.0,0.470001220703125,0.0,0.470001220703125,85.26967861098184,147.47999572753906,165.6999969482422,74.31398264417545,-25.686017355824553,2.75709971750004,1.6829727923804538,0.06770112644488524,1607817000.0,1.0
AAPL,2021-11-23,161.41000366210938,161.8000030517578,159.05999755859375,161.1199951171875,96041900.0,0.3899993896484375,0.0,0.3899993896484375,85.7949782094607,147.47999572753906,165.6999969482422,76.45448409049416,-23.54551590950584,3.132270090708772,1.9728322520461177,0.09119798310000382,1703858900.0,1.0
AAPL,2021-11-24,161.94000244140625,162.13999938964844,159.63999938964844,160.75,69463600.0,0.529998779296875,0.0,0.529998779296875,86.54723357959833,147.47999572753906,165.6999969482422,79.36336852401793,-20.636631475982064,3.432790712047421,2.264823944046378,0.0951511989505931,1773322500.0,1.0
AAPL,2021-11-26,156.80999755859375,160.4499969482422,156.36000061035156,159.57000732421875,76959800.0,-5.1300048828125,5.1300048828125,0.0,54.382806290095616,147.47999572753906,165.6999969482422,51.20747094381718,-48.79252905618283,3.2198900604838627,2.4558371673338755,0.045469643413944105,1696362700.0,-1.0
AAPL,2021-11-29,160.24000549316406,161.19000244140625,158.7899932861328,159.3699951171875,88748200.0,3.4300079345703125,0.0,3.4300079345703125,64.5475082641331,147.47999572753906,165.6999969482422,70.03297975153802,-29.967020248461978,3.2900125184498563,2.622672237557072,0.06826670328776041,1785110900.0,1.0
AAPL,2021-11-30,165.3000030517578,165.52000427246094,159.9199981689453,159.99000549316406,174048100.0,5.05999755859375,0.0,5.05999755859375,74.29652826375772,147.47999572753906,165.6999969482422,97.80464396440398,-2.1953560355960224,3.711105274881419,2.8403588450219415,0.09470200696528353,1959159000.0,1.0
AAPL,2021-12-01,164.77000427246094,170.3000030517578,164.52999877929688,167.47999572753906,152052500.0,-0.529998779296875,0.529998779296875,0.0,71.90675682129043,147.47999572753906,170.3000030517578,75.76688429267979,-24.233115707320206,3.956450349237059,3.0635771458649654,0.0734901190670636,1807106500.0,-1.0
AAPL,2021-12-02,163.75999450683594,164.1999969482422,157.8000030517578,158.74000549316406,136739200.0,-1.010009765625,1.010009765625,0.0,67.15693494330797,147.47999572753906,170.3000030517578,71.34090076307295,-28.65909923692706,4.023013940728106,3.2554645048375943,0.03730917572573733,1670367300.0,-1.0
AAPL,2021-12-03,161.83999633789062,164.9600067138672,159.72000122070312,164.02000427246094,118023100.0,-1.9199981689453125,1.9199981689453125,0.0,58.658110815480875,149.33999633789062,170.3000030517578,59.637385477219205,-40.362614522780795,3.8761563429123385,3.379602872452544,0.00803483812900918,1552344200.0,-1.0
AAPL,2021-12-06,165.32000732421875,167.8800048828125,164.27999877929688,164.2899932861328,107497000.0,3.480010986328125,0.0,3.480010986328125,67.30999456692923,149.33999633789062,170.3000030517578,76.24048600974785,-23.75951399025214,3.994531963556767,3.5025886906733885,0.026704775417107918,1659841200.0,1.0
AAPL,2021-12-07,171.17999267578125,171.5800018310547,168.33999633789062,169.0800018310547,120405400.0,5.8599853515625,0.0,5.8599853515625,76.75981815486423,150.99000549316406,171.5800018310547,98.05726456329027,-1.9427354367097331,4.509217882835259,3.703914529105763,0.060529017979109145,1780246600.0,1.0
AAPL,2021-12-08,175.0800018310547,175.9600067138672,170.6999969482422,172.1300048828125,116998900.0,3.9000091552734375,0.0,3.9000091552734375,80.98163102943883,153.0500030517578,175.9600067138672,96.15886188500296,-3.8411381149970363,5.172186579752349,3.99756893923508,0.08114115840156799,1897245500.0,1.0
AAPL,2021-12-09,174.55999755859375,176.75,173.9199981689453,174.91000366210938,108923700.0,-0.5200042724609375,0.5200042724609375,0.0,78.77990092572522,156.36000061035156,176.75,89.25942860734921,-10.740571392650786,5.591182379479648,4.316291627283994,0.11319431334961605,1788321800.0,-1.0
AAPL,2021-12-10,179.4499969482422,179.6300048828125,174.69000244140625,175.2100067138672,115402700.0,4.8899993896484375,0.0,4.8899993896484375,83.6138690466368,156.36000061035156,179.6300048828125,99.22643789634648,-0.7735621036535187,6.245823685226782,4.7021980388725515,0.11988261855056925,1903724500.0,1.0
AAPL,2021-12-13,175.74000549316406,182.1300048828125,175.52999877929688,181.1199951171875,153237000.0,-3.709991455078125,3.709991455078125,0.0,69.71192699964868,156.36000061035156,182.1300048828125,75.20373174141419,-24.796268258585805,6.391588082940075,5.040076047686057,0.06315790834037283,1750487500.0,-1.0
AAPL,2021-12-14,174.3300018310547,177.74000549316406,172.2100067138672,175.25,139380400.0,-1.410003662109375,1.410003662109375,0.0,64.97457312952795,156.36000061035156,182.1300048828125,69.73223997446803,-30.26776002553197,6.320473423396862,5.296155522828219,0.0580202543588304,1611107100.0,-1.0
AAPL,2021-12-15,179.3000030517578,179.5,172.30999755859375,175.11000061035156,131063300.0,4.970001220703125,0.0,4.970001220703125,72.55886408398527,156.36000061035156,182.1300048828125,89.01823297686077,-10.981767023139238,6.589195956478676,5.554763609558311,0.09489502360891433,1742170400.0,1.0
AAPL,2021-12-16,172.25999450683594,181.13999938964844,170.75,179.27999877929688,150185800.0,-7.040008544921875,7.040008544921875,0.0,53.591981329916806,157.8000030517578,182.1300048828125,59.43275941977723,-40.56724058022278,6.163046878170292,5.676420263280708,0.06438456750326638,1591984600.0,-1.0
AAPL,2021-12-17,171.13999938964844,173.47000122070312,169.69000244140625,169.92999267578125,195432700.0,-1.1199951171875,1.1199951171875,0.0,51.138168116611844,157.8000030517578,182.1300048828125,54.82940951062126,-45.17059048937874,5.669590902874802,5.675054391199527,0.03520440241703926,1396551900.0,-1.0
AAPL,2021-12-20,169.75,170.5800018310547,167.4600067138672,168.27999877929688,107499100.0,-1.3899993896484375,1.3899993896484375,0.0,47.99149008065586,157.8000030517578,182.1300048828125,49.116301064101336,-50.88369893589867,5.107486231285293,5.561540759216681,-0.008353737217933421,1289052800.0,-1.0
AAPL,2021-12-21,172.99000549316406,173.1999969482422,169.1199951171875,171.55999755859375,91185900.0,3.2400054931640625,0.0,3.2400054931640625,55.37648152373996,157.8000030517578,182.1300048828125,62.43321536465242,-37.56678463534758,4.867347838682235,5.422702175109792,-0.011937379004070325,1380238700.0,1.0
AAPL,2021-12-22,175.63999938964844,175.86000061035156,172.14999389648438,173.0399932861328,92135300.0,2.649993896484375,0.0,2.649993896484375,60.6496454131426,159.72000122070312,182.1300048828125,71.0396946336189,-28.9603053663811,4.835132396462825,5.3051882193803985,0.006186994994040296,1472374000.0,1.0
AAPL,2021-12-23,176.27999877929688,176.85000610351562,175.27000427246094,175.85000610351562,68356600.0,0.6399993896484375,0.0,0.6399993896484375,61.90413732120834,164.27999877929688,182.1300048828125,67.22686776917435,-32.77313223082565,4.805845236103806,5.205319622725081,-0.01766507786489191,1540730600.0,1.0
AAPL,2021-12-27,180.3300018310547,180.4199981689453,177.07000732421875,177.08999633789062,74919600.0,4.0500030517578125,0.0,4.0500030517578125,69.09756139252974,167.4600067138672,182.1300048828125,87.73003901549075,-12.26996098450926,5.051209154639622,5.174497529107989,0.026118107399679014,1615650200.0,1.0
AAPL,2021-12-28,179.2899932861328,181.3300018310547,178.52999877929688,180.16000366210935,79144300.0,-1.040008544921875,1.040008544921875,0.0,65.4364970808864,167.4600067138672,182.1300048828125,80.64068199618686,-19.359318003813136,5.102918561252068,5.160181735536805,0.028451737526423715,1536505900.0,-1.0
AAPL,2021-12-29,179.3800048828125,180.6300048828125,178.13999938964844,179.3300018310547,62348900.0,0.0900115966796875,0.0,0.0900115966796875,65.61841688192536,167.4600067138672,182.1300048828125,81.2542580555911,-18.745741944408906,5.0924591233046215,5.146637213090369,0.0004461897919298963,1598854800.0,1.0
AAPL,2021-12-30,178.1999969482422,180.57000732421875,178.08999633789062,179.47000122070312,59773000.0,-1.1800079345703125,1.1800079345703125,0.0,60.779442708392274,167.4600067138672,182.1300048828125,73.2105765160238,-26.789423483976186,4.932098997672938,5.103729570006883,0.03448277389310217,1539081800.0,-1.0
AAPL,2021-12-31,177.57000732421875,179.22999572753906,177.25999450683594,178.08999633789062,64062300.0,-0.6299896240234375,0.6299896240234375,0.0,58.1383326210295,167.4600067138672,182.1300048828125,68.91616818162434,-31.083831818375664,4.699998883678404,5.022983432741188,0.037571625321387137,1475019500.0,-1.0
AAPL,2022-01-03,182.00999450683597,182.8800048828125,177.7100067138672,177.8300018310547,104487900.0,4.439987182617216,0.0,4.439987182617216,69.06850344952784,167.4600067138672,182.8800048828125,94.3579086946413,-5.642091305358699,4.81877983590087,4.982142713373125,0.07222382625529278,1579507400.0,1.0
AAPL,2022-01-04,179.6999969482422,182.94000244140625,179.1199951171875,182.6300048828125,99310400.0,-2.3099975585937784,2.3099975585937784,0.0,59.709463384892345,167.4600067138672,182.94000244140625,79.0697261795747,-20.930273820425292,4.672653656063119,4.920244901911124,0.03878831864273957,1480197000.0,-1.0
AAPL,2022-01-05,174.9199981689453,180.1699981689453,174.63999938964844,179.61000061035156,94537600.0,-4.779998779296875,4.779998779296875,0.0,45.11377452919902,167.4600067138672,182.94000244140625,48.19117257123481,-51.80882742876519,4.123607274581758,4.760917376445251,-0.004099300974750308,1385659400.0,-1.0
AAPL,2022-01-06,172.0,175.3000030517578,171.63999938964844,172.6999969482422,96904000.0,-2.9199981689453125,2.9199981689453125,0.0,38.48314601017269,167.4600067138672,182.94000244140625,29.328130097969733,-70.67186990203027,3.41351572832491,4.491437046821183,-0.024279548496341063,1288755400.0,-1.0
AAPL,2022-01-07,172.1699981689453,174.13999938964844,171.02999877929688,172.88999938964844,86709100.0,0.1699981689453125,0.0,0.1699981689453125,39.08457229090237,167.4600067138672,182.94000244140625,30.42630978701761,-69.5736902129824,2.8318368411355266,4.159517005684052,-0.04525039416211074,1375464500.0,1.0
AAPL,2022-01-10,172.19000244140625,172.5,168.1699981689453,169.0800018310547,106765600.0,0.0200042724609375,0.0,0.0200042724609375,39.165326634097724,168.1699981689453,182.94000244140625,27.217353484158036,-72.78264651584196,2.3454296567688004,3.796699535901001,-0.03960059741535904,1482230100.0,1.0
AAPL,2022-01-11,175.0800018310547,175.17999267578125,170.82000732421875,172.32000732421875,76138300.0,2.8899993896484375,0.0,2.8899993896484375,50.17571344612464,168.1699981689453,182.94000244140625,46.784032926742334,-53.215967073257666,2.1681541256640458,3.4709904538536107,-0.023971473601904325,1558368400.0,1.0
AAPL,2022-01-12,175.52999877929688,177.17999267578125,174.82000732421875,176.1199951171875,74805200.0,0.4499969482421875,0.0,0.4499969482421875,51.74482918165515,168.1699981689453,182.94000244140625,49.8307277004278,-50.1692722995722,2.040451923368664,3.1848827477566215,-0.014983154964479661,1633173600.0,1.0
AAPL,2022-01-13,172.19000244140625,176.6199951171875,171.7899932861328,175.77999877929688,84505800.0,-3.339996337890625,3.339996337890625,0.0,40.75324255098215,168.1699981689453,182.94000244140625,27.217353484158036,-72.78264651584196,1.6507088726973222,2.878047972744762,-0.030297936931372282,1548667800.0,-1.0
AAPL,2022-01-14,173.07000732421875,173.77999877929688,171.08999633789062,171.33999633789062,80440800.0,0.8800048828125,0.0,0.8800048828125,44.347157371275465,168.1699981689453,182.94000244140625,33.17540783931683,-66.82459216068317,1.3967429533051074,2.5817869688568313,-0.04911811138086397,1629108600.0,1.0
AAPL,2022-01-18,169.8000030517578,172.5399932861328,169.41000366210938,171.50999450683594,90956700.0,-3.2700042724609375,3.2700042724609375,0.0,35.19379864499176,168.1699981689453,182.94000244140625,11.035913414403591,-88.96408658559642,0.9209944653422042,2.249628468153906,-0.055091786670067644,1538151900.0,-1.0
AAPL,2022-01-19,166.22999572753906,171.0800018310547,165.94000244140625,170.0,94815000.0,-3.57000732421875,3.57000732421875,0.0,27.931452957814187,165.94000244140625,182.94000244140625,1.7058428596047794,-98.29415714039523,0.2529744735208226,1.8502976692272892,-0.0496798681247016,1443336900.0,-1.0
AAPL,2022-01-20,164.50999450683594,169.67999267578125,164.17999267578125,166.97999572753906,91420500.0,-1.720001220703125,1.720001220703125,0.0,25.05704634394479,164.17999267578125,182.94000244140625,1.7590706784138674,-98.24092932158614,-0.41049398751800936,1.3981393378782294,-0.04354654356490739,1351916400.0,-1.0
AAPL,2022-01-21,162.41000366210938,166.3300018310547,162.3000030517578,164.4199981689453,122848900.0,-2.0999908447265625,2.0999908447265625,0.0,21.88437314478071,162.3000030517578,182.94000244140625,0.5329487093237562,-99.46705129067624,-1.093148102868298,0.8998818497289238,-0.05668812575149562,1229067500.0,-1.0
AAPL,2022-01-24,161.6199951171875,162.3000030517578,154.6999969482422,160.02000427246094,162294600.0,-0.790008544921875,0.790008544921875,0.0,20.744240709233793,154.6999969482422,182.94000244140625,24.504238041385676,-75.49576195861432,-1.678554167163668,0.38419464635040534,-0.06138572027615585,1066772900.0,-1.0
AAPL,2022-01-25,159.77999877929688,162.75999450683594,157.02000427246094,158.97999572753906,115798400.0,-1.839996337890625,1.839996337890625,0.0,18.196567401553935,154.6999969482422,180.1699981689453,19.94503960575173,-80.05496039424827,-2.2648571542676734,-0.14561571377321056,-0.08738863886077475,950974500.0,-1.0
AAPL,2022-01-26,159.69000244140625,164.38999938964844,157.82000732421875,163.5,108275300.0,-0.089996337890625,0.089996337890625,0.0,18.0713133748727,154.6999969482422,177.17999267578125,22.197537551357577,-77.80246244864242,-2.7055802035481804,-0.6576086117282047,-0.09024096421151973,842699200.0,-1.0
AAPL,2022-01-27,159.22000122070312,163.83999633789062,158.27999877929688,162.4499969482422,121954600.0,-0.470001220703125,0.470001220703125,0.0,17.351593261083835,154.6999969482422,177.17999267578125,20.106784392862306,-79.89321560713769,-3.057536191917535,-1.137594127766071,-0.0753237762750868,720744600.0,-1.0
AAPL,2022-01-28,170.3300018310547,170.35000610351562,162.8000030517578,165.7100067138672,179935700.0,11.110000610351562,0.0,11.110000610351562,60.38456582198727,154.6999969482422,177.17999267578125,69.52850468590171,-30.471495314098295,-2.412173613410573,-1.3925100248949716,-0.015831775450445895,900680300.0,1.0
AAPL,2022-01-31,174.77999877929688,175.0,169.50999450683594,170.16000366210938,115541600.0,4.4499969482421875,0.0,4.4499969482421875,68.06844412695412,154.6999969482422,177.17999267578125,89.32386853817651,-10.676131461823493,-1.52407299206061,-1.4188226183280994,0.02932859621928907,1016221900.0,1.0
AAPL,2022-02-01,174.61000061035156,174.83999633789062,172.30999755859375,174.00999450683594,86213900.0,-0.1699981689453125,0.1699981689453125,0.0,67.4914159315883,154.6999969482422,177.17999267578125,88.56764878170628,-11.432351218293716,-0.8244604162514406,-1.2999501779127678,0.050412110318211356,930008000.0,-1.0
AAPL,2022-02-02,175.83999633789062,175.8800048828125,173.3300018310547,174.75,84914300.0,1.2299957275390625,0.0,1.2299957275390625,69.64003646801724,154.6999969482422,176.6199951171875,96.44161111107243,-3.558388888927562,-0.16881602769413462,-1.0737233478690411,0.06887120667057034,1014922300.0,1.0
AAPL,2022-02-03,172.89999389648438,176.24000549316406,172.1199951171875,174.47999572753906,89418100.0,-2.94000244140625,2.94000244140625,0.0,58.90286094709103,154.6999969482422,176.24000549316406,84.49391703019029,-15.506082969809713,0.11225919340171231,-0.8365268396148904,0.0645895572799764,925504200.0,-1.0
AAPL,2022-02-04,172.38999938964844,174.10000610351562,170.67999267578125,171.67999267578125,82465400.0,-0.5099945068359375,0.5099945068359375,0.0,57.13953153245493,154.6999969482422,176.24000549316406,82.12625544931235,-17.873744550687636,0.2905121929355232,-0.6111190331048076,0.06663782080089664,843038800.0,-1.0
AAPL,2022-02-07,171.66000366210938,173.9499969482422,170.9499969482422,172.86000061035156,77251200.0,-0.7299957275390625,0.7299957275390625,0.0,54.44751423091182,154.6999969482422,176.24000549316406,78.73723298900715,-21.262767010992842,0.36862514373029853,-0.41517019773778635,0.07435226544983431,765787600.0,-1.0
AAPL,2022-02-08,174.8300018310547,175.35000610351562,171.42999267578125,171.72999572753906,74829200.0,3.1699981689453125,0.0,3.1699981689453125,63.14711402873342,154.6999969482422,176.24000549316406,93.45402459256783,-6.545975407432175,0.6785012395254455,-0.19643591028513996,0.09480868656886421,840616800.0,1.0
AAPL,2022-02-09,176.27999877929688,176.64999389648438,174.89999389648438,176.0500030517578,71285000.0,1.4499969482421875,0.0,1.4499969482421875,66.52160172218797,154.6999969482422,176.64999389648438,98.31437280806942,-1.6856271919305672,1.0292187208255825,0.0486950159370046,0.10714732714356656,911901800.0,1.0
AAPL,2022-02-10,172.1199951171875,175.47999572753906,171.5500030517578,174.13999938964844,90865900.0,-4.160003662109375,4.160003662109375,0.0,51.04804937650102,154.6999969482422,176.64999389648438,79.3621894801236,-20.6378105198764,0.9604162420084208,0.23103926115128792,0.010508972388248106,821035900.0,-1.0
AAPL,2022-02-11,168.63999938964844,173.0800018310547,168.0399932861328,172.3300018310547,98670700.0,-3.4799957275390625,3.4799957275390625,0.0,41.68812046281928,157.02000427246094,176.64999389648438,59.1951159412066,-40.8048840587934,0.6179597547894957,0.3084233598789295,-0.03512987431360326,722365200.0,-1.0
AAPL,2022-02-14,168.8800048828125,169.5800018310547,166.55999755859375,167.3699951171875,86185500.0,0.2400054931640625,0.0,0.2400054931640625,42.52671075280122,157.82000732421875,176.64999389648438,58.73608839893618,-41.26391160106382,0.3617568510978231,0.31909005812270824,-0.032815965337092856,808550700.0,1.0
AAPL,2022-02-15,172.7899932861328,172.9499969482422,170.25,170.97000122070312,62527400.0,3.9099884033203125,0.0,3.9099884033203125,54.757213929063944,158.27999877929688,176.64999389648438,78.98747067853037,-21.01252932146963,0.4688134020190944,0.3490347269019855,-0.01734533163829799,871078100.0,1.0
AAPL,2022-02-16,172.5500030517578,173.33999633789062,170.0500030517578,171.85000610351562,61177400.0,-0.239990234375,0.239990234375,0.0,53.944216506293785,162.8000030517578,176.64999389648438,70.39715844803139,-29.602841551968606,0.5282024941352859,0.3848682803486456,-0.0020242386181696936,809900700.0,-1.0
AAPL,2022-02-17,168.8800048828125,171.91000366210938,168.47000122070312,171.02999877929688,69589300.0,-3.6699981689453125,3.6699981689453125,0.0,42.74570103461302,166.55999755859375,176.64999389648438,22.993143372178483,-77.00685662782152,0.27594962127184886,0.3630845485332863,-0.020360777999090307,740311400.0,-1.0
AAPL,2022-02-18,167.3000030517578,170.5399932861328,166.19000244140625,169.82000732421875,82772700.0,-1.5800018310546875,1.5800018310546875,0.0,38.74971696042196,166.19000244140625,176.64999389648438,10.611869188599371,-89.38813081140063,-0.050869153064468264,0.2802938082137354,-0.025399047636825545,657538700.0,-1.0
AAPL,2022-02-22,164.32000732421875,166.69000244140625,162.14999389648438,164.97999572753906,91162800.0,-2.9799957275390625,2.9799957275390625,0.0,32.19911516306989,162.14999389648438,176.64999389648438,14.965609846443966,-85.03439015355603,-0.5440644997919151,0.11542214661260526,-0.06011550876143201,566375900.0,-1.0
AAPL,2022-02-23,160.07000732421875,166.14999389648438,159.75,165.5399932861328,90009200.0,-4.25,4.25,0.0,25.1912772481804,159.75,176.64999389648438,1.8935351466920918,-98.10646485330791,-1.2633022842673824,-0.16032273956339238,-0.09195593128732138,476366700.0,-1.0
AAPL,2022-02-24,162.74000549316406,162.85000610351562,152.0,152.5800018310547,141147500.0,2.6699981689453125,0.0,2.6699981689453125,35.38521454543131,152.0,176.64999389648438,43.570012788911164,-56.429987211088836,-1.599419756812182,-0.4481421430131505,-0.0544968039165763,617514200.0,1.0
AAPL,2022-02-25,164.85000610351562,165.1199951171875,160.8699951171875,163.83999633789062,91974200.0,2.1100006103515625,0.0,2.1100006103515625,42.52650723125539,152.0,176.64999389648438,52.12985511265508,-47.87014488734492,-1.6762135141703425,-0.6937564172445889,-0.02247386918791372,709488400.0,1.0
AAPL,2022-02-28,165.1199951171875,165.4199981689453,162.42999267578125,163.05999755859375,95056600.0,0.269989013671875,0.0,0.269989013671875,43.44927940060128,152.0,176.64999389648438,53.22514550017271,-46.77485449982729,-1.6957398299367128,-0.8941530997830138,-0.02226438688365806,804545000.0,1.0
AAPL,2022-03-01,163.1999969482422,166.60000610351562,161.97000122070312,164.6999969482422,83474400.0,-1.9199981689453125,1.9199981689453125,0.0,38.391451393560665,152.0,176.64999389648438,45.43610434662035,-54.56389565337966,-1.8448758021488914,-1.0842976402561895,-0.05550087800518633,721070600.0,-1.0
AAPL,2022-03-02,166.55999755859375,167.36000061035156,162.9499969482422,164.38999938964844,79724800.0,3.3600006103515625,0.0,3.3600006103515625,50.116722819211695,152.0,175.47999572753906,62.01022235075075,-37.98977764924925,-1.6726617624335063,-1.201970464691653,-0.034714606706597984,800795400.0,1.0
AAPL,2022-03-03,166.22999572753906,168.91000366210938,165.5500030517578,168.47000122070312,76678400.0,-0.3300018310546875,0.3300018310546875,0.0,49.058633633884426,152.0,173.33999633789062,66.68227820767115,-33.31772179232885,-1.5449994926274542,-1.2705762702788133,-0.015691669106193462,724117000.0,-1.0
AAPL,2022-03-04,163.1699981689453,165.5500030517578,162.10000610351562,164.49000549316406,83737200.0,-3.05999755859375,3.05999755859375,0.0,40.01887008860439,152.0,173.33999633789062,52.34301820901541,-47.65698179098459,-1.6714747332925697,-1.3507559628815646,-0.024686221204280545,640379800.0,-1.0
AAPL,2022-03-07,159.3000030517578,165.02000427246094,159.0399932861328,163.36000061035156,96418800.0,-3.8699951171875,3.8699951171875,0.0,31.538421596125147,152.0,173.33999633789062,34.208080152273304,-65.7919198477267,-2.0602344356600497,-1.492651657437262,-0.030550170695623158,543961000.0,-1.0
AAPL,2022-03-08,157.44000244140625,162.8800048828125,155.8000030517578,158.82000732421875,131148300.0,-1.8600006103515625,1.8600006103515625,0.0,28.221845373870238,152.0,173.33999633789062,25.49204955460631,-74.50795044539369,-2.4897159100140698,-1.6920645079526238,-0.01643034149105449,412812700.0,-1.0
AAPL,2022-03-09,162.9499969482422,163.41000366210938,159.41000366210938,161.47999572753906,91454900.0,5.5099945068359375,0.0,5.5099945068359375,47.200512909936215,152.0,171.91000366210938,54.9974632555245,-45.00253674447549,-2.3582876923955496,-1.8253091448412093,0.0012903493178690884,504267600.0,1.0
AAPL,2022-03-10,158.52000427246094,160.38999938964844,155.97999572753906,160.1999969482422,105342000.0,-4.42999267578125,4.42999267578125,0.0,37.90334427244303,152.0,170.5399932861328,35.16724182061945,-64.83275817938055,-2.581831522330617,-1.9766136203390912,-0.038398553816733516,398925600.0,-1.0
AAPL,2022-03-11,154.72999572753906,159.27999877929688,154.5,158.92999267578125,96970100.0,-3.790008544921875,3.790008544921875,0.0,31.733109266235516,152.0,168.91000366210938,16.144264555401755,-83.85573544459824,-3.029886982161429,-2.187268292703559,-0.06292393227285731,301955500.0,-1.0
AAPL,2022-03-14,150.6199951171875,154.1199951171875,150.10000610351562,151.4499969482422,108732100.0,-4.1100006103515625,4.1100006103515625,0.0,26.36314909087187,150.10000610351562,168.91000366210938,2.7644289269687166,-97.23557107303128,-3.674262254567907,-2.484667085076429,-0.07708334599445088,193223400.0,-1.0
AAPL,2022-03-15,155.08999633789062,155.57000732421875,150.3800048828125,150.89999389648438,92964300.0,4.470001220703125,0.0,4.470001220703125,39.26154836235071,150.10000610351562,168.91000366210938,26.528393843917414,-73.47160615608259,-3.7806614474848175,-2.743865957558107,-0.06886408134503075,286187700.0,1.0
AAPL,2022-03-16,159.58999633789062,160.0,154.4600067138672,157.0500030517578,102300200.0,4.5,0.0,4.5,49.530426938388935,150.10000610351562,168.91000366210938,50.45184192508996,-49.548158074910035,-3.461963818602186,-2.887485529766923,-0.03994465235102207,388487900.0,1.0
AAPL,2022-03-17,160.6199951171875,161.0,157.6300048828125,158.61000061035156,75615400.0,1.029998779296875,0.0,1.029998779296875,51.687623912242444,150.10000610351562,168.91000366210938,55.92764688512993,-44.07235311487006,-3.0906542202048968,-2.9281192678545183,-0.015627891649036774,464103300.0,1.0
AAPL,2022-03-18,163.97999572753906,164.47999572753906,159.75999450683594,160.50999450683594,123511700.0,3.3600006103515625,0.0,3.3600006103515625,58.383086561524074,150.10000610351562,168.91000366210938,73.79049136389743,-26.209508636102573,-2.496486774250741,-2.841792769133763,0.02937848453311509,587615000.0,1.0
AAPL,2022-03-21,165.3800048828125,166.35000610351562,163.00999450683594,163.50999450683594,95811400.0,1.4000091552734375,0.0,1.4000091552734375,60.982756456676846,150.10000610351562,168.91000366210938,81.23339055041971,-18.766609449580283,-1.8908393352705275,-2.651602082361116,0.050431925293962454,683426400.0,1.0
AAPL,2022-03-22,168.82000732421875,169.4199981689453,164.91000366210938,165.50999450683594,81532000.0,3.44000244140625,0.0,3.44000244140625,66.85314042110366,150.10000610351562,169.4199981689453,96.89445605000967,-3.105543949990325,-1.120365057720619,-2.3453546774330167,0.036023384387304125,764958400.0,1.0
AAPL,2022-03-23,170.2100067138672,172.63999938964844,167.64999389648438,167.99000549316406,98062700.0,1.3899993896484375,0.0,1.3899993896484375,69.02590332869511,150.10000610351562,172.63999938964844,89.21919521033644,-10.780804789663554,-0.39306628430963997,-1.9548969988083413,0.07374465131425123,863021100.0,1.0
AAPL,2022-03-24,174.07000732421875,174.13999938964844,170.2100067138672,171.05999755859375,90131400.0,3.8600006103515625,0.0,3.8600006103515625,74.40230268068669,150.10000610351562,174.13999938964844,99.70885155999582,-0.29114844000418916,0.4891543564741596,-1.4660867277518412,0.12499199981065812,953152500.0,1.0
AAPL,2022-03-25,174.72000122070312,175.27999877929688,172.75,173.8800048828125,80546200.0,0.649993896484375,0.0,0.649993896484375,75.23744061808267,150.10000610351562,175.27999877929688,97.77602175741549,-2.223978242584517,1.2266298205516648,-0.92754341809114,0.1600053570893094,1033698700.0,1.0
AAPL,2022-03-28,175.60000610351562,175.72999572753906,172.0,172.1699981689453,90371900.0,0.8800048828125,0.0,0.8800048828125,76.43828813386506,150.10000610351562,175.72999572753906,99.49282217460753,-0.5071778253924689,1.8606451198618004,-0.3699057105005518,0.13224585885565676,1124070600.0,1.0
AAPL,2022-03-29,178.9600067138672,179.00999450683594,176.33999633789062,176.69000244140625,100589400.0,3.3600006103515625,0.0,3.3600006103515625,80.58600756437825,150.10000610351562,179.00999450683594,99.82709161874652,-0.1729083812534802,2.6042110569578085,0.2249176429911204,0.12137358744570403,1224660000.0,1.0
AAPL,2022-03-30,177.77000427246094,179.61000061035156,176.6999969482422,178.5500030517578,92633200.0,-1.19000244140625,1.19000244140625,0.0,75.17785582685985,150.10000610351562,179.61000061035156,93.76483673196078,-6.235163268039217,3.0621703735224344,0.7923681890973835,0.10677381195760138,1132026800.0,-1.0
AAPL,2022-03-31,174.61000061035156,178.02999877929688,174.39999389648438,177.83999633789062,103049300.0,-3.160003662109375,3.160003662109375,0.0,62.355896479679416,150.10000610351562,179.61000061035156,83.05658783216053,-16.943412167839472,3.133993815180901,1.2606933143140873,0.06482501012181263,1028977500.0,-1.0
AAPL,2022-04-01,174.30999755859375,174.8800048828125,171.94000244140625,174.02999877929688,78751300.0,-0.3000030517578125,0.3000030517578125,0.0,61.212257755336275,150.3800048828125,179.61000061035156,81.86793080245164,-18.13206919754836,3.1306188457966755,1.6346784206106049,0.05399680984475119,950226200.0,-1.0
AAPL,2022-04-04,178.44000244140625,178.49000549316406,174.44000244140625,174.57000732421875,76468400.0,4.1300048828125,0.0,4.1300048828125,69.96293426422986,154.4600067138672,179.61000061035156,95.34791867639831,-4.652081323601682,3.4217571499416977,1.9920941664768237,0.05698373830011927,1026694600.0,1.0
AAPL,2022-04-05,175.05999755859375,178.3000030517578,174.4199981689453,177.5,73401800.0,-3.3800048828125,3.3800048828125,0.0,57.675687558871346,157.6300048828125,179.61000061035156,79.29934514929388,-20.70065485070612,3.3412325582646076,2.2619218448343807,0.028494158118915314,953292800.0,-1.0
AAPL,2022-04-06,171.8300018310547,173.6300048828125,170.1300048828125,172.36000061035156,89058800.0,-3.2299957275390625,3.2299957275390625,0.0,48.31873106908478,159.75999450683594,179.61000061035156,60.80606354111416,-39.193936458885844,2.9824032895599544,2.4060181337794955,-0.012868417297138834,864234000.0,-1.0
AAPL,2022-04-07,172.13999938964844,173.36000061035156,169.85000610351562,171.16000366210938,77594700.0,0.30999755859375,0.0,0.30999755859375,49.230838621031964,163.00999450683594,179.61000061035156,55.00000919203822,-44.99999080796178,2.6920108952254793,2.4632166860686926,-0.01476649389325313,941828700.0,1.0
AAPL,2022-04-08,170.08999633789062,171.77999877929688,169.1999969482422,171.77999877929688,76575500.0,-2.0500030517578125,2.0500030517578125,0.0,43.38796722509502,164.91000366210938,179.61000061035156,35.23805272898828,-64.76194727101172,2.2702842927408824,2.4246302074031307,-0.031378186640704686,865253200.0,-1.0
AAPL,2022-04-11,165.75,169.02999877929688,165.5,168.7100067138672,72246700.0,-4.339996337890625,4.339996337890625,0.0,33.636279102384506,165.5,179.61000061035156,1.7717929779293682,-98.22820702207063,1.5677889926976718,2.253261964462039,-0.07381541248480283,793006500.0,-1.0
AAPL,2022-04-12,167.66000366210938,169.8699951171875,166.63999938964844,168.02000427246094,79265200.0,1.910003662109375,0.0,1.910003662109375,40.434538819332545,165.5,179.61000061035156,15.308317283308442,-84.69168271669155,1.1518993603797298,2.032989443645577,-0.056871240183222205,872271700.0,1.0
AAPL,2022-04-13,170.39999389648438,171.0399932861328,166.77000427246094,167.38999938964844,70618900.0,2.739990234375,0.0,2.739990234375,49.07030408287146,165.5,179.61000061035156,34.72709911075112,-65.27290088924889,1.0315075661732465,1.8326930681511107,-0.024110914032134723,942890600.0,1.0
AAPL,2022-04-14,165.2899932861328,171.27000427246094,165.0399932861328,170.6199951171875,75329400.0,-5.1100006103515625,5.1100006103515625,0.0,37.401728628650964,165.0399932861328,179.61000061035156,1.7158536329933183,-98.28414636700668,0.5177930625797842,1.5697130670368453,-0.05174691296423717,867561200.0,-1.0
AAPL,2022-04-18,165.07000732421875,166.60000610351562,163.57000732421875,163.9199981689453,69023900.0,-0.2199859619140625,0.2199859619140625,0.0,36.965099314680565,163.57000732421875,179.61000061035156,9.3516248619431,-90.6483751380569,0.09186067604952086,1.2741425888393805,-0.07492711799069696,798537300.0,-1.0
AAPL,2022-04-19,167.39999389648438,167.82000732421875,163.91000366210938,165.02000427246094,67723800.0,2.329986572265625,0.0,2.329986572265625,44.835347987098395,163.57000732421875,179.61000061035156,23.8777317667383,-76.1222682332617,-0.05702600479543207,1.007908870112418,-0.04375644789750166,866261100.0,1.0
AAPL,2022-04-20,167.22999572753906,168.8800048828125,166.10000610351562,168.75999450683594,67929800.0,-0.1699981689453125,0.1699981689453125,0.0,44.368983371515256,163.57000732421875,178.49000549316406,24.530756383993815,-75.46924361600618,-0.18658635221325426,0.7690098256472834,-0.026770680640732403,798331300.0,-1.0
AAPL,2022-04-21,166.4199981689453,171.52999877929688,165.91000366210938,168.91000366210938,87227800.0,-0.80999755859375,0.80999755859375,0.0,41.96893304502226,163.57000732421875,178.49000549316406,19.101817657448326,-80.89818234255168,-0.35058259657699864,0.545091341202427,-0.033228774491602,711103500.0,-1.0
AAPL,2022-04-22,161.7899932861328,167.8699951171875,161.5,166.4600067138672,84882400.0,-4.6300048828125,4.6300048828125,0.0,30.933009342131285,161.5,178.49000549316406,1.7068463353322132,-98.29315366466778,-0.8444195582079601,0.2671891613203495,-0.048797714330415576,626221100.0,-1.0
AAPL,2022-04-25,162.8800048828125,163.1699981689453,158.4600067138672,161.1199951171875,96046400.0,1.0900115966796875,0.0,1.0900115966796875,35.53753844611414,158.4600067138672,178.3000030517578,22.278220689506657,-77.72177931049335,-1.1347533516799047,-0.013199341279701442,-0.017315204326923128,722267500.0,1.0
AAPL,2022-04-26,156.8000030517578,162.33999633789062,156.72000122070312,162.25,95623200.0,-6.0800018310546875,6.0800018310546875,0.0,24.867477143799462,156.72000122070312,173.6300048828125,0.4731035702490674,-99.52689642975093,-1.8343055769437058,-0.3774205884125025,-0.06477394949983462,626644300.0,-1.0
AAPL,2022-04-27,156.57000732421875,159.7899932861328,155.3800048828125,155.91000366210938,88063200.0,-0.2299957275390625,0.2299957275390625,0.0,24.545799616521663,155.3800048828125,173.36000061035156,6.618480112225959,-93.38151988777405,-2.379831274980347,-0.7779027257260716,-0.08116189593684575,538581100.0,-1.0
AAPL,2022-04-28,163.63999938964844,164.52000427246094,158.92999267578125,159.25,130216800.0,7.0699920654296875,0.0,7.0699920654296875,48.27700220904631,155.3800048828125,171.77999877929688,50.36583890806576,-49.63416109193424,-2.2161288932940977,-1.065547959239677,-0.009982418558321826,668797900.0,1.0
AAPL,2022-04-29,157.64999389648438,166.1999969482422,157.25,161.83999633789062,131747600.0,-5.9900054931640625,5.9900054931640625,0.0,36.92418900468656,155.3800048828125,171.52999877929688,14.055664839390555,-85.94433516060944,-2.5404522074584577,-1.3605288088834333,-0.044950706357942516,537050300.0,-1.0
AAPL,2022-05-02,157.9600067138672,158.22999572753906,153.27000427246094,156.7100067138672,123055300.0,0.3100128173828125,0.0,0.3100128173828125,37.7977031760315,153.27000427246094,171.52999877929688,25.68457750439338,-74.31542249560663,-2.740870280617031,-1.636597103230153,-0.05639180123539678,660105600.0,1.0
AAPL,2022-05-03,159.47999572753906,160.7100067138672,156.32000732421875,158.14999389648438,88966500.0,1.519989013671875,0.0,1.519989013671875,42.31693042865562,153.27000427246094,171.52999877929688,34.00872575702753,-65.99127424297248,-2.7454053137034293,-1.8583587453248085,-0.04634336062907496,749072100.0,1.0
AAPL,2022-05-04,166.02000427246094,166.47999572753906,159.25999450683594,159.6699981689453,108256500.0,6.540008544921875,0.0,6.540008544921875,57.60773025387759,153.27000427246094,171.52999877929688,69.82477456511185,-30.175225434888155,-2.195961648706657,-1.9258793260011784,-0.0024035206158234956,857328600.0,1.0
AAPL,2022-05-05,156.77000427246094,164.0800018310547,154.9499969482422,163.85000610351562,130525300.0,-9.25,9.25,0.0,40.21182740977499,153.27000427246094,171.52999877929688,19.167585174736583,-80.83241482526341,-2.478352376715378,-2.0363739361440185,-0.031027809023972175,726803300.0,-1.0
AAPL,2022-05-06,157.27999877929688,159.44000244140625,154.17999267578125,156.00999450683594,116124600.0,0.5099945068359375,0.0,0.5099945068359375,41.33873754964656,153.27000427246094,171.52999877929688,21.96054607428676,-78.03945392571325,-2.6306720191772683,-2.1552335527506687,-0.034381175930984664,842927900.0,1.0
AAPL,2022-05-09,152.05999755859375,155.8300018310547,151.49000549316406,154.92999267578125,131577900.0,-5.220001220703125,5.220001220703125,0.0,33.81212605310827,151.49000549316406,171.52999877929688,2.8442727364789495,-97.15572726352106,-3.136441955872442,-2.3514752333750235,-0.030229626281317423,711350000.0,-1.0
AAPL,2022-05-10,154.50999450683594,156.74000549316406,152.92999267578125,155.52000427246094,115366700.0,2.4499969482421875,0.0,2.4499969482421875,39.75262925375348,151.49000549316406,171.52999877929688,15.069810506182325,-84.93018949381768,-3.3015161730145905,-2.541483421302937,-0.013157135600798786,826716700.0,1.0
AAPL,2022-05-11,146.5,155.4499969482422,145.80999755859375,153.5,142689800.0,-8.009994506835938,8.009994506835938,0.0,29.69764497702532,145.80999755859375,167.8699951171875,3.127844595510623,-96.87215540448938,-4.032197629463127,-2.839626262934975,-0.10474211350267626,684026900.0,-1.0
AAPL,2022-05-12,142.55999755859375,146.1999969482422,138.8000030517578,142.77000427246094,182602000.0,-3.94000244140625,3.94000244140625,0.0,25.969511166272213,138.8000030517578,166.47999572753906,13.583798777973536,-86.41620122202647,-4.873020074947107,-3.246305025337402,-0.09571834393979728,501424900.0,-1.0
AAPL,2022-05-13,147.11000061035156,148.10000610351562,143.11000061035156,144.58999633789062,113990900.0,4.5500030517578125,0.0,4.5500030517578125,36.57839748713833,138.8000030517578,166.47999572753906,30.021675424302497,-69.9783245756975,-5.1132879004715335,-3.6197016003642286,-0.06868831123291608,615415800.0,1.0
AAPL,2022-05-16,145.5399932861328,147.52000427246094,144.17999267578125,145.5500030517578,86643800.0,-1.57000732421875,1.57000732421875,0.0,34.6040482132714,138.8000030517578,166.47999572753906,24.349682145227547,-75.65031785477245,-5.3685035856437935,-3.9694619974201415,-0.08740909715862932,528772000.0,-1.0
AAPL,2022-05-17,149.24000549316406,149.77000427246094,146.67999267578125,148.86000061035156,78336300.0,3.70001220703125,0.0,3.70001220703125,42.97397727839746,138.8000030517578,166.47999572753906,37.71678180587376,-62.28321819412624,-5.212121697560946,-4.217993937448303,-0.10107215002692482,607108300.0,1.0
AAPL,2022-05-18,140.82000732421875,147.36000061035156,139.89999389648438,146.85000610351562,109742900.0,-8.419998168945312,8.419998168945312,0.0,32.164504266254525,138.8000030517578,166.47999572753906,7.297705227459654,-92.70229477254036,-5.701883642624864,-4.514771878483615,-0.10174138236624419,497365400.0,-1.0
AAPL,2022-05-19,137.35000610351562,141.66000366210938,136.60000610351562,139.8800048828125,136095600.0,-3.470001220703125,3.470001220703125,0.0,28.72833205811162,136.60000610351562,166.47999572753906,2.510041032266631,-97.48995896773337,-6.297430749467509,-4.871303652680394,-0.1267166380370336,361269800.0,-1.0
AAPL,2022-05-20,137.58999633789062,140.6999969482422,132.61000061035156,139.08999633789062,137426100.0,0.239990234375,0.0,0.239990234375,29.33080844597258,132.61000061035156,166.47999572753906,14.70326674187189,-85.29673325812811,-6.673117372890204,-5.231666396722357,-0.09515981489561287,498695900.0,1.0
AAPL,2022-05-23,143.11000061035156,143.25999450683594,137.64999389648438,137.7899932861328,117726300.0,5.5200042724609375,0.0,5.5200042724609375,42.28001281258631,132.61000061035156,166.47999572753906,31.000890208784593,-68.9991097912154,-6.451069601724299,-5.4755470377227455,-0.07378159537750817,616422200.0,1.0
AAPL,2022-05-24,140.36000061035156,141.97000122070312,137.3300018310547,140.80999755859375,104132700.0,-2.75,2.75,0.0,38.251014321678994,132.61000061035156,164.0800018310547,24.626627579860145,-75.37337242013984,-6.422957306916544,-5.665029091561506,-0.04191125863241252,512289500.0,-1.0
AAPL,2022-05-25,140.52000427246094,141.7899932861328,138.33999633789062,138.42999267578125,92482700.0,0.160003662109375,0.0,0.160003662109375,38.64353941817502,132.61000061035156,159.44000244140625,29.481934857543884,-70.51806514245611,-6.314972085153414,-5.795017690279888,-0.014309717459796922,604772200.0,1.0
AAPL,2022-05-26,143.77999877929688,144.33999633789062,137.13999938964844,137.38999938964844,90601500.0,3.2599945068359375,0.0,3.2599945068359375,46.620651947833764,132.61000061035156,156.74000549316406,46.290907205334065,-53.709092794665935,-5.898346243224978,-5.815683400868907,-0.022636134982249256,695373700.0,1.0
AAPL,2022-05-27,149.63999938964844,149.67999267578125,145.25999450683594,145.38999938964844,90978500.0,5.8600006103515625,0.0,5.8600006103515625,57.957712311709685,132.61000061035156,156.74000549316406,70.57602707501783,-29.423972924982166,-5.037247928145035,-5.659996306324133,0.028170992803709938,786352200.0,1.0
AAPL,2022-05-31,148.83999633789062,150.66000366210938,146.83999633789062,149.07000732421875,103718400.0,-0.8000030517578125,0.8000030517578125,0.0,56.08147189738671,132.61000061035156,155.4499969482422,71.05953734595903,-28.94046265404097,-4.3690116235571566,-5.401799369770738,-0.0026803078300058347,682633800.0,-1.0
AAPL,2022-06-01,148.7100067138672,151.74000549316406,147.67999267578125,149.89999389648438,74286600.0,-0.1299896240234375,0.1299896240234375,0.0,55.743147211478764,132.61000061035156,151.74000549316406,84.16101408306905,-15.83898591693095,-3.806044897678987,-5.082648475352388,0.056028965908820005,608347200.0,-1.0
AAPL,2022-06-02,151.2100067138672,151.27000427246094,146.86000061035156,147.8300018310547,72348100.0,2.5,0.0,2.5,60.96842716830042,132.61000061035156,151.74000549316406,97.22948957648696,-2.770510423513046,-3.122170170592881,-4.690552814400487,0.10091008368726095,680695300.0,1.0
AAPL,2022-06-03,145.3800048828125,147.97000122070312,144.4600067138672,146.89999389648438,88570300.0,-5.8300018310546875,5.8300018310546875,0.0,46.26911999106959,132.61000061035156,151.74000549316406,66.75379515419908,-33.246204845800925,-3.015861967283712,-4.355614644977132,0.05661755034712934,592125000.0,-1.0
AAPL,2022-06-06,146.13999938964844,148.57000732421875,144.89999389648438,147.02999877929688,71598400.0,0.7599945068359375,0.0,0.7599945068359375,48.14945348165766,132.61000061035156,151.74000549316406,70.72658298928614,-29.273417010713853,-2.8375769246325717,-4.05200710090822,0.021172516011279452,663723400.0,1.0
AAPL,2022-06-07,148.7100067138672,149.0,144.10000610351562,144.35000610351562,67808200.0,2.57000732421875,0.0,2.57000732421875,54.37888779964334,132.61000061035156,151.74000549316406,84.16101408306905,-15.83898591693095,-2.4605430229068475,-3.7337142853079457,0.05948992638362682,731531600.0,1.0
AAPL,2022-06-08,147.9600067138672,149.8699951171875,147.4600067138672,148.5800018310547,53950200.0,-0.75,0.75,0.0,52.264536321699055,132.61000061035156,151.74000549316406,80.24047143504369,-19.759528564956323,-2.196934774854981,-3.426358383217353,0.05294621559347856,677581400.0,-1.0
AAPL,2022-06-09,142.63999938964844,147.9499969482422,142.52999877929688,147.0800018310547,69473000.0,-5.32000732421875,5.32000732421875,0.0,39.647407638867165,132.61000061035156,151.74000549316406,52.43071729850109,-47.56928270149891,-2.389755851106969,-3.219037876795276,-0.007928775902956708,608108400.0,-1.0
AAPL,2022-06-10,137.1300048828125,140.75999450683594,137.05999755859375,140.27999877929688,91437900.0,-5.5099945068359375,5.5099945068359375,0.0,30.770291787671,137.05999755859375,151.74000549316406,0.4768888717960978,-99.5231111282039,-2.953136531324276,-3.1658576077010765,-0.0836006051714896,516670500.0,-1.0
AAPL,2022-06-13,131.8800048828125,135.1999969482422,131.44000244140625,132.8699951171875,122207100.0,-5.25,5.25,0.0,24.692136347701222,131.44000244140625,151.74000549316406,2.167499385514375,-97.83250061448562,-3.7796810923911153,-3.2886223046390852,-0.1139478088710526,394463400.0,-1.0
AAPL,2022-06-14,132.75999450683594,133.88999938964844,131.47999572753906,133.1300048828125,84784300.0,0.8799896240234375,0.0,0.8799896240234375,27.463312060492527,131.44000244140625,151.74000549316406,6.502422990105843,-93.49757700989416,-4.313986848662239,-3.4936952134437163,-0.1072558098778158,479247700.0,1.0
AAPL,2022-06-15,135.42999267578125,137.33999633789062,132.16000366210938,134.2899932861328,91533000.0,2.6699981689453125,0.0,2.6699981689453125,35.74150602649895,131.44000244140625,151.74000549316406,19.65512135245467,-80.34487864754533,-4.470448919458363,-3.689045954646646,-0.10435826557395944,570780700.0,1.0
AAPL,2022-06-16,130.05999755859375,132.38999938964844,129.0399932861328,132.0800018310547,108123900.0,-5.3699951171875,5.3699951171875,0.0,28.257659152830854,129.0399932861328,151.74000549316406,4.493408475546964,-95.50659152445303,-4.970463554992136,-3.945329474715744,-0.1053790535814596,462656800.0,-1.0
AAPL,2022-06-17,131.55999755859375,133.0800018310547,129.80999755859375,130.07000732421875,134520300.0,1.5,0.0,1.5,32.79321422808181,129.0399932861328,151.74000549316406,11.10133443752235,-88.89866556247765,-5.185911334342023,-4.1934458466410005,-0.0997673593263162,597177100.0,1.0
AAPL,2022-06-21,135.8699951171875,137.05999755859375,133.32000732421875,133.4199981689453,81000500.0,4.30999755859375,0.0,4.30999755859375,44.43877455985653,129.0399932861328,151.74000549316406,30.088097613177133,-69.91190238682286,-4.951793278339835,-4.345115332980767,-0.08634261997839288,678177600.0,1.0
AAPL,2022-06-22,135.35000610351562,137.75999450683594,133.91000366210938,134.7899932861328,73409200.0,-0.519989013671875,0.519989013671875,0.0,43.392073371916545,129.0399932861328,151.27000427246094,28.38510885695733,-71.61489114304267,-4.753417363436256,-4.426775739071865,-0.0852257369434799,604768400.0,-1.0
AAPL,2022-06-23,138.27000427246094,138.58999633789062,135.6300048828125,136.82000732421875,72433800.0,2.9199981689453125,0.0,2.9199981689453125,50.88738987222623,129.0399932861328,149.8699951171875,44.311138622020856,-55.68886137797915,-4.310890312773324,-4.403598653812157,-0.030636533482098716,677202200.0,1.0
AAPL,2022-06-24,141.66000366210938,141.91000366210938,139.77000427246094,139.89999389648438,89116800.0,3.3899993896484375,0.0,3.3899993896484375,58.2861355771688,129.0399932861328,149.8699951171875,60.585738197880765,-39.414261802119235,-3.6446268281762855,-4.2518042886849825,0.0330343368919741,766319000.0,1.0
AAPL,2022-06-28,137.44000244140625,143.4199981689453,137.32000732421875,142.1300048828125,67083400.0,-4.220001220703125,4.220001220703125,0.0,46.64106094894691,129.0399932861328,149.8699951171875,40.32649263981423,-59.67350736018577,-2.941101007294037,-3.8023495564111514,0.035251643026614765,699235600.0,-1.0
AAPL,2022-06-29,139.22999572753906,140.6699981689453,136.6699981689453,137.4600067138672,66242400.0,1.7899932861328125,0.0,1.7899932861328125,51.393914100928995,129.0399932861328,147.9499969482422,53.88683483877007,-46.11316516122994,-2.655113684485201,-3.572902382025961,0.028058799802603618,765478000.0,1.0
AAPL,2022-06-30,136.72000122070312,138.3699951171875,133.77000427246094,137.25,98964500.0,-2.5099945068359375,2.5099945068359375,0.0,44.920139395556205,129.0399932861328,143.49000549316406,53.148798938960674,-46.851201061039326,-2.60101931890415,-3.3785257694015995,0.05120716428668981,666513500.0,-1.0
AAPL,2022-07-01,138.92999267578125,139.0399932861328,135.66000366210938,136.0399932861328,71051600.0,2.209991455078125,0.0,2.209991455078125,51.16908162307645,129.0399932861328,143.49000549316406,68.44284453155029,-31.55715546844971,-2.352700832999318,-3.173360782121143,0.05602003081449647,737565100.0,1.0
AAPL,2022-07-05,141.55999755859375,141.61000061035156,136.92999267578125,137.77000427246094,73353800.0,2.6300048828125,0.0,2.6300048828125,57.7508883583342,129.0399932861328,143.49000549316406,86.64355498861663,-13.356445011383364,-1.9215369478865512,-2.922996015274225,0.04187828546323735,810918900.0,1.0
AAPL,2022-07-06,142.9199981689453,144.1199951171875,141.0800018310547,141.35000610351562,74064300.0,1.3600006103515625,0.0,1.3600006103515625,60.89577081791613,129.0399932861328,144.1199951171875,92.04246152164916,-7.957538478350837,-1.4533425510563518,-2.6290653224306504,0.05592901162959807,884983200.0,1.0
AAPL,2022-07-07,146.35000610351562,146.5500030517578,143.27999877929688,143.2899932861328,66253700.0,3.4300079345703125,0.0,3.4300079345703125,67.85820221918559,129.0399932861328,146.5500030517578,98.85781361107625,-1.1421863889237462,-0.7963424043312841,-2.2625207388107773,0.058436404002223385,951236900.0,1.0
AAPL,2022-07-08,147.0399932861328,147.5500030517578,145.0,145.25999450683594,64547800.0,0.6899871826171875,0.0,0.6899871826171875,69.13380117301435,129.80999755859375,147.5500030517578,97.12508676605806,-2.874913233941936,-0.21748185994383107,-1.853512963037388,0.03797818357294358,1015784700.0,1.0
AAPL,2022-07-11,144.8699951171875,146.63999938964844,143.77999877929688,145.6699981689453,63141600.0,-2.1699981689453125,2.1699981689453125,0.0,60.43080801547248,133.32000732421875,147.5500030517578,81.16648812913036,-18.833511870869643,0.06541451730933545,-1.4697274669680434,0.022659828971448137,952643100.0,-1.0
AAPL,2022-07-12,145.86000061035156,148.4499969482422,145.0500030517578,145.75999450683594,77588800.0,0.9900054931640625,0.0,0.9900054931640625,62.89001523722901,133.77000427246094,148.4499969482422,82.35696437258073,-17.643035627419266,0.36528631071098516,-1.1027247114322376,0.0612630822131639,1030231900.0,1.0
AAPL,2022-07-13,145.49000549316406,146.4499969482422,142.1199951171875,142.99000549316406,71185600.0,-0.3699951171875,0.3699951171875,0.0,61.24851922439401,133.77000427246094,148.4499969482422,79.83656040945131,-20.16343959054869,0.5665505120254011,-0.7688696667407098,0.04496164589328355,959046300.0,-1.0
AAPL,2022-07-14,148.47000122070312,148.9499969482422,143.25,144.0800018310547,78140700.0,2.9799957275390625,0.0,2.9799957275390625,68.81328266515708,133.77000427246094,148.9499969482422,96.83797128370908,-3.1620287162909264,0.9555001806421046,-0.4239956972641469,0.08594207061944292,1037187000.0,1.0
AAPL,2022-07-15,150.1699981689453,150.86000061035156,148.1999969482422,149.77999877929688,76259900.0,1.6999969482421875,0.0,1.6999969482421875,72.36433719456062,133.77000427246094,150.86000061035156,95.96253604878527,-4.037463951214721,1.384956228214179,-0.062205312168481595,0.0809040962047316,1113446900.0,1.0
AAPL,2022-07-18,147.07000732421875,151.57000732421875,146.6999969482422,150.74000549316406,81420900.0,-3.0999908447265625,3.0999908447265625,0.0,58.378180007496205,133.77000427246094,151.57000732421875,74.71910545793075,-25.280894542069245,1.4583489476361535,0.24190553979244553,0.03892349435329945,1032026000.0,-1.0
AAPL,2022-07-19,151.0,151.22999572753906,146.91000366210938,147.9199981689453,82982400.0,3.92999267578125,0.0,3.92999267578125,67.55184803460097,133.77000427246094,151.57000732421875,96.79771221071528,-3.2022877892847315,1.8127346939962194,0.5560713706332004,0.05653513808125954,1115008400.0,1.0
AAPL,2022-07-20,153.0399932861328,153.72000122070312,150.3699951171875,151.1199951171875,64823400.0,2.0399932861328125,0.0,2.0399932861328125,71.33580821968388,133.77000427246094,153.72000122070312,96.59143840305084,-3.4085615969491596,2.232463906203492,0.8913498777472589,0.045712243960449594,1179831800.0,1.0
AAPL,2022-07-21,155.35000610351562,155.57000732421875,151.94000244140625,154.5,65086600.0,2.3100128173828125,0.0,2.3100128173828125,75.1258075953265,135.66000366210938,155.57000732421875,98.89502169644595,-1.104978303554048,2.7201449222117446,1.2571088866401563,0.056515323699804165,1244918400.0,1.0
AAPL,2022-07-22,154.08999633789062,156.27999877929688,153.41000366210938,155.38999938964844,66675400.0,-1.260009765625,1.260009765625,0.0,69.35441057481434,136.92999267578125,156.27999877929688,88.6821614955028,-11.317838504497201,2.970718786245726,1.5998308665612704,0.06364327694803151,1178243000.0,-1.0
AAPL,2022-07-25,152.9499969482422,155.0399932861328,152.27999877929688,154.00999450683594,53623900.0,-1.1399993896484375,1.1399993896484375,0.0,64.20520041293292,141.0800018310547,156.27999877929688,78.09208881821658,-21.907911181783412,3.0422428732947537,1.8883132679079673,0.04860822918018992,1124619100.0,-1.0
AAPL,2022-07-26,151.60000610351562,153.08999633789062,150.8000030517578,152.25999450683594,55138700.0,-1.3499908447265625,1.3499908447265625,0.0,58.291666209621305,142.1199951171875,156.27999877929688,66.94921281479326,-33.05078718520674,2.9559192516222765,2.101834464650829,0.04199601608124648,1069480400.0,-1.0
AAPL,2022-07-27,156.7899932861328,157.3300018310547,152.16000366210938,152.5800018310547,78620700.0,5.1899871826171875,0.0,5.1899871826171875,70.38946842352792,142.1199951171875,157.3300018310547,96.44964952954595,-3.550350470454042,3.2686171665705785,2.3351910050347793,0.056038202983927254,1148101100.0,1.0
AAPL,2022-07-28,157.35000610351562,157.63999938964844,154.41000366210938,156.97999572753906,81378700.0,0.5600128173828125,0.0,0.5600128173828125,71.42152218516416,142.1199951171875,157.63999938964844,98.13148707280072,-1.8685129271992755,3.521032599138181,2.57235932385546,0.047812532610492564,1229479800.0,1.0
AAPL,2022-07-29,162.50999450683594,163.6300048828125,159.5,161.24000549316406,101786900.0,5.1599884033203125,0.0,5.1599884033203125,79.14827177974354,142.1199951171875,163.6300048828125,94.79307360535725,-5.206926394642756,4.090291256837617,2.8759457104518917,0.10498392883451357,1331266700.0,1.0
AAPL,2022-08-01,161.50999450683594,163.58999633789062,160.88999938964844,161.00999450683594,67829400.0,-1.0,1.0,0.0,74.6359017072927,142.1199951171875,163.6300048828125,90.14407525112082,-9.855924748879179,4.409906544131047,3.1827378771877233,0.06960261262805267,1263437300.0,-1.0
AAPL,2022-08-02,160.00999450683594,162.41000366210938,159.6300048828125,160.10000610351562,59907000.0,-1.5,1.5,0.0,67.93271366027207,143.25,163.6300048828125,82.23744107623104,-17.762558923768964,4.490403916863698,3.444271085122919,0.04554365869365662,1203530300.0,-1.0
AAPL,2022-08-03,166.1300048828125,166.58999633789062,160.75,160.83999633789062,82507500.0,6.1200103759765625,0.0,6.1200103759765625,77.46196025275168,146.6999969482422,166.58999633789062,97.68732293014789,-2.312677069852115,4.990504920742268,3.7535178522467887,0.06939168558586184,1286037800.0,1.0
AAPL,2022-08-04,165.80999755859375,167.19000244140625,164.42999267578125,166.00999450683594,55474100.0,-0.32000732421875,0.32000732421875,0.0,76.0976187528539,146.6999969482422,167.19000244140625,93.26498529601224,-6.735014703987763,5.299922445829196,4.062798770963271,0.07605945550808735,1230563700.0,-1.0
AAPL,2022-08-05,165.35000610351562,165.85000610351562,163.0,163.2100067138672,56697000.0,-0.459991455078125,0.459991455078125,0.0,73.93769574476742,146.91000366210938,167.19000244140625,90.92703920786715,-9.072960792132845,5.445251132078198,4.339289243186257,0.08107230730752857,1173866700.0,-1.0
AAPL,2022-08-08,164.8699951171875,167.80999755859375,164.1999969482422,166.3699951171875,60276900.0,-0.480010986328125,0.480010986328125,0.0,71.49433194009663,150.3699951171875,167.80999755859375,83.14219019587942,-16.85780980412057,5.458767019750525,4.563184798499111,0.08753290553702775,1113589800.0,-1.0
AAPL,2022-08-09,164.9199981689453,165.82000732421875,163.25,164.02000427246094,63135500.0,0.0500030517578125,0.0,0.0500030517578125,71.6071101151051,150.8000030517578,167.80999755859375,83.00999222259001,-16.99000777740999,5.411137066702366,4.732775252139763,0.05185283009723518,1176725300.0,1.0
AAPL,2022-08-10,169.24000549316406,169.33999633789062,166.89999389648438,167.67999267578125,70170500.0,4.32000732421875,0.0,4.32000732421875,79.63782070648676,150.8000030517578,169.33999633789062,99.46067486010715,-0.5393251398928592,5.656770741127048,4.91757434993722,0.07556402242416427,1246895800.0,1.0
AAPL,2022-08-11,168.49000549316406,170.99000549316406,168.19000244140625,170.05999755859375,57149200.0,-0.75,0.75,0.0,75.36756810307273,150.8000030517578,170.99000549316406,87.61763398862733,-12.382366011372671,5.724925092985387,5.079044498546853,0.03679780437182023,1189746600.0,-1.0
AAPL,2022-08-12,172.10000610351562,172.1699981689453,169.39999389648438,169.82000732421875,68039400.0,3.6100006103515625,0.0,3.6100006103515625,81.01988956005748,150.8000030517578,172.1699981689453,99.67247505183849,-0.327524948161519,6.0010583222701825,5.2634472632915195,0.06556876946851409,1257786000.0,1.0
AAPL,2022-08-15,173.19000244140625,173.38999938964844,171.35000610351562,171.52000427246094,54091700.0,1.089996337890625,0.0,1.089996337890625,82.42491044274227,152.16000366210938,173.38999938964844,99.05795106692953,-0.9420489330704671,6.235965166216516,5.457950843876519,0.08236990429999191,1311877700.0,1.0
AAPL,2022-08-16,173.02999877929688,173.7100067138672,171.66000366210938,172.77999877929688,56377100.0,-0.160003662109375,0.160003662109375,0.0,81.4042438939009,154.41000366210938,173.7100067138672,96.47664338318134,-3.5233566168186616,6.336180034824281,5.633596682066072,0.04153370067828277,1255500600.0,-1.0
AAPL,2022-08-17,174.5500030517578,176.14999389648438,172.57000732421875,172.77000427246094,79542000.0,1.5200042724609375,0.0,1.5200042724609375,83.62666042664804,159.5,176.14999389648438,90.3904418543697,-9.609558145630302,6.4637426797152955,5.799625881595917,0.05271096810718867,1335042600.0,1.0
AAPL,2022-08-18,174.14999389648438,174.89999389648438,173.1199951171875,173.75,62290100.0,-0.4000091552734375,0.4000091552734375,0.0,80.69814055720737,159.6300048828125,176.14999389648438,87.8934544184938,-12.106545581506188,6.45811447538054,5.931323600352842,0.05322036569783739,1272752500.0,-1.0
AAPL,2022-08-19,171.52000427246094,173.74000549316406,171.30999755859375,173.02999877929688,70346300.0,-2.6299896240234375,2.6299896240234375,0.0,63.75944508816048,159.6300048828125,176.14999389648438,71.97340978742977,-28.02659021257022,6.1703084253342695,5.979120565349128,0.04033486596846614,1202406200.0,-1.0
AAPL,2022-08-22,167.57000732421875,169.86000061035156,167.13999938964844,169.69000244140625,69026800.0,-3.9499969482421875,3.9499969482421875,0.0,46.75291367350651,160.75,176.14999389648438,44.28577939745594,-55.71422060254406,5.559402977998531,5.8951770478790095,0.01606845249027189,1133379400.0,-1.0
AAPL,2022-08-23,167.22999572753906,168.7100067138672,166.64999389648438,167.0800018310547,54147100.0,-0.3400115966796875,0.3400115966796875,0.0,45.5462974200202,163.0,176.14999389648438,32.16728282033609,-67.83271717966392,4.990294902111515,5.714200618725511,-0.011876682228695534,1079232300.0,-1.0
AAPL,2022-08-24,167.52999877929688,168.11000061035156,166.25,167.32000732421875,53841500.0,0.3000030517578125,0.0,0.3000030517578125,46.94042996489498,163.0,176.14999389648438,34.44867590781134,-65.55132409218865,4.511474916276313,5.4736554782356714,-0.005697707178875633,1133073800.0,1.0
AAPL,2022-08-25,170.02999877929688,170.13999938964844,168.35000610351562,168.77999877929688,51218200.0,2.5,0.0,2.5,57.42195759735855,163.25,176.14999389648438,52.55815493947345,-47.44184506052656,4.284348432601718,5.235794069108881,-0.012027932892539672,1184292000.0,1.0
AAPL,2022-08-26,163.6199951171875,171.0500030517578,163.55999755859375,170.57000732421875,78961000.0,-6.410003662109375,6.410003662109375,0.0,36.24156591209985,163.25,176.14999389648438,2.8681805600569663,-97.13181943994303,3.546236525821115,4.897882560451328,-0.055257273452932076,1105331000.0,-1.0
AAPL,2022-08-29,161.3800048828125,162.89999389648438,159.82000732421875,161.14999389648438,73314000.0,-2.239990234375,2.239990234375,0.0,31.549310730238844,159.82000732421875,176.14999389648438,9.552962898592977,-90.44703710140702,2.7488420898368986,4.468074466328442,-0.06732933005070507,1032017000.0,-1.0
AAPL,2022-08-30,158.91000366210938,162.55999755859375,157.72000122070312,162.1300048828125,77906200.0,-2.470001220703125,2.470001220703125,0.0,27.087223031856567,157.72000122070312,176.14999389648438,6.4568796219329245,-93.54312037806707,1.8957398891682828,3.95360755089641,-0.08960182822231655,954110800.0,-1.0
AAPL,2022-08-31,157.22000122070312,160.5800018310547,157.13999938964844,160.30999755859375,87991100.0,-1.69000244140625,1.69000244140625,0.0,24.366527525282876,157.13999938964844,176.14999389648438,0.42084089517184803,-99.57915910482815,1.070936091162821,3.377073258949693,-0.09721500585205034,866119700.0,-1.0
AAPL,2022-09-01,157.9600067138672,158.4199981689453,154.6699981689453,156.63999938964844,74229900.0,0.7400054931640625,0.0,0.7400054931640625,28.019335366301164,154.6699981689453,176.14999389648438,15.316616384163535,-84.68338361583648,0.4715496666398735,2.795968540487729,-0.07905781961766734,940349600.0,1.0
AAPL,2022-09-02,155.80999755859375,160.36000061035156,154.97000122070312,159.75,76957800.0,-2.1500091552734375,2.1500091552734375,0.0,24.11495194887108,154.6699981689453,176.14999389648438,5.3072607839808255,-94.69273921601918,-0.17493956913799025,2.2017869185625853,-0.07017968163521904,863391800.0,-1.0
AAPL,2022-09-06,154.52999877929688,157.08999633789062,153.69000244140625,156.47000122070312,73714800.0,-1.279998779296875,1.279998779296875,0.0,22.008275690733825,153.69000244140625,176.14999389648438,3.7399673084056526,-96.26003269159435,-0.781562781054447,1.6051169786391788,-0.07594329529813404,789677000.0,-1.0
AAPL,2022-09-07,155.9600067138672,156.6699981689453,153.61000061035156,154.82000732421875,87449600.0,1.4300079345703125,0.0,1.4300079345703125,29.902193932066126,153.61000061035156,174.89999389648438,11.038078180354786,-88.96192181964521,-1.1338559718944339,1.0573223885324563,-0.06906221064725204,877126600.0,1.0
AAPL,2022-09-08,154.4600067138672,156.36000061035156,152.67999267578125,154.63999938964844,84923800.0,-1.5,1.5,0.0,26.6388671019224,152.67999267578125,173.74000549316406,8.45210329889602,-91.54789670110398,-1.5166058396819722,0.5425367428895704,-0.09157202950780419,792202800.0,-1.0
AAPL,2022-09-09,157.3699951171875,157.82000732421875,154.75,155.47000122070312,68028800.0,2.9099884033203125,0.0,2.9099884033203125,41.041765415875254,152.67999267578125,171.0500030517578,25.530755538056827,-74.46924446194318,-1.567062007744255,0.12061699276280521,-0.03819826541079918,860231600.0,1.0
AAPL,2022-09-12,163.42999267578125,164.25999450683594,159.3000030517578,159.58999633789062,104956000.0,6.05999755859375,0.0,6.05999755859375,59.94007900716641,152.67999267578125,171.0500030517578,58.51929193278163,-41.48070806721837,-1.1053163283867775,-0.1245696714671114,0.012702861141052457,965187600.0,1.0
AAPL,2022-09-13,153.83999633789062,160.5399932861328,153.3699951171875,159.89999389648438,122656600.0,-9.589996337890625,9.589996337890625,0.0,37.81012239119596,152.67999267578125,171.0500030517578,6.314659808937144,-93.68534019106286,-1.4959675258913023,-0.3988492423519497,-0.031904897158011036,842531000.0,-1.0
AAPL,2022-09-14,155.30999755859375,157.10000610351562,153.61000061035156,154.7899932861328,87965400.0,1.470001220703125,0.0,1.470001220703125,41.6221703615235,152.67999267578125,171.0500030517578,14.316839397390307,-85.68316060260969,-1.667720161305823,-0.6526234261427245,-0.012148604803965957,930496400.0,1.0
AAPL,2022-09-15,152.3699951171875,155.24000549316406,151.3800048828125,154.64999389648438,90481100.0,-2.94000244140625,2.94000244140625,0.0,36.46415416643728,151.3800048828125,171.0500030517578,5.032996067777887,-94.96700393222211,-2.0178089432236277,-0.9256605295589054,-0.03538877791266226,840015300.0,-1.0
AAPL,2022-09-16,150.6999969482422,151.35000610351562,148.3699951171875,151.2100067138672,162278800.0,-1.6699981689453125,1.6699981689453125,0.0,33.72494358041817,148.3699951171875,164.25999450683594,14.663322344572085,-85.33667765542792,-2.4023192793631267,-1.2209922795197499,-0.03279635896554012,677736500.0,-1.0
AAPL,2022-09-19,154.47999572753906,154.55999755859375,149.10000610351562,149.30999755859375,81474200.0,3.779998779296875,0.0,3.779998779296875,44.59500020369703,148.3699951171875,164.25999450683594,38.451861831611716,-61.54813816838828,-2.3746585941796354,-1.4517255424517272,-0.0003235815191406921,759210700.0,1.0
AAPL,2022-09-20,156.89999389648438,158.0800018310547,153.0800018310547,153.39999389648438,107689800.0,2.4199981689453125,0.0,2.4199981689453125,50.58235544118079,148.3699951171875,164.25999450683594,53.68155510977398,-46.31844489022602,-2.132877193801761,-1.5879558727217342,0.006027104014824314,866900500.0,1.0
AAPL,2022-09-21,153.72000122070312,158.74000549316406,153.60000610351562,157.33999633789062,101696800.0,-3.17999267578125,3.17999267578125,0.0,43.46125205284931,148.3699951171875,164.25999450683594,33.66901390191931,-66.33098609808069,-2.172815658311009,-1.7049278298395896,-0.004790919726780141,765203700.0,-1.0
AAPL,2022-09-22,152.74000549316406,154.47000122070312,150.91000366210938,152.3800048828125,86652500.0,-0.9799957275390625,0.9799957275390625,0.0,41.38928822466451,148.3699951171875,164.25999450683594,27.501639671700755,-72.49836032829926,-2.257521343433183,-1.8154465325583082,-0.029421044466422352,678551200.0,-1.0
AAPL,2022-09-23,150.42999267578125,151.47000122070312,148.55999755859375,151.19000244140625,96029900.0,-2.3100128173828125,2.3100128173828125,0.0,36.638596217737685,148.3699951171875,164.25999450683594,12.964113516176335,-87.03588648382366,-2.4824339842354277,-1.948844022893732,-0.07954476278898148,582521300.0,-1.0
AAPL,2022-09-26,150.77000427246094,153.77000427246094,149.63999938964844,149.66000366210938,93339400.0,0.3400115966796875,0.0,0.3400115966796875,37.85013235461546,148.3699951171875,164.25999450683594,15.103897089114596,-84.8961029108854,-2.6032343135136387,-2.0797220810177137,-0.019955747130198986,675860700.0,1.0
AAPL,2022-09-27,151.75999450683594,154.72000122070312,149.9499969482422,152.74000549316406,84442700.0,0.989990234375,0.0,0.989990234375,41.60157088464449,148.3699951171875,164.25999450683594,21.33416941385698,-78.66583058614303,-2.589238378285586,-2.1816253404712884,-0.02285753079365349,760303400.0,1.0
AAPL,2022-09-28,149.83999633789062,150.63999938964844,144.83999633789062,147.63999938964844,146691400.0,-1.9199981689453125,1.9199981689453125,0.0,36.65093991985833,144.83999633789062,164.25999450683594,25.74665536269485,-74.25334463730515,-2.701928158996708,-2.2856859041763724,-0.0166043109560452,613612000.0,-1.0
AAPL,2022-09-29,142.47999572753906,146.72000122070312,140.67999267578125,146.10000610351562,128138200.0,-7.3600006103515625,7.3600006103515625,0.0,24.012124851327314,140.67999267578125,164.25999450683594,7.63360013563367,-92.36639986436633,-3.3465492249494844,-2.497858568330995,-0.054545463750249934,485473800.0,-1.0
AAPL,2022-09-30,138.1999969482422,143.10000610351562,138.0,141.27999877929688,124925300.0,-4.279998779296875,4.279998779296875,0.0,19.500097471662187,138.0,160.5399932861328,0.887298171314145,-99.11270182868586,-4.154881310583448,-2.829263116781486,-0.10538580547354748,360548500.0,-1.0
AAPL,2022-10-03,142.4499969482422,143.07000732421875,137.69000244140625,138.2100067138672,114311700.0,4.25,0.0,4.25,33.76102920841164,137.69000244140625,158.74000549316406,22.612797229207278,-77.38720277079273,-4.401809510888285,-3.1437723956028463,-0.09209686112400772,474860200.0,1.0
AAPL,2022-10-04,146.10000610351562,146.22000122070312,144.25999450683594,145.02999877929688,87830100.0,3.6500091552734375,0.0,3.6500091552734375,43.65287309384526,137.69000244140625,158.74000549316406,39.952505666772744,-60.047494333227256,-4.253939883231965,-3.36580589312867,-0.04957061577333133,562690300.0,1.0
AAPL,2022-10-05,146.39999389648438,147.3800048828125,143.00999450683594,144.07000732421875,79471000.0,0.29998779296875,0.0,0.29998779296875,44.43971177833439,137.69000244140625,158.74000549316406,41.377625616784805,-58.622374383215195,-4.06567901331303,-3.505780517165542,-0.04150852015625628,642161300.0,1.0
AAPL,2022-10-06,145.42999267578125,147.5399932861328,145.22000122070312,145.80999755859375,68402200.0,-0.970001220703125,0.970001220703125,0.0,42.239091549679515,137.69000244140625,158.74000549316406,36.76954447628292,-63.23045552371709,-3.949227671144172,-3.594469947961268,-0.03323805253900658,573759100.0,-1.0
AAPL,2022-10-07,140.08999633789062,143.10000610351562,139.4499969482422,142.5399932861328,85925600.0,-5.339996337890625,5.339996337890625,0.0,32.13196439618808,137.69000244140625,158.74000549316406,11.401394529888014,-88.59860547011199,-4.238968034904644,-3.7233695653499437,-0.07083642390345868,487833500.0,-1.0
AAPL,2022-10-10,140.4199981689453,141.88999938964844,138.57000732421875,140.4199981689453,74899000.0,0.3300018310546875,0.0,0.3300018310546875,33.27051987848158,137.69000244140625,158.74000549316406,12.969098963199865,-87.03090103680013,-4.391340332981514,-3.8569637188762584,-0.07472322580625701,562732500.0,1.0
AAPL,2022-10-11,138.97999572753906,141.35000610351562,138.22000122070312,139.89999389648438,77033700.0,-1.44000244140625,1.44000244140625,0.0,30.67916308468142,137.69000244140625,154.72000122070312,7.574828999406852,-92.42517100059315,-4.575548563746736,-4.000680687850354,-0.07247731497444887,485698800.0,-1.0
AAPL,2022-10-12,138.33999633789062,140.36000061035156,138.16000366210938,139.1300048828125,70433700.0,-0.6399993896484375,0.6399993896484375,0.0,29.500835145946056,137.69000244140625,154.72000122070312,3.816758326926971,-96.18324167307303,-4.718782330457827,-4.144301016371848,-0.029056706301179624,415265100.0,-1.0
AAPL,2022-10-13,142.99000549316406,143.58999633789062,134.3699951171875,134.99000549316406,113224000.0,4.6500091552734375,0.0,4.6500091552734375,46.67201078350694,134.3699951171875,154.72000122070312,42.358760641783725,-57.64123935821628,-4.406286319563435,-4.196698077010166,0.03465997576480273,528489100.0,1.0
AAPL,2022-10-14,138.3800048828125,144.52000427246094,138.19000244140625,144.30999755859375,88598000.0,-4.6100006103515625,4.6100006103515625,0.0,36.50188302031542,134.3699951171875,154.72000122070312,19.70520178336575,-80.29479821663425,-4.478988509921379,-4.253156163592409,-0.028571373482784157,439891100.0,-1.0
AAPL,2022-10-17,142.41000366210938,142.89999389648438,140.27000427246094,141.07000732421875,85250900.0,4.029998779296875,0.0,4.029998779296875,47.94370075804541,134.3699951171875,150.63999938964844,49.41614280047005,-50.583857199529945,-4.163424927267329,-4.235209916327393,-0.025256689166678004,525142000.0,1.0
AAPL,2022-10-18,143.75,146.6999969482422,140.61000061035156,145.49000549316406,99136600.0,1.339996337890625,0.0,1.339996337890625,51.309766832440765,134.3699951171875,147.5399932861328,71.22252230019616,-28.77747769980385,-3.761847769432933,-4.140537486948501,-0.018101051960139558,624278600.0,1.0
AAPL,2022-10-19,143.86000061035156,144.9499969482422,141.5,141.69000244140625,61758300.0,0.1100006103515625,0.0,0.1100006103515625,51.60616721252794,134.3699951171875,147.5399932861328,72.05775863766917,-27.942241362330826,-3.3955767535582027,-3.9915453402704415,-0.01079551773704479,686036900.0,1.0
AAPL,2022-10-20,143.38999938964844,145.88999938964844,142.64999389648438,143.02000427246094,64522000.0,-0.470001220703125,0.470001220703125,0.0,50.102512214254105,134.3699951171875,147.5399932861328,68.48903209212278,-31.51096790787722,-3.107409225922595,-3.814718117400872,0.023556307645253627,621514900.0,-1.0
AAPL,2022-10-21,147.27000427246094,147.85000610351562,142.64999389648438,142.8699951171875,86548600.0,3.8800048828125,0.0,3.8800048828125,60.942567181760694,134.3699951171875,147.85000610351562,95.69731930008852,-4.302680699911481,-2.5367088164575478,-3.559116257212207,0.04878226885656334,708063500.0,1.0
AAPL,2022-10-24,149.4499969482422,150.22999572753906,146.0,147.19000244140625,75981900.0,2.17999267578125,0.0,2.17999267578125,65.76429555737565,134.3699951171875,150.22999572753906,95.08197509911959,-4.918024900880411,-1.8867679538062987,-3.2246465965310254,0.07533459161438505,784045400.0,1.0
AAPL,2022-10-25,152.33999633789062,152.49000549316406,149.36000061035156,150.08999633789062,74732300.0,2.8899993896484375,0.0,2.8899993896484375,71.2023833699544,134.3699951171875,152.49000549316406,99.17213537872848,-0.8278646212715145,-1.1255121362721638,-2.8048197044792533,0.10119994485040662,858777700.0,1.0
AAPL,2022-10-26,149.35000610351562,151.99000549316406,148.0399932861328,150.9600067138672,88194300.0,-2.989990234375,2.989990234375,0.0,59.852988348818236,134.3699951171875,152.49000549316406,82.6710949690656,-17.3289050309344,-0.7547780285671308,-2.394811369296829,0.04447863742935243,770583400.0,-1.0
AAPL,2022-10-27,144.8000030517578,149.0500030517578,144.1300048828125,148.07000732421875,109180200.0,-4.5500030517578125,4.5500030517578125,0.0,46.76462219956993,134.3699951171875,152.49000549316406,57.560717230042954,-42.439282769957046,-0.8186785804647343,-2.07958481153041,0.04639397270134582,661403200.0,-1.0
AAPL,2022-10-28,155.74000549316406,157.5,147.82000732421875,148.1999969482422,164762400.0,10.94000244140625,0.0,10.94000244140625,66.86603677868375,134.3699951171875,157.5,92.39085976958113,-7.609140230418881,0.01329330246801419,-1.661009188730725,0.09360298776961096,826165600.0,1.0
AAPL,2022-10-31,153.33999633789062,154.24000549316406,151.9199981689453,153.16000366210938,97943200.0,-2.4000091552734375,2.4000091552734375,0.0,61.032513658765794,134.3699951171875,157.5,82.01468748845531,-17.98531251154469,0.4735179128639402,-1.2341037684117921,0.06671301800271734,728222400.0,-1.0
AAPL,2022-11-01,150.64999389648438,155.4499969482422,149.1300048828125,155.0800018310547,80379300.0,-2.69000244140625,2.69000244140625,0.0,54.84456605522574,134.3699951171875,157.5,70.3847615328186,-29.615238467181403,0.6141094451945719,-0.8644611256905192,0.04719861849940954,647843100.0,-1.0
AAPL,2022-11-02,145.02999877929688,152.1699981689453,145.0,148.9499969482422,93604600.0,-5.6199951171875,5.6199951171875,0.0,44.07279458943187,138.19000244140625,157.5,35.42204662188858,-64.57795337811142,0.26894240909453515,-0.6377804187335083,0.011437334518650033,554238500.0,-1.0
AAPL,2022-11-03,138.8800048828125,142.8000030517578,138.75,142.05999755859375,97918500.0,-6.149993896484375,6.149993896484375,0.0,35.31492509996774,138.75,157.5,0.693359375,-99.306640625,-0.495150279411007,-0.6092543908690081,-0.056970185008797136,456320000.0,-1.0
AAPL,2022-11-04,138.3800048828125,142.6699981689453,134.3800048828125,142.08999633789062,140814800.0,-0.5,0.5,0.0,34.66866371305099,134.3800048828125,157.5,17.301041716165344,-82.69895828383466,-1.1280416988451236,-0.7130118524642313,-0.07407154427218532,315505200.0,-1.0
AAPL,2022-11-07,138.9199981689453,139.14999389648438,135.6699981689453,137.11000061035156,83374600.0,0.5399932861328125,0.0,0.5399932861328125,36.125280095515016,134.3800048828125,157.5,19.636653308623593,-80.3633466913764,-1.5679652359883676,-0.8840025291690586,-0.08809241493730713,398879800.0,1.0
AAPL,2022-11-08,139.5,141.42999267578125,137.49000549316406,140.41000366210938,89908500.0,0.5800018310546875,0.0,0.5800018310546875,37.8428085576766,134.3800048828125,157.5,22.14531227725595,-77.85468772274406,-1.8484981718884228,-1.0769016577129316,-0.06595249883477416,488788300.0,1.0
AAPL,2022-11-09,134.8699951171875,138.5500030517578,134.58999633789062,138.5,74917800.0,-4.6300048828125,4.6300048828125,0.0,30.330762339957502,134.3800048828125,157.5,2.1193353713588774,-97.88066462864113,-2.4165685462579347,-1.3448350354219323,-0.0685774014177396,413870500.0,-1.0
AAPL,2022-11-10,146.8699951171875,146.8699951171875,139.5,141.24000549316406,118854000.0,12.0,0.0,12.0,56.28293011652243,134.3800048828125,157.5,54.02246051985491,-45.97753948014509,-1.8768337279291245,-1.4512347739233709,-0.05695396213637538,532724500.0,1.0
AAPL,2022-11-11,149.6999969482422,150.00999450683594,144.3699951171875,145.82000732421875,93979700.0,2.8300018310546875,0.0,2.8300018310546875,60.30644788859104,134.3800048828125,157.5,66.26295545383027,-33.73704454616973,-1.2068210178958907,-1.402352022717875,-0.023738094930089604,626704200.0,1.0
AAPL,2022-11-14,148.27999877929688,150.27999877929688,147.42999267578125,148.97000122070312,73374100.0,-1.4199981689453125,1.4199981689453125,0.0,57.25559154289691,134.3800048828125,157.5,60.121093564379954,-39.878906435620046,-0.7814055461003022,-1.2781627273943605,-0.015731796967851097,553330100.0,-1.0
AAPL,2022-11-15,150.0399932861328,153.58999633789062,148.55999755859375,152.22000122070312,89868300.0,1.7599945068359375,0.0,1.7599945068359375,60.139442510298736,134.3800048828125,157.5,67.73352816012756,-32.26647183987244,-0.2987994973264847,-1.0822900813807854,0.034544539398776664,643198400.0,1.0
AAPL,2022-11-16,148.7899932861328,149.8699951171875,147.2899932861328,149.1300048828125,64218300.0,-1.25,1.25,0.0,56.98859036755358,134.3800048828125,157.5,62.326952623825896,-37.673047376174104,-0.01699932239174018,-0.8692319295829763,0.07135648081005175,578980100.0,-1.0
AAPL,2022-11-17,150.72000122070312,151.47999572753906,146.14999389648438,146.42999267578125,80389400.0,1.9300079345703125,0.0,1.9300079345703125,60.660519066336924,134.3800048828125,155.4499969482422,77.55103223175988,-22.448967768240124,0.35793876183785756,-0.6237977912988095,0.08917470662283034,659369500.0,1.0
AAPL,2022-11-18,151.2899932861328,152.6999969482422,149.97000122070312,152.30999755859375,74829600.0,0.5699920654296875,0.0,0.5699920654296875,61.77261630268026,134.3800048828125,155.4499969482422,80.25626374613189,-19.743736253868107,0.6930840494384825,-0.36042142315135106,0.08904402015715496,734199100.0,1.0
AAPL,2022-11-21,148.00999450683594,150.3699951171875,147.72000122070312,150.16000366210938,58724100.0,-3.279998779296875,3.279998779296875,0.0,52.010235672251774,134.3800048828125,153.58999633789062,70.95260638661229,-29.047393613387705,0.6861115482194009,-0.15111482887720062,0.06100354485187043,675475000.0,-1.0
AAPL,2022-11-22,150.17999267578125,150.4199981689453,146.92999267578125,148.1300048828125,51804100.0,2.1699981689453125,0.0,2.1699981689453125,57.176488003046686,134.3800048828125,153.58999633789062,82.24880177545344,-17.751198224546567,0.8459350943799393,0.048295155774227425,0.11351670581207496,727279100.0,1.0
AAPL,2022-11-23,151.07000732421875,151.8300018310547,149.33999633789062,149.4499969482422,58301400.0,0.8900146484375,0.0,0.8900146484375,59.252426318680875,134.3800048828125,153.58999633789062,86.88188373448901,-13.11811626551099,1.0325110059835936,0.2451383258161007,0.028596802251406483,785580500.0,1.0
AAPL,2022-11-25,148.11000061035156,148.8800048828125,147.1199951171875,148.30999755859375,35195900.0,-2.9600067138671875,2.9600067138671875,0.0,49.95875663134789,134.58999633789062,153.58999633789062,71.15791722347862,-28.842082776521384,0.9307963156097685,0.3822699237748343,-0.010621218238503705,750384600.0,-1.0
AAPL,2022-11-28,144.22000122070312,146.63999938964844,143.3800048828125,145.13999938964844,69246000.0,-3.8899993896484375,3.8899993896484375,0.0,40.3596069120908,134.58999633789062,153.58999633789062,50.68423622532895,-49.31576377467105,0.5301846118336755,0.41185286138660254,-0.027380614998768205,681138600.0,-1.0
AAPL,2022-11-29,141.1699981689453,144.80999755859375,140.35000610351562,144.2899932861328,83763800.0,-3.0500030517578125,3.0500030517578125,0.0,34.382896053142076,134.58999633789062,153.58999633789062,34.63158858449836,-65.36841141550165,-0.03303203328019322,0.3228758824532434,-0.05911753875029857,597374800.0,-1.0
AAPL,2022-11-30,148.02999877929688,148.72000122070312,140.5500030517578,141.39999389648438,111380900.0,6.8600006103515625,0.0,6.8600006103515625,52.59957914716254,139.5,153.58999633789062,60.539396709125604,-39.460603290874396,0.07331431377576791,0.2729635687177483,-0.005107833464139122,708755700.0,1.0
AAPL,2022-12-01,148.30999755859375,149.1300048828125,146.61000061035156,148.2100067138672,71250400.0,0.279998779296875,0.0,0.279998779296875,53.21132756917431,140.35000610351562,153.58999633789062,60.120825726982716,-39.87917427301728,0.17813469555810002,0.25399779408581863,-0.015989939242239903,780006100.0,1.0
AAPL,2022-12-02,147.80999755859375,148.0,145.64999389648438,145.9600067138672,65447400.0,-0.5,0.5,0.0,51.83298041196597,140.35000610351562,153.58999633789062,56.34438789622172,-43.65561210377828,0.21834286139261394,0.24686680754717769,-0.02300215402189487,714558700.0,-1.0
AAPL,2022-12-05,146.6300048828125,150.9199981689453,145.77000427246094,147.77000427246094,68826400.0,-1.17999267578125,1.17999267578125,0.0,48.41777696455465,140.35000610351562,153.58999633789062,47.432049934539286,-52.567950065460714,0.1532262780223448,0.22813870164221112,-0.009323624587795676,645732300.0,-1.0
AAPL,2022-12-06,142.91000366210938,147.3000030517578,141.9199981689453,147.07000732421875,64727200.0,-3.720001220703125,3.720001220703125,0.0,39.05684247085141,140.35000610351562,152.6999969482422,20.72874053738159,-79.27125946261842,-0.19628939069161788,0.1432530831754453,-0.04840850558147791,581005100.0,-1.0
AAPL,2022-12-07,140.94000244140625,143.3699951171875,140.0,142.19000244140625,69721100.0,-1.970001220703125,1.970001220703125,0.0,34.93028575293674,140.0,152.6999969482422,7.4015958053939235,-92.59840419460608,-0.6250406314701138,-0.010405659753666566,-0.06705503668290691,511284000.0,-1.0
AAPL,2022-12-08,142.64999389648438,143.52000427246094,141.10000610351562,142.36000061035156,62128300.0,1.709991455078125,0.0,1.709991455078125,41.15702477512303,140.0,152.6999969482422,20.866098687143086,-79.13390131285692,-0.8174243008319877,-0.17180938796933085,-0.03686453778520604,573412300.0,1.0
AAPL,2022-12-09,142.16000366210938,145.57000732421875,140.89999389648438,142.33999633789062,76097000.0,-0.489990234375,0.489990234375,0.0,39.894792260469366,140.0,151.8300018310547,18.25869254254209,-81.7413074574579,-0.9979244103296594,-0.3370323924413966,-0.01428371613616397,497315300.0,-1.0
AAPL,2022-12-12,144.49000549316406,144.5,141.05999755859375,142.6999969482422,70462700.0,2.3300018310546875,0.0,2.3300018310546875,48.552047658076475,140.0,151.8300018310547,37.95439389854906,-62.045606101450936,-0.9421004251473448,-0.4580459989825863,0.0235177967505924,567778000.0,1.0
AAPL,2022-12-13,145.47000122070312,149.97000122070312,144.24000549316406,149.5,93886200.0,0.9799957275390625,0.0,0.9799957275390625,51.913356500250366,140.0,151.8300018310547,46.23838016951055,-53.76161983048946,-0.8094512000852205,-0.5283270392031132,-0.01729377544892463,661664200.0,1.0
AAPL,2022-12-14,143.2100067138672,146.66000366210938,141.16000366210938,145.35000610351562,82291200.0,-2.2599945068359375,2.2599945068359375,0.0,44.22491312589892,140.0,150.9199981689453,29.395670806941354,-70.60432919305865,-0.8765836915352736,-0.5979783696695453,-0.03438737056624708,579373000.0,-1.0
AAPL,2022-12-15,136.5,141.8000030517578,136.02999877929688,141.11000061035156,98931900.0,-6.7100067138671875,6.7100067138671875,0.0,29.339167913009504,136.02999877929688,150.9199981689453,3.156489187164581,-96.84351081283542,-1.4544620059823217,-0.7692750969321007,-0.07651713514243397,480441100.0,-1.0
AAPL,2022-12-16,134.50999450683594,137.64999389648438,133.72999572753906,136.69000244140625,160156900.0,-1.9900054931640625,1.9900054931640625,0.0,26.30887195023979,133.72999572753906,150.9199981689453,4.5375140693293945,-95.46248593067061,-2.0493874824996965,-1.02529757404562,-0.08265709590382231,320284200.0,-1.0
AAPL,2022-12-19,132.3699951171875,135.1999969482422,131.32000732421875,135.11000061035156,79592600.0,-2.1399993896484375,2.1399993896484375,0.0,23.32020879185046,131.32000732421875,150.9199981689453,5.357083078695685,-94.64291692130432,-2.662854545241686,-1.3528089682848334,-0.07375276939914044,240691600.0,-1.0
AAPL,2022-12-20,132.3000030517578,133.25,129.88999938964844,131.38999938964844,77432800.0,-0.0699920654296875,0.0699920654296875,0.0,23.220660827270038,129.88999938964844,150.9199981689453,11.459837384688388,-88.54016261531162,-3.118728624743426,-1.7059928995765523,-0.061302676599856,163258800.0,-1.0
AAPL,2022-12-21,135.4499969482422,136.80999755859375,132.75,132.97999572753906,85928000.0,3.149993896484375,0.0,3.149993896484375,37.15219314560677,129.88999938964844,150.9199981689453,26.438411228379756,-73.56158877162025,-3.189072295006781,-2.0026087786625983,-0.050473166886126575,249186800.0,1.0
AAPL,2022-12-22,132.22999572753906,134.55999755859375,130.3000030517578,134.35000610351562,77852100.0,-3.220001220703125,3.220001220703125,0.0,30.60269005489114,129.88999938964844,150.9199981689453,11.126944715727944,-88.87305528427206,-3.464708347206482,-2.295028692371375,-0.0698509262715854,171334700.0,-1.0
AAPL,2022-12-23,131.86000061035156,132.4199981689453,129.63999938964844,130.9199981689453,63814900.0,-0.3699951171875,0.3699951171875,0.0,29.9037539594633,129.63999938964844,149.97000122070312,10.919827942720628,-89.08017205727937,-3.6706939433527452,-2.5701617425676493,-0.087410923957713,107519800.0,-1.0
AAPL,2022-12-27,130.02999877929688,131.41000366210938,128.72000122070312,131.3800048828125,69007800.0,-1.8300018310546875,1.8300018310546875,0.0,26.455513806823703,128.72000122070312,149.97000122070312,6.164694393382353,-93.83530560661765,-3.9362304517183873,-2.843375484397797,-0.10613873865293433,38512000.0,-1.0
AAPL,2022-12-28,126.04000091552734,131.02999877929688,125.87000274658205,129.6699981689453,85438400.0,-3.9899978637695312,3.9899978637695312,0.0,20.506633730665442,125.87000274658205,149.97000122070312,0.7053866377952046,-99.2946133622048,-4.4177049764455205,-3.158241382807342,-0.11989389702805775,-46926400.0,-1.0
AAPL,2022-12-29,129.61000061035156,130.47999572753906,127.7300033569336,127.98999786376952,75703700.0,3.5699996948242188,0.0,3.5699996948242188,35.48384378567371,125.87000274658205,149.97000122070312,15.518664317699354,-84.48133568230064,-4.459798090232141,-3.4185527242923026,-0.050476186004750456,28777300.0,1.0
AAPL,2022-12-30,129.92999267578125,129.9499969482422,127.43000030517578,128.41000366210938,77034200.0,0.3199920654296875,0.0,0.3199920654296875,36.716966392567144,125.87000274658205,149.97000122070312,16.846432308113542,-83.15356769188645,-4.41642668310493,-3.618127516054828,-0.034049528050660416,105811500.0,1.0
AAPL,2023-01-03,125.06999969482422,130.89999389648438,124.16999816894533,130.27999877929688,112117500.0,-4.859992980957031,4.859992980957031,0.0,27.50434186080136,124.16999816894533,149.97000122070312,3.4883775946591347,-96.51162240534087,-4.719808334883879,-3.8384636798206384,-0.055148414985590755,-6306000.0,-1.0
AAPL,2023-01-04,126.36000061035156,128.66000366210938,125.08000183105467,126.88999938964844,89113600.0,1.2900009155273438,0.0,1.2900009155273438,32.677758218917816,124.16999816894533,146.66000366210938,9.737669659849118,-90.26233034015088,-4.800807466692731,-4.030932437195057,-0.044897976601575906,82807600.0,1.0
AAPL,2023-01-05,125.0199966430664,127.7699966430664,124.76000213623048,127.12999725341795,80962700.0,-1.3400039672851562,1.3400039672851562,0.0,30.102985074085623,124.16999816894533,141.8000030517578,4.821317292712403,-95.17868270728759,-4.916453171720207,-4.208036584100087,-0.0770025879672871,1844900.0,-1.0
AAPL,2023-01-06,129.6199951171875,130.2899932861328,124.88999938964844,126.01000213623048,87754700.0,4.599998474121094,0.0,4.599998474121094,46.7286764087791,124.16999816894533,137.64999389648438,40.43025723745643,-59.56974276254358,-4.584079379470296,-4.283245143174129,-0.019738339973401242,89599600.0,1.0
AAPL,2023-01-09,130.14999389648438,133.41000366210938,129.88999938964844,130.47000122070312,70790800.0,0.529998779296875,0.0,0.529998779296875,48.36157480379306,124.16999816894533,136.80999755859375,47.3100950656405,-52.6899049343595,-4.229153236430648,-4.272426761825433,-0.012968350568420606,160390400.0,1.0
AAPL,2023-01-10,130.72999572753906,131.25999450683594,128.1199951171875,130.25999450683594,63896200.0,0.5800018310546875,0.0,0.5800018310546875,50.285768583208196,124.16999816894533,136.80999755859375,51.89871736834157,-48.10128263165842,-3.8566137676239123,-4.189264162985129,0.005383349648647728,224286600.0,1.0
AAPL,2023-01-11,133.49000549316406,133.50999450683594,130.4600067138672,131.25,69458900.0,2.760009765625,0.0,2.760009765625,58.729666210492994,124.16999816894533,136.80999755859375,73.73423872038627,-26.26576127961373,-3.300616381783925,-4.011534606744888,0.05910825550239207,293745500.0,1.0
AAPL,2023-01-12,133.41000366210938,134.25999450683594,131.44000244140625,133.8800048828125,71379600.0,-0.0800018310546875,0.0800018310546875,0.0,58.39792694759878,124.16999816894533,134.55999755859375,88.93172315649878,-11.068276843501225,-2.833773944850549,-3.77598247436602,0.029318748814621376,222365900.0,-1.0
AAPL,2023-01-13,134.75999450683594,134.9199981689453,131.66000366210938,132.02999877929688,57809700.0,1.3499908447265625,0.0,1.3499908447265625,62.520017475932114,124.16999816894533,134.9199981689453,98.51159384084302,-1.4884061591569786,-2.3280289032881285,-3.4863917601504424,0.037173879037361024,280175600.0,1.0
AAPL,2023-01-17,135.94000244140625,137.2899932861328,134.1300048828125,134.8300018310547,63646600.0,1.1800079345703125,0.0,1.1800079345703125,65.92518206380544,124.16999816894533,137.2899932861328,89.71043180528288,-10.28956819471712,-1.81112797961066,-3.151339004042486,0.08691135182781862,343822200.0,1.0
AAPL,2023-01-18,135.2100067138672,138.61000061035156,135.02999877929688,136.82000732421875,69672800.0,-0.7299957275390625,0.7299957275390625,0.0,61.910194586328345,124.16999816894533,138.61000061035156,76.45433987784514,-23.545660122154853,-1.4437422657683499,-2.809819656387659,0.0700380346689442,274149400.0,-1.0
AAPL,2023-01-19,135.27000427246094,136.25,133.77000427246094,134.0800018310547,58280400.0,0.05999755859375,0.0,0.05999755859375,62.128921235852324,124.16999816894533,138.61000061035156,76.86983536572477,-23.13016463427523,-1.1346654224340682,-2.474788809596941,0.08198694532570205,332429800.0,1.0
AAPL,2023-01-20,137.8699951171875,138.02000427246094,134.22000122070312,135.27999877929688,80223600.0,2.5999908447265625,0.0,2.5999908447265625,70.57712227801152,124.16999816894533,138.61000061035156,94.87530908552951,-5.1246909144704915,-0.6721738632915617,-2.114265820335865,0.06364758764680789,412653400.0,1.0
AAPL,2023-01-23,141.11000061035156,143.32000732421875,137.89999389648438,138.1199951171875,81760300.0,3.2400054931640625,0.0,3.2400054931640625,77.72274490359914,124.16999816894533,143.32000732421875,88.45950048405795,-11.540499515942049,-0.04370084897263382,-1.7001528260632188,0.08421058185054009,494413700.0,1.0
AAPL,2023-01-24,142.52999877929688,143.16000366210938,140.3000030517578,140.30999755859375,66435100.0,1.4199981689453125,0.0,1.4199981689453125,80.15942806149482,124.76000213623048,143.32000732421875,95.7434896331109,-4.256510366889097,0.5624667608964842,-1.2476289086712782,0.09026239912338707,560848800.0,1.0
AAPL,2023-01-25,141.86000061035156,142.42999267578125,138.80999755859375,140.88999938964844,65799300.0,-0.6699981689453125,0.6699981689453125,0.0,75.65432351300922,124.76000213623048,143.32000732421875,92.13358671466277,-7.8664132853372255,0.9775273789590244,-0.8025976511452176,0.062701286783722,495049500.0,-1.0
AAPL,2023-01-26,143.9600067138672,144.25,141.89999389648438,143.1699981689453,54105100.0,2.100006103515625,0.0,2.100006103515625,79.76684925387707,124.88999938964844,144.25,98.50210084199193,-1.497899158008066,1.4590992631464985,-0.35025826828687434,0.07907954997496325,549154600.0,1.0
AAPL,2023-01-27,145.92999267578125,147.22999572753906,143.0800018310547,143.16000366210938,70555800.0,1.9699859619140625,0.0,1.9699859619140625,82.89446825569135,128.1199951171875,147.22999572753906,93.19726315940763,-6.80273684059237,1.9769211378831528,0.11517761294713122,0.08288808714947438,619710400.0,1.0
AAPL,2023-01-30,143.0,145.5500030517578,142.85000610351562,144.9600067138672,64015300.0,-2.92999267578125,2.92999267578125,0.0,65.51481350226734,128.1199951171875,147.22999572753906,77.86501521487264,-22.13498478512735,2.1263614116130043,0.517414372680306,0.0519346581712532,555695100.0,-1.0
AAPL,2023-01-31,144.2899932861328,144.33999633789062,142.27999877929688,142.6999969482422,65874500.0,1.2899932861328125,0.0,1.2899932861328125,68.83423366163431,130.4600067138672,147.22999572753906,82.46866805333391,-17.531331946666086,2.322117655604359,0.8783550292651167,0.06715469359809134,621569600.0,1.0
AAPL,2023-02-01,145.42999267578125,146.61000061035156,141.32000732421875,143.97000122070312,77663600.0,1.1399993896484375,0.0,1.1399993896484375,71.61978054918058,131.44000244140625,147.22999572753906,88.60035581307926,-11.39964418692073,2.5399651752207717,1.2106770584562478,0.0751089530747413,699233200.0,1.0
AAPL,2023-02-02,150.82000732421875,151.17999267578125,148.1699981689453,148.89999389648438,118339000.0,5.3900146484375,0.0,5.3900146484375,80.92217508507113,131.66000366210938,151.17999267578125,98.15581171018916,-1.8441882898108442,3.111670637756049,1.5908757743162083,0.09392915547740421,817572200.0,1.0
AAPL,2023-02-03,154.5,157.3800048828125,147.8300018310547,148.02999877929688,154357300.0,3.67999267578125,0.0,3.67999267578125,84.83740633163674,133.77000427246094,157.3800048828125,87.80175854146403,-12.19824145853597,3.8176880581778505,2.036238231088537,0.09489050621310935,971929500.0,1.0
AAPL,2023-02-06,151.72999572753906,153.10000610351562,150.77999877929688,152.57000732421875,69858300.0,-2.7700042724609375,2.7700042724609375,0.0,72.00338230026559,133.77000427246094,157.3800048828125,76.06942393387212,-23.93057606612788,4.1063601913812136,2.4502626231470725,0.06454779363667917,902071200.0,-1.0
AAPL,2023-02-07,154.64999389648438,155.22999572753906,150.63999938964844,150.63999938964844,83322600.0,2.9199981689453125,0.0,2.9199981689453125,76.3542730863248,133.77000427246094,157.3800048828125,88.43705668888809,-11.562943311111901,4.518666016440648,2.863943301805788,0.09015926428241894,985393800.0,1.0
AAPL,2023-02-08,151.9199981689453,154.5800018310547,151.1699981689453,153.8800048828125,64120100.0,-2.7299957275390625,2.7299957275390625,0.0,65.39148303466214,134.22000122070312,157.3800048828125,76.42484520501195,-23.575154794988055,4.572425439387928,3.205639729322216,0.055293075047567086,921273700.0,-1.0
AAPL,2023-02-09,150.8699951171875,154.3300018310547,150.4199981689453,153.77999877929688,56007100.0,-1.0500030517578125,1.0500030517578125,0.0,61.474435853016594,137.89999389648438,157.3800048828125,66.5810775456236,-33.41892245437641,4.478676305780311,3.460247044613835,0.0338518652048565,865266600.0,-1.0
AAPL,2023-02-10,151.00999450683594,151.33999633789062,149.22000122070312,149.4600067138672,57450700.0,0.1399993896484375,0.0,0.1399993896484375,61.82622803069852,138.80999755859375,157.3800048828125,65.69731898991293,-34.30268101008706,4.365355126136279,3.641268660918324,0.056013947600251246,922717300.0,1.0
AAPL,2023-02-13,153.85000610351562,154.25999450683594,150.9199981689453,150.9499969482422,62199000.0,2.8400115966796875,0.0,2.8400115966796875,68.548555258178,138.80999755859375,157.3800048828125,80.99085952059319,-19.009140479406806,4.453376721009164,3.8036902729364925,0.06625554967228342,984916300.0,1.0
AAPL,2023-02-14,153.1999969482422,153.77000427246094,150.86000061035156,152.1199951171875,61707600.0,-0.6500091552734375,0.6500091552734375,0.0,65.50235295577025,141.32000732421875,157.3800048828125,73.97254937729689,-26.027450622703107,4.419736194964571,3.9268994573421083,0.053427798004385796,923208700.0,-1.0
AAPL,2023-02-15,155.3300018310547,155.5,152.8800048828125,153.11000061035156,65573800.0,2.1300048828125,0.0,2.1300048828125,70.46493205867513,141.32000732421875,157.3800048828125,87.23534642967084,-12.764653570329157,4.512927212846705,4.044105008443028,0.029903157988454332,988782500.0,1.0
AAPL,2023-02-16,153.7100067138672,156.3300018310547,153.35000610351562,153.50999450683594,68167900.0,-1.6199951171875,1.6199951171875,0.0,62.5665007187758,141.32000732421875,157.3800048828125,77.14820219893815,-22.851797801061842,4.405280368929169,4.116340080540256,-0.005113225152963197,920614600.0,-1.0
AAPL,2023-02-17,152.5500030517578,153.0,150.85000610351562,152.35000610351562,59144100.0,-1.160003662109375,1.160003662109375,0.0,57.26330359319636,141.32000732421875,157.3800048828125,69.92526422602013,-30.074735773979867,4.178203143595567,4.128712693151319,0.005404385074202711,861470500.0,-1.0
AAPL,2023-02-21,148.47999572753906,151.3000030517578,148.41000366210938,150.1999969482422,58867200.0,-4.07000732421875,4.07000732421875,0.0,42.633697287273726,141.32000732421875,157.3800048828125,44.58274901473433,-55.41725098526567,3.6280058369880237,4.02857132191866,-0.039896530310083445,802603300.0,-1.0
AAPL,2023-02-22,148.91000366210938,149.9499969482422,147.16000366210938,148.8699951171875,51011300.0,0.4300079345703125,0.0,0.4300079345703125,44.36639432505666,147.16000366210938,157.3800048828125,17.123285625983534,-82.87671437401647,3.1898974025234565,3.8608365380396195,-0.01981302358553627,853614600.0,1.0
AAPL,2023-02-23,149.39999389648438,150.33999633789062,147.24000549316406,150.08999633789062,48394200.0,0.489990234375,0.0,0.489990234375,46.49134413271807,147.16000366210938,157.3800048828125,21.917710047209674,-78.08228995279033,2.8493854864968284,3.6585463277310617,-0.009743496177363253,902008800.0,1.0
AAPL,2023-02-24,146.7100067138672,147.19000244140625,145.72000122070312,147.11000061035156,55469600.0,-2.6899871826171875,2.6899871826171875,0.0,37.43420942882694,145.72000122070312,156.3300018310547,9.330871217841134,-90.66912878215886,2.3355451447116593,3.3939460911271815,-0.028474855634632146,846539200.0,-1.0
AAPL,2023-02-27,147.9199981689453,149.1699981689453,147.4499969482422,147.7100067138672,44998500.0,1.209991455078125,0.0,1.209991455078125,43.17940120400792,145.72000122070312,156.3300018310547,20.735125557823043,-79.26487444217696,2.002871316143029,3.115731136130351,-0.038544086443392134,891537700.0,1.0
AAPL,2023-02-28,147.41000366210938,149.0800018310547,146.8300018310547,147.0500030517578,50547000.0,-0.5099945068359375,0.5099945068359375,0.0,41.333530824925234,145.72000122070312,156.3300018310547,15.928391556899749,-84.07160844310026,1.6787213608372156,2.828329181071724,-0.0377936906101175,840990700.0,-1.0
AAPL,2023-03-01,145.30999755859375,147.22999572753906,145.00999450683594,146.8300018310547,55479000.0,-2.100006103515625,2.100006103515625,0.0,34.355620986699904,145.00999450683594,156.3300018310547,2.6502019227140137,-97.34979807728598,1.2381051384700186,2.510284372551383,-0.06450784880154214,785511700.0,-1.0
AAPL,2023-03-02,145.91000366210938,146.7100067138672,143.89999389648438,144.3800048828125,52238100.0,0.600006103515625,0.0,0.600006103515625,37.816459322986574,143.89999389648438,156.3300018310547,16.170623351210946,-83.82937664878905,0.9266472729246402,2.1935569526260346,-0.050744926882201,837749800.0,1.0
AAPL,2023-03-03,151.02999877929688,151.11000061035156,147.3300018310547,148.0399932861328,70732300.0,5.1199951171875,0.0,5.1199951171875,59.06536201927171,143.89999389648438,156.3300018310547,57.36122551444674,-42.63877448555326,1.080500153735386,1.970945592847905,-0.009963974054757796,908482100.0,1.0
AAPL,2023-03-06,153.8300018310547,156.3000030517578,153.4600067138672,153.7899932861328,87558000.0,2.8000030517578125,0.0,2.8000030517578125,66.32624549349737,143.89999389648438,156.3300018310547,79.88738210659541,-20.1126178934046,1.412088834810163,1.859174241240357,0.036031830936558595,996040100.0,1.0
AAPL,2023-03-07,151.60000610351562,154.02999877929688,151.1300048828125,153.6999969482422,56182000.0,-2.2299957275390625,2.2299957275390625,0.0,57.03022575952476,143.89999389648438,156.3300018310547,61.94696131782822,-38.05303868217178,1.4778969589845872,1.782918784789203,0.01806461873112375,939858100.0,-1.0
AAPL,2023-03-08,152.8699951171875,153.47000122070312,151.8300018310547,152.80999755859375,47204800.0,1.269989013671875,0.0,1.269989013671875,60.653961163011985,143.89999389648438,156.3300018310547,72.1640828221499,-27.835917177850096,1.6139235649527848,1.7491197408219192,0.02322624740605672,987062900.0,1.0
AAPL,2023-03-09,150.58999633789062,154.5399932861328,150.22999572753906,153.55999755859375,53833600.0,-2.279998779296875,2.279998779296875,0.0,51.63387504879302,143.89999389648438,156.3000030517578,53.951592757987164,-46.04840724201283,1.5202245807964516,1.703340708816826,0.026446659712794363,933229300.0,-1.0
AAPL,2023-03-10,148.5,150.94000244140625,147.61000061035156,150.2100067138672,68572400.0,-2.089996337890625,2.089996337890625,0.0,44.61606517427978,143.89999389648438,156.3000030517578,37.09679602582671,-62.90320397417328,1.2627658445368581,1.6152257359608326,0.003921050826354522,864656900.0,-1.0
AAPL,2023-03-13,150.47000122070312,153.13999938964844,147.6999969482422,147.80999755859375,84457100.0,1.970001220703125,0.0,1.970001220703125,51.748625376637236,143.89999389648438,156.3000030517578,52.98389091450532,-47.01610908549468,1.2038137600073924,1.5329433407701447,0.020758411794139953,949114000.0,1.0
AAPL,2023-03-14,152.58999633789062,153.39999389648438,150.10000610351562,151.27999877929688,73695900.0,2.1199951171875,0.0,2.1199951171875,58.40079007154549,143.89999389648438,156.3000030517578,70.08061310753624,-29.919386892463763,1.3130239736701412,1.4889594673501443,0.05009977910405894,1022809900.0,1.0
AAPL,2023-03-15,152.99000549316406,153.25,149.9199981689453,151.19000244140625,77167900.0,0.4000091552734375,0.0,0.4000091552734375,59.61300010242342,143.89999389648438,156.3000030517578,73.30649101024184,-26.693508989758165,1.415533857459934,1.4742743453721023,0.0485230734929607,1099977800.0,1.0
AAPL,2023-03-16,155.85000610351562,156.4600067138672,151.63999938964844,152.16000366210938,76161100.0,2.8600006103515625,0.0,2.8600006103515625,67.4403771991067,143.89999389648438,156.4600067138672,95.14331219863618,-4.8566878013638135,1.7078646258422907,1.5209924014661402,0.03191423798699966,1176138900.0,1.0
AAPL,2023-03-17,155.0,156.74000549316406,154.27999877929688,156.0800018310547,98944600.0,-0.850006103515625,0.850006103515625,0.0,63.23744119233982,143.89999389648438,156.74000549316406,86.44856758841236,-13.551432411587639,1.8496291041993516,1.5867197420127828,0.007605786615216159,1077194300.0,-1.0
AAPL,2023-03-20,157.39999389648438,157.82000732421875,154.14999389648438,155.07000732421875,73641400.0,2.399993896484375,0.0,2.399993896484375,69.44179584221058,143.89999389648438,157.82000732421875,96.98266506771081,-3.017334932289189,2.1310722501622195,1.6955902436426704,0.03825849313626284,1150835700.0,1.0
AAPL,2023-03-21,159.27999877929688,159.39999389648438,156.5399932861328,157.32000732421875,73938300.0,1.8800048828125,0.0,1.8800048828125,73.48624086126334,143.89999389648438,159.39999389648438,99.22583795362904,-0.7741620463709677,2.4772623152844346,1.8519246579710233,0.04193107782332017,1224774000.0,1.0
AAPL,2023-03-22,157.8300018310547,162.13999938964844,157.80999755859375,159.3000030517578,75701800.0,-1.4499969482421875,1.4499969482421875,0.0,65.74277868107416,147.3300018310547,162.13999938964844,70.89805355104329,-29.101946448956717,2.6045936659872666,2.0024584595742723,0.048077599237861035,1149072200.0,-1.0
AAPL,2023-03-23,158.92999267578125,161.5500030517578,157.67999267578125,158.8300018310547,67622100.0,1.0999908447265625,0.0,1.0999908447265625,68.63568790028019,147.61000061035156,162.13999938964844,77.90772895011541,-22.092271049884587,2.7624212740547023,2.1544510224703584,0.07023564091435186,1216694300.0,1.0
AAPL,2023-03-24,160.25,160.33999633789062,157.85000610351562,158.86000061035156,59196500.0,1.32000732421875,0.0,1.32000732421875,71.91912354147291,147.61000061035156,162.13999938964844,86.99243256412788,-13.007567435872126,2.9598945281870215,2.315539723613691,0.0649963361464454,1275890800.0,1.0
AAPL,2023-03-27,158.27999877929688,160.77000427246094,157.8699951171875,159.94000244140625,52390300.0,-1.970001220703125,1.970001220703125,0.0,60.93430977405189,147.61000061035156,162.13999938964844,73.43426748354928,-26.56573251645072,2.9237279543806096,2.437177369767075,0.03728948540510135,1223500500.0,-1.0
AAPL,2023-03-28,157.64999389648438,158.49000549316406,155.97999572753906,157.97000122070312,45992200.0,-0.6300048828125,0.6300048828125,0.0,57.683261294257925,147.61000061035156,162.13999938964844,69.09837666633761,-30.901623333662382,2.811816682776538,2.5121052323689677,0.0304594302634269,1177508300.0,-1.0
AAPL,2023-03-29,160.77000427246094,161.0500030517578,159.35000610351562,159.3699951171875,51305700.0,3.1200103759765625,0.0,3.1200103759765625,67.57026992394285,147.61000061035156,162.13999938964844,90.5712647468385,-9.428735253161499,2.9409831332184524,2.5978808125388646,0.031568803184245375,1228814000.0,1.0
AAPL,2023-03-30,162.36000061035156,162.47000122070312,161.27000427246094,161.52999877929688,49501700.0,1.589996337890625,0.0,1.589996337890625,71.48747568470482,147.6999969482422,162.47000122070312,99.25524320560515,-0.7447567943948502,3.1355037565791406,2.70540540134692,0.047483874905493995,1278315700.0,1.0
AAPL,2023-03-31,164.89999389648438,165.0,161.91000366210938,162.44000244140625,68749800.0,2.5399932861328125,0.0,2.5399932861328125,76.67968130726113,149.9199981689453,165.0,99.3368296328076,-0.6631703671923932,3.4547942648685535,2.8552831740512468,0.047649302991285,1347065500.0,1.0
AAPL,2023-04-03,166.1699981689453,166.2899932861328,164.22000122070312,164.27000427246094,56976200.0,1.2700042724609375,0.0,1.2700042724609375,78.89678201013209,149.9199981689453,166.2899932861328,99.26698135015623,-0.7330186498437768,3.7668906533272946,3.0376046699064565,0.04325715370701011,1404041700.0,1.0
AAPL,2023-04-04,165.6300048828125,166.83999633789062,165.11000061035156,166.60000610351562,46278300.0,-0.5399932861328125,0.5399932861328125,0.0,75.38083000152037,151.63999938964844,166.83999633789062,92.03952830254973,-7.960471697450276,3.9254066994843697,3.2151650758220396,0.04942028106992691,1357763400.0,-1.0
AAPL,2023-04-05,163.75999450683594,165.0500030517578,161.8000030517578,164.74000549316406,51511700.0,-1.8700103759765625,1.8700103759765625,0.0,63.98679455842357,154.14999389648438,166.83999633789062,75.7289106501277,-24.2710893498723,3.8556915865724477,3.343270377972122,0.030390750982465242,1306251700.0,-1.0
AAPL,2023-04-06,164.66000366210938,164.9600067138672,162.0,162.42999267578125,45390100.0,0.9000091552734375,0.0,0.9000091552734375,66.77563790531897,154.14999389648438,166.83999633789062,82.82118001279382,-17.178819987206186,3.828927580733648,3.4404018185244274,0.02751952363250787,1351641800.0,1.0
AAPL,2023-04-10,162.02999877929688,162.02999877929688,160.0800018310547,161.4199981689453,47716900.0,-2.6300048828125,2.6300048828125,0.0,52.949983295329915,155.97999572753906,166.83999633789062,55.709048911019906,-44.290951088980094,3.554523168632983,3.463226088546139,0.023692191236549975,1303924900.0,-1.0
AAPL,2023-04-11,160.8000030517578,162.36000061035156,160.50999450683594,162.35000610351562,47644200.0,-1.2299957275390625,1.2299957275390625,0.0,47.62853512034825,155.97999572753906,166.83999633789062,44.3831220379896,-55.61687796201039,3.2009072530394462,3.410762321444801,0.019981029351271662,1256280700.0,-1.0
AAPL,2023-04-12,160.10000610351562,162.05999755859375,159.77999877929688,161.22000122070312,50133100.0,-0.6999969482421875,0.6999969482421875,0.0,44.679927906569745,155.97999572753906,166.83999633789062,37.93747830961852,-62.06252169038149,2.831539958591719,3.2949178488741846,-0.004167432674877847,1206147600.0,-1.0
AAPL,2023-04-13,165.55999755859375,165.8000030517578,161.4199981689453,161.6300048828125,68445600.0,5.459991455078125,0.0,5.459991455078125,64.47413423573155,155.97999572753906,166.83999633789062,88.21363989540846,-11.786360104591546,2.9454362404569565,3.225021527190739,0.019709269131637175,1274593200.0,1.0
AAPL,2023-04-14,165.2100067138672,166.32000732421875,163.82000732421875,164.58999633789062,49386500.0,-0.3499908447265625,0.3499908447265625,0.0,62.81183403367283,155.97999572753906,166.83999633789062,84.99088828347064,-15.00911171652937,2.973185496578793,3.1746543210683504,0.0018800050264247137,1225206700.0,-1.0
AAPL,2023-04-17,165.22999572753906,165.38999938964844,164.02999877929688,165.08999633789062,41516200.0,0.019989013671875,0.0,0.019989013671875,62.874911468619345,155.97999572753906,166.83999633789062,85.17494917249877,-14.825050827501226,2.962638476151483,3.132251152084977,-0.005656872189711115,1266722900.0,1.0
AAPL,2023-04-18,166.47000122070312,167.41000366210938,165.64999389648438,166.10000610351562,49923000.0,1.2400054931640625,0.0,1.2400054931640625,66.89423563437427,159.35000610351562,167.41000366210938,88.33743515959259,-11.662564840407406,3.019530696340894,3.109707060936161,0.005071522750270674,1316645900.0,1.0
AAPL,2023-04-19,167.6300048828125,168.16000366210938,165.5399932861328,165.8000030517578,47720200.0,1.160003662109375,0.0,1.160003662109375,70.35820250798251,159.77999877929688,168.16000366210938,93.67543591312328,-6.324564086876721,3.1222296715710343,3.112211583063136,0.023632208755447914,1364366100.0,1.0
AAPL,2023-04-20,166.64999389648438,167.8699951171875,165.55999755859375,166.08999633789062,52456400.0,-0.980010986328125,0.980010986328125,0.0,63.84606262289995,159.77999877929688,168.16000366210938,81.98080088566476,-18.01919911433524,3.0889333521545552,3.10755593688142,0.01208544995819727,1311909700.0,-1.0
AAPL,2023-04-21,165.02000427246094,166.4499969482422,164.49000549316406,165.0500030517578,58337300.0,-1.6299896240234375,1.6299896240234375,0.0,54.21582773139835,159.77999877929688,168.16000366210938,62.52986205188713,-37.470137948112864,2.897617310214912,3.065568211548119,0.018453406873357947,1253572400.0,-1.0
AAPL,2023-04-24,165.3300018310547,165.60000610351562,163.88999938964844,165.0,41949600.0,0.30999755859375,0.0,0.30999755859375,55.68271666161073,159.77999877929688,168.16000366210938,66.22911477224723,-33.77088522775277,2.7394336944495308,3.0003413081284016,0.028171633664949347,1295522000.0,1.0
AAPL,2023-04-25,163.77000427246094,166.30999755859375,163.72999572753906,165.19000244140625,48714100.0,-1.55999755859375,1.55999755859375,0.0,46.94861570473993,159.77999877929688,168.16000366210938,47.61340296289822,-52.38659703710178,2.4598377948658197,2.8922406054758856,0.022923160706017853,1246807900.0,-1.0
AAPL,2023-04-26,163.75999450683594,165.27999877929688,162.8000030517578,163.05999755859375,45498800.0,-0.010009765625,0.010009765625,0.0,46.89415736144838,159.77999877929688,168.16000366210938,47.49395475534968,-52.50604524465032,2.2119503390183013,2.756182552184369,-0.010872209943834865,1201309100.0,-1.0
AAPL,2023-04-27,168.41000366210938,168.55999755859375,165.19000244140625,165.19000244140625,64902300.0,4.6500091552734375,0.0,4.6500091552734375,67.25409482270226,159.77999877929688,168.55999755859375,98.29164103259264,-1.708358967407361,2.3634700103388298,2.6776400438152614,0.019369268314263666,1266211400.0,1.0
AAPL,2023-04-28,169.67999267578125,169.85000610351562,167.8800048828125,168.49000549316406,55209200.0,1.269989013671875,0.0,1.269989013671875,70.78389785928367,159.77999877929688,169.85000610351562,98.31168516307346,-1.6883148369265455,2.5565575372749834,2.653423542507206,0.026932137404277023,1321420600.0,1.0
AAPL,2023-05-01,169.58999633789062,170.4499969482422,168.63999938964844,169.27999877929688,52472900.0,-0.089996337890625,0.089996337890625,0.0,70.16546908845315,159.77999877929688,170.4499969482422,91.94001164072768,-8.059988359272326,2.6715231848459666,2.6570434709749584,0.018742086227602428,1268947700.0,-1.0
AAPL,2023-05-02,168.5399932861328,170.35000610351562,167.5399932861328,170.08999633789062,48425700.0,-1.0500030517578125,1.0500030517578125,0.0,62.7813378294116,161.4199981689453,170.4499969482422,78.84824008516534,-21.151759914834653,2.647390349784473,2.6551128467368614,0.005428553223251864,1220522000.0,-1.0
AAPL,2023-05-03,167.4499969482422,170.9199981689453,167.16000366210938,169.5,65136000.0,-1.089996337890625,1.089996337890625,0.0,55.75337405580491,162.8000030517578,170.9199981689453,57.26596912160436,-42.73403087839564,2.5113618925138326,2.626362655892256,0.004800498536200015,1155386000.0,-1.0
AAPL,2023-05-04,165.7899932861328,167.0399932861328,164.30999755859375,164.88999938964844,81235400.0,-1.660003662109375,1.660003662109375,0.0,46.58879820714971,162.8000030517578,170.9199981689453,36.822561974774125,-63.177438025225875,2.2437454370764556,2.549839212129096,0.004666034382113882,1074150600.0,-1.0
AAPL,2023-05-05,173.57000732421875,174.3000030517578,170.75999450683594,170.97999572753906,113316400.0,7.7800140380859375,0.0,7.7800140380859375,71.72387906476229,162.8000030517578,174.3000030517578,93.65221106487772,-6.347788935122282,2.6291325768850413,2.565697885080285,0.049839747183842986,1187467000.0,1.0
AAPL,2023-05-08,173.5,173.85000610351562,172.11000061035156,172.47999572753906,55962800.0,-0.07000732421875,0.07000732421875,0.0,71.3751357520351,162.8000030517578,174.3000030517578,93.04345172384511,-6.956548276154892,2.8955278135280764,2.631663870769844,0.0594125631904574,1131504200.0,-1.0
AAPL,2023-05-09,171.77000427246094,173.5399932861328,171.60000610351562,173.0500030517578,45326900.0,-1.7299957275390625,1.7299957275390625,0.0,62.68449655608849,162.8000030517578,174.3000030517578,78.00001061480978,-21.999989385190215,2.9332392051281033,2.691978937641496,0.04891310475276445,1086177300.0,-1.0
AAPL,2023-05-10,173.55999755859375,174.02999877929688,171.89999389648438,173.02000427246094,53724500.0,1.7899932861328125,0.0,1.7899932861328125,67.42041865552642,162.8000030517578,174.3000030517578,93.56516962466033,-6.434830375339675,3.072149427011965,2.7680130355155903,0.030580094914178124,1139901800.0,1.0
AAPL,2023-05-11,173.75,174.58999633789062,172.1699981689453,173.85000610351562,49514700.0,0.19000244140625,0.0,0.19000244140625,67.91909361479185,162.8000030517578,174.58999633789062,92.87534507013999,-7.1246549298600055,3.1611288619674838,2.8466362008059694,0.02398637140440929,1189416500.0,1.0
AAPL,2023-05-12,172.57000732421875,174.05999755859375,171.0,173.6199951171875,45497800.0,-1.17999267578125,1.17999267578125,0.0,61.205841296356226,162.8000030517578,174.58999633789062,82.8669197288878,-17.13308027111221,3.1006873640843367,2.897446433461643,0.017571855950693882,1143918700.0,-1.0
AAPL,2023-05-15,172.07000732421875,173.2100067138672,171.47000122070312,173.16000366210938,37266700.0,-0.5,0.5,0.0,58.38436597043927,162.8000030517578,174.58999633789062,78.62603521041999,-21.373964789580015,2.9781114057532534,2.9135794279199656,0.02094466701498554,1106652000.0,-1.0
AAPL,2023-05-17,172.69000244140625,172.92999267578125,170.4199981689453,171.7100067138672,57951600.0,0.6199951171875,0.0,0.6199951171875,61.327434953971164,164.30999755859375,174.58999633789062,81.51756690564189,-18.482433094358104,2.763307019003122,2.873054240748762,0.04161897240302603,1164603600.0,1.0
AAPL,2023-05-18,175.0500030517578,175.24000549316406,172.5800018310547,173.0,65496700.0,2.3600006103515625,0.0,2.3600006103515625,70.49270197246375,164.30999755859375,175.24000549316406,98.26164406701578,-1.7383559329842289,2.8536158550346045,2.8691665636059307,0.008526794175761632,1230100300.0,1.0
AAPL,2023-05-19,175.16000366210938,176.38999938964844,174.94000244140625,176.38999938964844,55772400.0,0.1100006103515625,0.0,0.1100006103515625,70.86406780803314,164.30999755859375,176.38999938964844,89.8179177061294,-10.182082293870591,2.900625779759281,2.875458406836601,0.009567744450198035,1285872700.0,1.0
AAPL,2023-05-22,174.1999969482422,174.7100067138672,173.4499969482422,173.97999572753906,43570900.0,-0.9600067138671875,0.9600067138671875,0.0,62.89323791972018,164.30999755859375,176.38999938964844,81.87084346480563,-18.129156535194365,2.8278196207620567,2.8659306496216925,0.014146781250158336,1242301800.0,-1.0
AAPL,2023-05-23,171.55999755859375,173.3800048828125,171.27999877929688,173.1300048828125,50747300.0,-2.6399993896484375,2.6399993896484375,0.0,46.35044500783436,164.30999755859375,176.38999938964844,60.016547194240054,-39.98345280575994,2.5279536517664667,2.7983352500506475,-0.0115233926488435,1191554500.0,-1.0
AAPL,2023-05-24,171.83999633789062,172.4199981689453,170.52000427246094,171.08999633789062,45143500.0,0.279998779296875,0.0,0.279998779296875,48.02350713902029,170.4199981689453,176.38999938964844,23.785559105431307,-76.2144408945687,2.28654342310395,2.695976884661308,-0.010992826832284197,1236698000.0,1.0
AAPL,2023-05-25,172.99000549316406,173.89999389648438,171.69000244140625,172.41000366210938,56058300.0,1.1500091552734375,0.0,1.1500091552734375,54.715944646388955,170.4199981689453,176.38999938964844,43.048690095846645,-56.951309904153355,2.163085502229478,2.5893986081749425,0.002433784267947825,1292756300.0,1.0
AAPL,2023-05-26,175.42999267578125,175.77000427246094,173.11000061035156,173.32000732421875,54835000.0,2.4399871826171875,0.0,2.4399871826171875,65.56917338024675,170.4199981689453,176.38999938964844,83.91948881789138,-16.080511182108626,2.2363515160866427,2.5187891897572827,0.0195268507499482,1347591300.0,1.0
AAPL,2023-05-30,177.3000030517578,178.99000549316406,176.57000732421875,176.9600067138672,55964400.0,1.8700103759765625,0.0,1.8700103759765625,71.59037903599142,170.4199981689453,178.99000549316406,80.28003503998974,-19.719964960010255,2.4174427932197773,2.4985199104497817,0.030394580722511222,1403555700.0,1.0
AAPL,2023-05-31,177.25,179.35000610351562,176.75999450683594,177.3300018310547,99625300.0,-0.0500030517578125,0.0500030517578125,0.0,71.20618190968521,170.4199981689453,179.35000610351562,76.48371514446283,-23.516284855537158,2.527785370397879,2.5043730024394013,0.026405683560870585,1303930400.0,-1.0
AAPL,2023-06-01,180.08999633789062,180.1199951171875,176.92999267578125,177.6999969482422,68901800.0,2.839996337890625,0.0,2.839996337890625,78.69802275526108,170.4199981689453,180.1199951171875,99.6907341367534,-0.3092658632465994,2.811981851034119,2.565894772158345,0.028791734922978707,1372832200.0,1.0
AAPL,2023-06-02,180.9499969482422,181.77999877929688,179.25999450683594,181.02999877929688,61945900.0,0.8600006103515625,0.0,0.8600006103515625,80.47322820753385,170.4199981689453,181.77999877929688,92.69364624594857,-7.306353754051437,3.071201571434898,2.666956132013656,0.0330554531004803,1434778100.0,1.0
AAPL,2023-06-05,179.5800018310547,184.9499969482422,178.0399932861328,182.6300048828125,121946500.0,-1.3699951171875,1.3699951171875,0.0,69.78386374951663,170.4199981689453,184.9499969482422,63.04201260609218,-36.95798739390783,3.1300071370851015,2.759566333027945,0.030884069902773925,1312831600.0,-1.0
AAPL,2023-06-06,179.2100067138672,180.1199951171875,177.42999267578125,179.97000122070312,64848400.0,-0.3699951171875,0.3699951171875,0.0,67.01012367662658,170.4199981689453,184.9499969482422,60.49559038811726,-39.50440961188274,3.110894996698306,2.8298320657620177,0.04459086770889398,1247983200.0,-1.0
AAPL,2023-06-07,177.82000732421875,181.2100067138672,177.32000732421875,178.44000244140625,61944600.0,-1.3899993896484375,1.3899993896484375,0.0,57.16139657107621,170.52000427246094,184.9499969482422,50.58909741520423,-49.41090258479577,2.9495861605064704,2.8537828847109084,0.034799878455360034,1186038600.0,-1.0
AAPL,2023-06-08,180.57000732421875,180.83999633789065,177.4600067138672,177.89999389648438,50214900.0,2.75,0.0,2.75,67.92341628822433,170.52000427246094,184.9499969482422,69.64662614573156,-30.353373854268444,3.008964295564084,2.884819166881544,0.04381757090211913,1236253500.0,1.0
AAPL,2023-06-09,180.9600067138672,182.22999572753903,180.6300048828125,181.5,48870700.0,0.3899993896484375,0.0,0.3899993896484375,69.1899871680535,170.52000427246094,184.9499969482422,72.3493259905,-27.650674009500005,3.052306497469317,2.918316632999099,0.03152262594176913,1285124200.0,1.0
AAPL,2023-06-12,183.7899932861328,183.88999938964844,180.97000122070312,181.2700042724609,54274900.0,2.829986572265625,0.0,2.829986572265625,76.84511402258552,170.52000427246094,184.9499969482422,91.96116250248497,-8.038837497515026,3.277233858031991,2.9901000780056775,0.036604569219778504,1339399100.0,1.0
AAPL,2023-06-13,183.30999755859372,184.1499938964844,182.44000244140625,182.8000030517578,54929100.0,-0.4799957275390909,0.4799957275390909,0.0,73.28177302470002,170.52000427246094,184.9499969482422,88.63478709590076,-11.365212904099241,3.3778213462129543,3.0676443316471333,0.03418898481576149,1284470000.0,-1.0
AAPL,2023-06-14,183.9499969482422,184.38999938964844,182.0200042724609,183.3699951171875,57462900.0,0.6399993896484659,0.0,0.6399993896484659,75.06091931885283,171.69000244140625,184.9499969482422,92.45851874610906,-7.541481253890936,3.469189599133358,3.147953385144379,0.021433731405654077,1341932900.0,1.0
AAPL,2023-06-15,186.00999450683597,186.5200042724609,183.77999877929688,183.9600067138672,65433200.0,2.0599975585937784,0.0,2.0599975585937784,80.0056840099942,173.11000061035156,186.5200042724609,96.19679622410543,-3.803203775894573,3.665569778042766,3.251476663724057,0.027963512815317282,1407366100.0,1.0
AAPL,2023-06-16,184.9199981689453,186.9900054931641,184.2700042724609,186.72999572753903,101235600.0,-1.0899963378906534,1.0899963378906534,0.0,71.3666223802265,176.57000732421875,186.9900054931641,80.13428322484731,-19.8657167751527,3.6907047427920077,3.339322279537647,0.029736030089332566,1306130500.0,-1.0
AAPL,2023-06-20,185.00999450683597,186.1000061035156,184.41000366210935,184.41000366210935,49799100.0,0.08999633789065342,0.0,0.08999633789065342,71.65817785671027,176.75999450683594,186.9900054931641,80.64507468296661,-19.354925317033388,3.675517260728782,3.406561275775874,0.03236419605870133,1355929600.0,1.0
AAPL,2023-06-21,183.9600067138672,185.41000366210935,182.58999633789065,184.8999938964844,49515700.0,-1.0499877929687784,1.0499877929687784,0.0,63.019786608481596,176.92999267578125,186.9900054931641,69.8807662147177,-30.11923378528231,3.537972289750371,3.432843478570774,0.034529294436780544,1306413900.0,-1.0
AAPL,2023-06-22,187.0,187.0500030517578,183.6699981689453,183.7400054931641,51245300.0,3.0399932861328125,0.0,3.0399932861328125,73.63678518452018,177.32000732421875,187.0500030517578,99.48609379533141,-0.5139062046685956,3.632396950245095,3.4727541729056384,0.03560941692955688,1357659200.0,1.0
AAPL,2023-06-23,186.67999267578125,187.55999755859372,185.00999450683597,185.5500030517578,53079300.0,-0.32000732421875,0.32000732421875,0.0,71.15550364808443,177.32000732421875,187.55999755859372,91.40619412059249,-8.593805879407514,3.639453898270574,3.506094117978625,0.03160911665392718,1304579900.0,-1.0
AAPL,2023-06-26,185.2700042724609,188.0500030517578,185.22999572753903,186.8300018310547,48088700.0,-1.409988403320341,1.409988403320341,0.0,60.74861037028578,177.32000732421875,188.0500030517578,74.0913337722782,-25.90866622772178,3.491029880666474,3.5030812705161947,0.008052728877485427,1256491200.0,-1.0
AAPL,2023-06-27,188.05999755859372,188.38999938964844,185.6699981689453,185.88999938964844,50730800.0,2.7899932861328125,0.0,2.7899932861328125,70.5745016567514,177.32000732421875,188.38999938964844,97.01895151230259,-2.981048487697419,3.557523007868525,3.513969617986661,0.025912389194602925,1307222000.0,1.0
AAPL,2023-06-28,189.25,189.8999938964844,187.6000061035156,187.92999267578125,51216800.0,1.1900024414062784,0.0,1.1900024414062784,73.80207694188414,177.4600067138672,189.8999938964844,94.77496329423344,-5.2250367057665486,3.6640061597445026,3.5439769263382295,0.028812194290218196,1358438800.0,1.0
AAPL,2023-06-29,189.58999633789065,190.07000732421875,188.94000244140625,189.0800018310547,46347300.0,0.3399963378906534,0.0,0.3399963378906534,74.71633109670827,180.6300048828125,190.07000732421875,94.91513917175863,-5.084860828241382,3.7328002896244357,3.581741598995471,0.019246287494100844,1404786100.0,1.0
AAPL,2023-06-30,193.97000122070312,194.47999572753903,191.25999450683597,191.6300048828125,85069600.0,4.380004882812472,0.0,4.380004882812472,83.35218888898076,180.97000122070312,194.47999572753903,96.22505762990609,-3.7749423700939144,4.093561888704841,3.6841056569373447,0.04894009918543052,1489855700.0,1.0
AAPL,2023-07-03,192.4600067138672,193.8800048828125,191.75999450683597,193.77999877929688,31458200.0,-1.5099945068359375,1.5099945068359375,0.0,73.38199545252328,182.0200042724609,194.47999572753903,83.78819904528433,-16.21180095471567,4.2091041850036675,3.7891053625506097,0.04026816079255635,1458397500.0,-1.0
AAPL,2023-07-05,191.3300018310547,192.97999572753903,190.6199951171875,191.57000732421875,46920300.0,-1.1300048828125,1.1300048828125,0.0,66.51224385092536,182.0200042724609,194.47999572753903,74.71913277115007,-25.280867228849925,4.16151893720712,3.863588077481912,0.04006302918139615,1411477200.0,-1.0
AAPL,2023-07-06,191.80999755859372,192.0200042724609,189.1999969482422,189.83999633789065,45094300.0,0.4799957275390341,0.0,0.4799957275390341,67.9813704265809,182.58999633789065,194.47999572753903,77.54416899911824,-22.455831000881755,4.115102588142207,3.9138909796139716,0.025721912078041198,1456571500.0,1.0
AAPL,2023-07-07,190.67999267578125,192.6699981689453,190.2400054931641,191.41000366210935,46778000.0,-1.1300048828124716,1.1300048828124716,0.0,60.742710276503956,182.58999633789065,194.47999572753903,68.0403427516899,-31.95965724831009,3.941697907047711,3.91945236510072,0.02142704176631849,1409793500.0,-1.0
AAPL,2023-07-10,188.6100006103516,189.9900054931641,187.0399932861328,189.25999450683597,59922200.0,-2.069992065429659,2.069992065429659,0.0,49.58332679631108,182.58999633789065,194.47999572753903,50.63082070216124,-49.36917929783876,3.5957923322294505,3.8547203585264667,0.018027723111501803,1349871300.0,-1.0
AAPL,2023-07-11,188.0800018310547,189.3000030517578,186.6000061035156,189.16000366210935,46638100.0,-0.5299987792969034,0.5299987792969034,0.0,47.03073205477271,182.58999633789065,194.47999572753903,46.173303406085275,-53.826696593914725,3.241526895693113,3.7320816659597966,0.00010637175752781225,1303233200.0,-1.0
AAPL,2023-07-12,189.7700042724609,191.6999969482422,188.47000122070312,189.67999267578125,60750200.0,1.6900024414062216,0.0,1.6900024414062216,55.46599019504655,183.6699981689453,194.47999572753903,56.429301398557854,-43.570698601442146,3.061843037371517,3.5980339402421406,0.0027477108188158628,1363983400.0,1.0
AAPL,2023-07-13,190.5399932861328,191.19000244140625,189.77999877929688,190.5,41342300.0,0.7699890136719034,0.0,0.7699890136719034,58.906279555312935,185.00999450683597,194.47999572753903,58.39491094475583,-41.60508905524417,2.9475959125706197,3.4679463347078365,0.00501079680675276,1405325700.0,1.0
AAPL,2023-07-14,190.69000244140625,191.17999267578125,189.6300048828125,190.22999572753903,41573900.0,0.1500091552734375,0.0,0.1500091552734375,59.60770710958334,185.22999572753903,194.47999572753903,59.02709960937531,-40.972900390624694,2.8364617626479003,3.3416494202958495,-0.016909825017554225,1446899600.0,1.0
AAPL,2023-07-17,193.9900054931641,194.32000732421875,191.80999755859372,191.8999938964844,50520200.0,3.300003051757841,0.0,3.300003051757841,71.8179523708478,185.6699981689453,194.47999572753903,94.43824778479102,-5.561752215208977,2.9803146035877432,3.2693824569542285,0.007949697214609142,1497419800.0,1.0
AAPL,2023-07-18,193.72999572753903,194.3300018310547,192.4199981689453,193.3500061035156,48353800.0,-0.26000976562505684,0.26000976562505684,0.0,69.89703854972605,186.6000061035156,194.47999572753903,90.48222097001877,-9.517779029981236,3.0383146018971843,3.2231688859428202,0.012543740519082691,1449066000.0,-1.0
AAPL,2023-07-19,195.1000061035156,198.22999572753903,192.6499938964844,193.1000061035156,80507300.0,1.3700103759765625,0.0,1.3700103759765625,74.10751046946565,186.6000061035156,198.22999572753903,73.08690957420987,-26.91309042579013,3.1584201051873038,3.210219129791717,0.017152435153526602,1529573300.0,1.0
AAPL,2023-07-20,193.1300048828125,196.47000122070312,192.5,195.08999633789065,59581200.0,-1.9700012207030966,1.9700012207030966,0.0,60.14896260915579,186.6000061035156,198.22999572753903,56.14793297672631,-43.8520670232737,3.059375372436193,3.1800503783206127,0.012848816347486913,1469992100.0,-1.0
AAPL,2023-07-21,191.94000244140625,194.97000122070312,191.22999572753903,194.1000061035156,71917800.0,-1.19000244140625,1.19000244140625,0.0,53.16881991348275,186.6000061035156,198.22999572753903,45.91574464400306,-54.08425535599694,2.851982576551052,3.114436817966701,0.017655489212017317,1398074300.0,-1.0
AAPL,2023-07-24,192.75,194.91000366210935,192.25,193.41000366210935,45377800.0,0.80999755859375,0.0,0.80999755859375,57.080592854049165,186.6000061035156,198.22999572753903,52.88047621109391,-47.11952378890609,2.7216093072234457,3.03587131581805,0.024829849656957226,1443452100.0,1.0
AAPL,2023-07-25,193.6199951171875,194.44000244140625,192.9199981689453,193.3300018310547,37283200.0,0.8699951171875,0.0,0.8699951171875,61.10677572259453,186.6000061035156,198.22999572753903,60.3610943828453,-39.63890561715469,2.6578508371016767,2.9602672200747757,0.020287668008896587,1480735300.0,1.0
AAPL,2023-07-26,194.5,195.63999938964844,193.32000732421875,193.6699981689453,47471900.0,0.8800048828125,0.0,0.8800048828125,64.94480547542827,186.6000061035156,198.22999572753903,67.92778112343123,-32.07221887656877,2.6478085410528536,2.8977754842703916,0.020783073650687545,1528207200.0,1.0
AAPL,2023-07-27,193.22000122070312,197.1999969482422,192.5500030517578,196.0200042724609,47460200.0,-1.279998779296875,1.279998779296875,0.0,55.717071766569795,186.6000061035156,198.22999572753903,56.92176288371714,-43.07823711628285,2.507658024249565,2.8197519922662266,0.013267600539646818,1480747000.0,-1.0
AAPL,2023-07-28,195.8300018310547,196.6300048828125,194.13999938964844,194.6699981689453,48291400.0,2.6100006103515625,0.0,2.6100006103515625,66.8117353461478,186.6000061035156,198.22999572753903,79.36374860105799,-20.636251398942004,2.577481365765067,2.771297866965995,0.009485005854878548,1529038400.0,1.0
AAPL,2023-07-31,196.4499969482422,196.4900054931641,195.25999450683597,196.05999755859372,38824100.0,0.6199951171875,0.0,0.6199951171875,68.94435738958504,188.47000122070312,198.22999572753903,81.76229732455143,-18.237702675448574,2.6522715558931225,2.7474926047514208,0.014040165594844334,1567862500.0,1.0
AAPL,2023-08-01,195.6100006103516,196.72999572753903,195.27999877929688,196.2400054931641,35175100.0,-0.8399963378905966,0.8399963378905966,0.0,62.650842091190555,189.6300048828125,198.22999572753903,69.53490806569859,-30.465091934301412,2.613634286949292,2.7207209411909954,0.0026140158425489446,1532687400.0,-1.0
AAPL,2023-08-02,192.5800018310547,195.17999267578125,191.8500061035156,195.0399932861328,50389300.0,-3.0299987792969034,3.0299987792969034,0.0,45.40135038406135,189.6300048828125,198.22999572753903,34.30232661295342,-65.69767338704658,2.311868611941719,2.6389504753411406,-0.0028478384396641854,1482298100.0,-1.0
AAPL,2023-08-03,191.1699981689453,192.3699951171875,190.69000244140625,191.57000732421875,61235200.0,-1.410003662109375,1.410003662109375,0.0,39.55392523111454,190.69000244140625,198.22999572753903,6.365996749915534,-93.63400325008446,1.9366175076285685,2.4984838817986263,-0.004011692521969201,1421062900.0,-1.0
AAPL,2023-08-04,181.9900054931641,187.3800048828125,181.9199981689453,185.5200042724609,115799700.0,-9.179992675781222,9.179992675781222,0.0,20.1033070663984,181.9199981689453,198.22999572753903,0.42922951991425423,-99.57077048008574,0.8882405314504638,2.176435211728994,-0.05582357720796838,1305263200.0,-1.0
AAPL,2023-08-07,178.85000610351562,183.1300048828125,177.35000610351562,182.1300048828125,97576100.0,-3.139999389648466,3.139999389648466,0.0,16.835824080457627,177.35000610351562,198.22999572753903,7.183911615905113,-92.81608838409488,-0.19374412235274008,1.702399344912647,-0.0762833869752575,1207687100.0,-1.0
AAPL,2023-08-08,179.8000030517578,180.2700042724609,177.5800018310547,179.69000244140625,67823000.0,0.9499969482421875,0.0,0.9499969482421875,21.301165615532,177.35000610351562,197.1999969482422,12.342559588097062,-87.65744041190294,-0.9634617541353521,1.169227125103047,-0.0755783904793943,1275510100.0,1.0
AAPL,2023-08-09,178.19000244140625,180.92999267578125,177.00999450683594,180.8699951171875,60378500.0,-1.6100006103515625,1.6100006103515625,0.0,19.27715380183548,177.00999450683594,197.1999969482422,5.844516056869402,-94.1554839431306,-1.68397035474365,0.5985876291337076,-0.07778697176452787,1215131600.0,-1.0
AAPL,2023-08-10,177.97000122070312,180.75,177.60000610351562,179.47999572753906,54686900.0,-0.220001220703125,0.220001220703125,0.0,18.99261506647919,177.00999450683594,197.1999969482422,4.754861801791453,-95.24513819820855,-2.246830804680968,0.02950394237077224,-0.09120155463083557,1160444700.0,-1.0
AAPL,2023-08-11,177.7899932861328,178.6199951171875,176.5500030517578,177.32000732421875,51988100.0,-0.1800079345703125,0.1800079345703125,0.0,18.731586812167706,176.5500030517578,197.1999969482422,6.00479709868634,-93.99520290131366,-2.6765730345442194,-0.5117114530122262,-0.0949860216441013,1108456600.0,-1.0
AAPL,2023-08-14,179.4600067138672,179.69000244140625,177.30999755859375,177.97000122070312,43675600.0,1.670013427734375,0.0,1.670013427734375,29.154544414945207,176.5500030517578,197.1999969482422,14.092031584594308,-85.90796841540569,-2.8495429635974006,-0.9792777551292613,-0.0825622097341262,1152132200.0,1.0
AAPL,2023-08-15,177.4499969482422,179.47999572753906,177.0500030517578,178.8800048828125,43622600.0,-2.010009765625,2.010009765625,0.0,24.74681768680732,176.5500030517578,197.1999969482422,4.358325242108655,-95.64167475789135,-3.1129299495596,-1.4060081940153293,-0.0785647769184552,1108509600.0,-1.0
AAPL,2023-08-16,176.57000732421875,178.5399932861328,176.5,177.1300048828125,46964900.0,-0.8799896240234375,0.8799896240234375,0.0,22.990946909006354,176.5,196.72999572753903,0.34605703907020224,-99.6539429609298,-3.354010892049672,-1.7956087336221982,-0.07637176850220984,1061544700.0,-1.0
AAPL,2023-08-17,174.0,177.50999450683594,173.47999572753906,177.13999938964844,66062900.0,-2.57000732421875,2.57000732421875,0.0,18.554566977955204,173.47999572753906,196.72999572753903,2.236577515961024,-97.76342248403897,-3.709684455282428,-2.1784238779542444,-0.04390354004063268,995481800.0,-1.0
AAPL,2023-08-18,174.49000549316406,175.10000610351562,171.9600067138672,172.3000030517578,61114200.0,0.4900054931640625,0.0,0.4900054931640625,21.871200742009137,171.9600067138672,196.72999572753903,10.213968112381629,-89.78603188761836,-3.9069817152803807,-2.5241354454194718,-0.024377972946939996,1056596000.0,1.0
AAPL,2023-08-21,175.83999633789062,176.1300048828125,173.74000549316406,175.07000732421875,46311900.0,1.3499908447265625,0.0,1.3499908447265625,30.825919624071616,171.9600067138672,195.17999267578125,16.709698405449007,-83.290301594551,-3.9093437551264856,-2.801177107360875,-0.022024508602078496,1102907900.0,1.0
AAPL,2023-08-22,177.22999572753906,177.67999267578125,176.25,177.05999755859375,42084200.0,1.3899993896484375,0.0,1.3899993896484375,39.116284541715785,171.9600067138672,192.3699951171875,25.82063698191298,-74.17936301808702,-3.7557602879669503,-2.9920937434820902,-0.005387545320803655,1144992100.0,1.0
AAPL,2023-08-23,181.1199951171875,181.5500030517578,178.3300018310547,178.52000427246094,52722800.0,3.8899993896484375,0.0,3.8899993896484375,56.10408609156033,171.9600067138672,187.3800048828125,59.403304092265216,-40.596695907734784,-3.282317332038474,-3.0501384611933675,0.017699577877611006,1197714900.0,1.0
AAPL,2023-08-24,176.3800048828125,181.1000061035156,176.00999450683594,180.6699981689453,54945800.0,-4.739990234375,4.739990234375,0.0,40.296143860494645,171.9600067138672,183.1300048828125,39.570267623084625,-60.42973237691538,-3.2520997945855186,-3.090530727871798,-0.007930639836692621,1142769100.0,-1.0
AAPL,2023-08-25,178.61000061035156,179.14999389648438,175.82000732421875,177.3800048828125,51449600.0,2.2299957275390625,0.0,2.2299957275390625,48.21653209772321,171.9600067138672,181.5500030517578,69.34302852869575,-30.65697147130424,-3.013472722366174,-3.075119126770674,-0.004736465350025809,1194218700.0,1.0
AAPL,2023-08-28,180.19000244140625,180.58999633789065,178.5500030517578,180.08999633789062,43820700.0,1.5800018310546875,0.0,1.5800018310546875,53.28316002366112,171.9600067138672,181.5500030517578,85.8185492211491,-14.181450778850897,-2.6661325884080043,-2.9933218190981403,0.015441000508798375,1238039400.0,1.0
AAPL,2023-08-29,184.1199951171875,184.8999938964844,179.5,179.6999969482422,53003900.0,3.92999267578125,0.0,3.92999267578125,63.52550181120248,171.9600067138672,184.8999938964844,93.97218275189093,-6.02781724810907,-2.0501130382256747,-2.8046800629236475,0.04275917471705948,1291043300.0,1.0
AAPL,2023-08-30,187.6499938964844,187.8500061035156,184.7400054931641,184.94000244140625,60813900.0,3.5299987792969034,0.0,3.5299987792969034,70.27888794396797,171.9600067138672,187.8500061035156,98.74126988852188,-1.2587301114781146,-1.262518182746021,-2.4962476868881223,0.07844824078439316,1351857200.0,1.0
AAPL,2023-08-31,187.8699951171875,189.1199951171875,187.47999572753903,187.83999633789065,60794500.0,0.22000122070309658,0.0,0.22000122070309658,70.66941526245338,171.9600067138672,189.1199951171875,92.71561279284934,-7.28438720715065,-0.6135190597614439,-2.1197019614627868,0.07668055019086828,1412651700.0,1.0
AAPL,2023-09-01,189.4600067138672,189.9199981689453,188.27999877929688,189.4900054931641,45732600.0,1.5900115966796875,0.0,1.5900115966796875,73.56591656871903,171.9600067138672,189.9199981689453,97.43879914292462,-2.561200857075375,0.028786238719561652,-1.690004321426317,0.07745683951110083,1458384300.0,1.0
AAPL,2023-09-05,189.6999969482422,189.97999572753903,187.6100006103516,188.27999877929688,45280000.0,0.239990234375,0.0,0.239990234375,74.0128601209164,171.9600067138672,189.97999572753903,98.44617674803014,-1.5538232519698556,0.550833357494156,-1.2418367856422223,0.07036055702373112,1503664300.0,1.0
AAPL,2023-09-06,182.91000366210935,188.8500061035156,181.47000122070312,188.3999938964844,81755800.0,-6.789993286132841,6.789993286132841,0.0,47.68975207576755,171.9600067138672,189.97999572753903,60.76583587223248,-39.23416412776752,0.411915443594836,-0.9110863397948107,0.009882997974705487,1421908500.0,-1.0
AAPL,2023-09-07,177.55999755859375,178.2100067138672,173.5399932861328,175.17999267578125,112488800.0,-5.350006103515597,5.350006103515597,0.0,36.03734585712185,171.9600067138672,189.97999572753903,31.076549716416718,-68.92345028358328,-0.12839868459644777,-0.7545488087551381,0.006690059208044774,1309419700.0,-1.0
AAPL,2023-09-08,178.17999267578125,180.2400054931641,177.7899932861328,178.35000610351562,65551300.0,0.6199951171875,0.0,0.6199951171875,38.06100157514054,173.5399932861328,189.97999572753903,28.223836378284307,-71.7761636217157,-0.5008001866846428,-0.7037990843410391,-0.0024075244000945073,1374971000.0,1.0
AAPL,2023-09-11,179.36000061035156,180.3000030517578,177.33999633789062,180.07000732421875,58953100.0,1.1800079345703125,0.0,1.1800079345703125,42.08489582676774,173.5399932861328,189.97999572753903,35.40149914795832,-64.59850085204168,-0.6927289335779392,-0.7015850541884192,-0.0046062590588209495,1433924100.0,1.0
AAPL,2023-09-12,176.3000030517578,180.1300048828125,174.82000732421875,179.49000549316406,90370200.0,-3.05999755859375,3.05999755859375,0.0,35.2355711264822,173.5399932861328,189.97999572753903,16.788378076353364,-83.21162192364665,-1.0793084814468443,-0.7771297396401043,-0.04247225870526705,1343553900.0,-1.0
AAPL,2023-09-13,174.2100067138672,177.3000030517578,173.97999572753906,176.50999450683594,84267900.0,-2.089996337890625,2.089996337890625,0.0,31.22998866404383,173.5399932861328,189.97999572753903,4.075506862741466,-95.92449313725854,-1.5366077384243226,-0.9290253393969482,-0.07162263586340045,1259286000.0,-1.0
AAPL,2023-09-14,175.74000549316406,176.10000610351562,173.5800018310547,174.0,60895800.0,1.529998779296875,0.0,1.529998779296875,37.25498839100487,173.5399932861328,189.97999572753903,13.382067398543942,-86.61793260145606,-1.7553282480960775,-1.0942859211367741,-0.064565869693333,1320181800.0,1.0
AAPL,2023-09-15,175.00999450683594,176.5,173.82000732421875,176.47999572753906,109205100.0,-0.730010986328125,0.730010986328125,0.0,35.540751787179445,173.5399932861328,189.97999572753903,8.941611936752158,-91.05838806324785,-1.9649212246902152,-1.2684129818474625,-0.07626945896214632,1210976700.0,-1.0
AAPL,2023-09-18,177.97000122070312,179.3800048828125,176.1699981689453,176.47999572753906,67257600.0,2.9600067138671875,0.0,2.9600067138671875,46.95921120476728,173.5399932861328,189.97999572753903,26.946516281608197,-73.0534837183918,-1.870614089865029,-1.388853203450976,-0.06183445396016263,1278234300.0,1.0
AAPL,2023-09-19,179.07000732421875,179.6300048828125,177.1300048828125,177.52000427246094,51826900.0,1.100006103515625,0.0,1.100006103515625,50.70365489140105,173.5399932861328,189.97999572753903,33.637549980880166,-66.36245001911983,-1.6876594193954304,-1.448614446639867,-0.02099391099999237,1330061200.0,1.0
AAPL,2023-09-20,175.49000549316406,179.6999969482422,175.39999389648438,179.25999450683594,58436200.0,-3.5800018310546875,3.5800018310546875,0.0,40.07870151942707,173.5399932861328,189.97999572753903,11.861386359164388,-88.13861364083562,-1.8106704712837143,-1.5210256515686367,-0.011657986561678157,1271625000.0,-1.0
AAPL,2023-09-21,173.92999267578125,176.3000030517578,173.86000061035156,174.5500030517578,63047900.0,-1.5600128173828125,1.5600128173828125,0.0,36.258466958044075,173.5399932861328,189.97999572753903,2.3722587088319087,-97.62774129116809,-2.01085769712671,-1.6189920606802515,-0.02385228518744731,1208577100.0,-1.0
AAPL,2023-09-22,174.7899932861328,177.0800018310547,174.0500030517578,174.6699981689453,56725400.0,0.8600006103515625,0.0,0.8600006103515625,39.9022546563428,173.5399932861328,189.97999572753903,7.603405196897764,-92.39659480310223,-2.07617974621067,-1.7104295977863355,-0.025479523353408084,1265302500.0,1.0
AAPL,2023-09-25,176.0800018310547,176.97000122070312,174.14999389648438,174.1999969482422,46172700.0,1.290008544921875,0.0,1.290008544921875,45.31299206934158,173.5399932861328,188.8500061035156,16.59050567245759,-83.4094943275424,-2.000791157194783,-1.768501909668025,-0.0012478798462558505,1311475200.0,1.0
AAPL,2023-09-26,171.9600067138672,175.1999969482422,171.66000366210938,174.82000732421875,64588900.0,-4.1199951171875,4.1199951171875,0.0,34.024380565596886,171.66000366210938,180.3000030517578,3.4722577887823167,-96.52774221121769,-2.2475855636708104,-1.864318640468582,-0.012915446376714379,1246886300.0,-1.0
AAPL,2023-09-27,170.42999267578125,173.0399932861328,169.0500030517578,172.6199951171875,66921800.0,-1.5300140380859375,1.5300140380859375,0.0,30.74263097359166,169.0500030517578,180.3000030517578,12.26657443576389,-87.73342556423611,-2.5373818958435663,-1.9989312915435788,-0.03021516246390099,1179964500.0,-1.0
AAPL,2023-09-28,170.69000244140625,172.02999877929688,167.6199951171875,169.33999633789062,56294400.0,0.260009765625,0.0,0.260009765625,32.02817308127901,167.6199951171875,180.3000030517578,24.21139907845636,-75.78860092154363,-2.7147727514750386,-2.142099583529871,-0.024684259191042668,1236258900.0,1.0
AAPL,2023-09-29,171.2100067138672,173.07000732421875,170.33999633789062,172.02000427246094,51814200.0,0.5200042724609375,0.0,0.5200042724609375,34.82006991499165,167.6199951171875,180.1300048828125,28.697112663687278,-71.30288733631272,-2.781334787554414,-2.26994662433478,-0.037983898749614387,1288073100.0,1.0
AAPL,2023-10-02,173.75,174.3000030517578,170.92999267578125,171.22000122070312,52164500.0,2.5399932861328125,0.0,2.5399932861328125,47.07257181149591,167.6199951171875,179.6999969482422,50.7450658414122,-49.2549341585878,-2.5991678609443625,-2.3357908716566964,-0.029709092012189964,1340237600.0,1.0
AAPL,2023-10-03,172.39999389648438,173.6300048828125,170.82000732421875,172.25999450683594,49594600.0,-1.350006103515625,1.350006103515625,0.0,42.20687387073889,167.6199951171875,179.6999969482422,39.56952032083873,-60.43047967916127,-2.5345171334141696,-2.375536124008191,-0.017607906433167564,1290643000.0,-1.0
AAPL,2023-10-04,173.66000366210938,174.2100067138672,170.97000122070312,171.08999633789062,53020300.0,1.260009765625,0.0,1.260009765625,47.9958445721002,167.6199951171875,179.6999969482422,50.000063157229924,-49.999936842770076,-2.3544678683373093,-2.3713224728740148,-0.0015522855461458374,1343663300.0,1.0
AAPL,2023-10-05,174.91000366210938,175.4499969482422,172.67999267578125,173.7899932861328,48527900.0,1.25,0.0,1.25,53.34524476147232,167.6199951171875,179.6999969482422,60.347743707960966,-39.65225629203903,-2.0868569869427915,-2.3144293756877703,0.0006865975203746988,1392191200.0,1.0
AAPL,2023-10-06,177.49000549316406,177.99000549316406,173.17999267578125,173.8000030517578,57224100.0,2.5800018310546875,0.0,2.5800018310546875,62.52560255351025,167.6199951171875,179.6999969482422,81.70537152240502,-18.294628477594973,-1.6475963840915426,-2.181062777368525,0.008007744476639989,1449415300.0,1.0
AAPL,2023-10-09,178.99000549316406,179.0500030517578,175.8000030517578,176.80999755859375,42390800.0,1.5,0.0,1.5,66.89548783716945,167.6199951171875,179.6999969482422,94.12258818328229,-5.877411816717719,-1.165012192295336,-1.977852660353887,0.04088159167726979,1491806100.0,1.0
AAPL,2023-10-10,178.38999938964844,179.72000122070312,177.9499969482422,178.10000610351562,43698000.0,-0.600006103515625,0.600006103515625,0.0,63.479015741781524,167.6199951171875,179.72000122070312,89.00825487461317,-10.991745125386828,-0.8215064070683127,-1.7465834096967725,0.046705433644006256,1448108100.0,-1.0
AAPL,2023-10-11,179.8000030517578,179.85000610351562,177.60000610351562,178.1999969482422,47551100.0,1.410003662109375,0.0,1.410003662109375,67.92133545880989,167.6199951171875,179.85000610351562,99.59114467015843,-0.40885532984157325,-0.43053712186952,-1.483374152131322,0.05337161216269126,1495659200.0,1.0
AAPL,2023-10-12,180.7100067138672,182.33999633789065,179.0399932861328,180.07000732421875,56743100.0,0.910003662109375,0.0,0.910003662109375,70.58571697108852,167.6199951171875,182.33999633789065,88.92670184204235,-11.07329815795765,-0.04672286415950566,-1.1960438945369587,0.055487410942496984,1552402300.0,1.0
AAPL,2023-10-13,178.85000610351562,181.92999267578125,178.13999938964844,181.4199981689453,51427100.0,-1.8600006103515625,1.8600006103515625,0.0,59.02390451861814,167.6199951171875,182.33999633789065,76.29082917828511,-23.709170821714896,0.10614264933633422,-0.9356065857623,0.02935255311375906,1500975200.0,-1.0
AAPL,2023-10-16,178.72000122070312,179.0800018310547,176.50999450683594,176.75,52517000.0,-0.1300048828125,0.1300048828125,0.0,58.25436304248568,167.6199951171875,182.33999633789065,75.40764390633245,-24.59235609366754,0.21432871456497082,-0.7056195256968458,0.03665897649633054,1448458200.0,-1.0
AAPL,2023-10-17,177.14999389648438,178.4199981689453,174.8000030517578,176.64999389648438,57549400.0,-1.57000732421875,1.57000732421875,0.0,49.29814609019853,167.6199951171875,182.33999633789065,64.74183416434283,-35.258165835657174,0.17140463479717027,-0.5302146935980426,0.02009668409984311,1390908800.0,-1.0
AAPL,2023-10-18,175.83999633789062,177.5800018310547,175.11000061035156,175.5800018310547,54764400.0,-1.30999755859375,1.30999755859375,0.0,42.941983950882744,170.33999633789062,182.33999633789065,45.83333333333323,-54.16666666666677,0.03132009885422349,-0.4179077351075894,0.00531697819627186,1336144400.0,-1.0
AAPL,2023-10-19,175.4600067138672,177.83999633789062,175.19000244140625,176.0399932861328,59302900.0,-0.3799896240234375,0.3799896240234375,0.0,41.16555629123854,170.82000732421875,182.33999633789065,40.2778108915008,-59.7221891084992,-0.10910222950010962,-0.3561466339860934,-0.011437256839653798,1276841500.0,-1.0
AAPL,2023-10-20,172.8800048828125,175.4199981689453,172.63999938964844,175.30999755859375,64189300.0,-2.5800018310546875,2.5800018310546875,0.0,31.08976709015306,170.82000732421875,182.33999633789065,17.881940305229012,-82.11805969477099,-0.42368850485331677,-0.3696550081595381,-0.03413598761292236,1212652200.0,-1.0
AAPL,2023-10-23,173.0,174.00999450683594,169.92999267578125,170.91000366210938,55980100.0,0.1199951171875,0.0,0.1199951171875,31.98318132128695,169.92999267578125,182.33999633789065,24.738166142466085,-75.26183385753392,-0.65575861431617,-0.42687572939086454,-0.03021469481523642,1268632300.0,1.0
AAPL,2023-10-24,173.44000244140625,173.6699981689453,171.4499969482422,173.0500030517578,43816600.0,0.44000244140625,0.0,0.44000244140625,35.52016058922031,169.92999267578125,182.33999633789065,28.283712569254654,-71.71628743074535,-0.7950069826513584,-0.5005019800429633,-0.03537263905674548,1312448900.0,1.0
AAPL,2023-10-25,171.10000610351562,173.05999755859375,170.64999389648438,171.8800048828125,57157000.0,-2.339996337890625,2.339996337890625,0.0,26.927611374387226,169.92999267578125,182.33999633789065,9.427986160122542,-90.57201383987746,-1.0817111730288502,-0.6167438186401407,-0.05317912817948067,1255291900.0,-1.0
AAPL,2023-10-26,166.88999938964844,171.3800048828125,165.6699981689453,170.3699951171875,70625300.0,-4.2100067138671875,4.2100067138671875,0.0,17.925644583705704,165.6699981689453,182.33999633789065,7.318544419374167,-92.68145558062584,-1.6298507617752307,-0.8193652072671589,-0.06687171543592185,1184666600.0,-1.0
AAPL,2023-10-27,168.22000122070312,168.9600067138672,166.8300018310547,166.91000366210938,58499100.0,1.3300018310546875,0.0,1.3300018310546875,26.840744411348837,165.6699981689453,182.33999633789065,15.296960599001332,-84.70303940099868,-1.9346340455034863,-1.0424189749144246,-0.05875111866764959,1243165700.0,1.0
AAPL,2023-10-30,170.2899932861328,171.1699981689453,168.8699951171875,169.02000427246094,51131000.0,2.0699920654296875,0.0,2.0699920654296875,38.78228119566547,165.6699981689453,182.33999633789065,27.714430861750916,-72.28556913824909,-1.986249683712117,-1.2311851166739631,-0.038724249769718444,1294296700.0,1.0
AAPL,2023-10-31,170.77000427246094,170.89999389648438,167.89999389648438,169.35000610351562,44846000.0,0.480010986328125,0.0,0.480010986328125,41.34401318837944,165.6699981689453,182.33999633789065,30.593921198002665,-69.40607880199732,-1.9657624875734996,-1.3781005908538706,-0.028832985503976505,1339142700.0,1.0
AAPL,2023-11-01,173.97000122070312,174.22999572753906,170.1199951171875,171.0,56934900.0,3.1999969482421875,0.0,3.1999969482421875,55.627064685312384,165.6699981689453,181.92999267578125,51.04554646847126,-48.95445353152874,-1.6720390019917204,-1.4368882730814407,-0.00849199496266917,1396077600.0,1.0
AAPL,2023-11-02,177.57000732421875,177.77999877929688,175.4600067138672,175.52000427246094,77334800.0,3.600006103515625,0.0,3.600006103515625,66.28426013055359,165.6699981689453,179.0800018310547,88.73979049608688,-11.26020950391312,-1.1356792144094072,-1.3766464613470342,0.027128657501978903,1473412400.0,1.0
AAPL,2023-11-03,176.64999389648438,176.82000732421875,173.35000610351562,174.24000549316406,79763700.0,-0.920013427734375,0.920013427734375,0.0,61.900396478154725,165.6699981689453,178.4199981689453,86.11761354932598,-13.88238645067402,-0.7759034808874503,-1.2564978652551175,0.021098230615516522,1393648700.0,-1.0
AAPL,2023-11-06,179.22999572753906,179.42999267578125,176.2100067138672,176.3800048828125,63841300.0,2.5800018310546875,0.0,2.5800018310546875,68.61655572324071,165.6699981689453,179.42999267578125,98.54653322613734,-1.4534667738626597,-0.2793735894013878,-1.0610730100843715,0.03338326340308284,1457490000.0,1.0
AAPL,2023-11-07,181.82000732421875,182.44000244140625,178.97000122070312,179.17999267578125,70530000.0,2.5900115966796875,0.0,2.5900115966796875,73.93808498129367,165.6699981689453,182.44000244140625,96.30295194256074,-3.697048057439272,0.3194399126593339,-0.7849704255356303,0.06265342395264151,1528020000.0,1.0
AAPL,2023-11-08,182.88999938964844,183.4499969482422,181.58999633789065,182.3500061035156,49340300.0,1.0699920654296875,0.0,1.0699920654296875,75.88708697888369,165.6699981689453,183.4499969482422,96.85040721574282,-3.149592784257185,0.870310941856161,-0.4539141520572721,0.09587153249754543,1577360300.0,1.0
AAPL,2023-11-09,182.41000366210935,184.1199951171875,181.80999755859372,182.9600067138672,53763500.0,-0.4799957275390909,0.4799957275390909,0.0,73.05905239480404,165.6699981689453,184.1199951171875,90.7317520979803,-9.26824790201969,1.2536967221712985,-0.11239197721155789,0.08435383627651416,1523596800.0,-1.0
AAPL,2023-11-10,186.3999938964844,186.57000732421875,183.52999877929688,183.97000122070312,66133400.0,3.989990234375057,0.0,3.989990234375057,80.15307334202308,165.6699981689453,186.57000732421875,99.18653897961835,-0.8134610203816548,1.8580728739105723,0.2817009930128683,0.09460333105587981,1589730200.0,1.0
AAPL,2023-11-13,184.8000030517578,186.02999877929688,184.2100067138672,185.82000732421875,43627500.0,-1.599990844726591,1.599990844726591,0.0,71.44816415016541,165.6699981689453,186.57000732421875,91.53108374589236,-8.468916254107642,2.182777735962759,0.6619163416028466,0.08215727837607956,1546102700.0,-1.0
AAPL,2023-11-14,187.44000244140625,188.1100006103516,186.3000030517578,187.6999969482422,60108400.0,2.6399993896484375,0.0,2.6399993896484375,76.34019756785756,165.6699981689453,188.1100006103516,97.0142687341733,-2.985731265826695,2.6228994141127657,1.0541129561048306,0.0774271490842533,1606211100.0,1.0
AAPL,2023-11-15,188.00999450683597,189.5,187.77999877929688,187.8500061035156,53790500.0,0.5699920654297159,0.0,0.5699920654297159,77.30875759730708,166.8300018310547,189.5,93.42741237974545,-6.572587620254556,2.98330295162512,1.4399509552088887,0.05879364054738834,1660001600.0,1.0
AAPL,2023-11-16,189.7100067138672,190.9600067138672,188.6499938964844,189.57000732421875,54412900.0,1.7000122070312216,0.0,1.7000122070312216,80.11073879497094,167.89999389648438,190.9600067138672,94.57936120895067,-5.4206387910493286,3.3672861505033893,1.8254179942677893,0.07393157808449113,1714414500.0,1.0
AAPL,2023-11-17,189.69000244140625,190.3800048828125,188.57000732421875,190.25,50922700.0,-0.0200042724609375,0.0200042724609375,0.0,79.9766511434542,167.89999389648438,190.9600067138672,94.4926124607199,-5.507387539280111,3.628158274322743,2.1859660502787803,0.05836080434755031,1663491800.0,-1.0
AAPL,2023-11-20,191.4499969482422,191.91000366210935,189.8800048828125,189.88999938964844,46505100.0,1.7599945068359375,0.0,1.7599945068359375,82.8847991494281,170.1199951171875,191.91000366210935,97.88890989685103,-2.1110901031489657,3.931597155076105,2.5350922712382453,0.05296441115444117,1709996900.0,1.0
AAPL,2023-11-21,190.63999938964844,191.5200042724609,189.7400054931641,191.41000366210935,38134500.0,-0.80999755859375,0.80999755859375,0.0,76.94996581743406,173.35000610351562,191.91000366210935,93.15730366638509,-6.842696333614909,4.059914454068291,2.840056707804255,0.04237519834798942,1671862400.0,-1.0
AAPL,2023-11-22,191.30999755859372,192.92999267578125,190.8300018310547,191.4900054931641,39617700.0,0.6699981689452841,0.0,0.6699981689452841,78.42442841516065,173.35000610351562,192.92999267578125,91.72627054054165,-8.273729459458341,4.167628266424543,3.105571019528313,0.04879115025385583,1711480100.0,1.0
AAPL,2023-11-24,189.97000122070312,190.8999938964844,189.25,190.8699951171875,24048300.0,-1.3399963378905966,1.3399963378905966,0.0,68.33668562382466,176.2100067138672,192.92999267578125,82.29668696002139,-17.703313039978607,4.097630795972492,3.3039829748171496,0.01915240043516997,1687431800.0,-1.0
AAPL,2023-11-27,189.7899932861328,190.6699981689453,188.8999938964844,189.9199981689453,40552600.0,-0.1800079345703125,0.1800079345703125,0.0,67.00083228593115,178.97000122070312,192.92999267578125,77.50715392804756,-22.49284607195245,3.9817332184050827,3.439533023534737,0.02700211121196472,1646879200.0,-1.0
AAPL,2023-11-28,190.3999938964844,191.0800018310547,189.3999938964844,189.77999877929688,38415400.0,0.6100006103515909,0.0,0.6100006103515909,69.3440175870197,181.58999633789065,192.92999267578125,77.68959791597726,-22.310402084022744,3.894215413234633,3.5304695014747165,0.015791674223881058,1685294600.0,1.0
AAPL,2023-11-29,189.3699951171875,192.08999633789065,188.97000122070312,190.8999938964844,43014200.0,-1.0299987792969034,1.0299987792969034,0.0,60.91661472013051,181.80999755859372,192.92999267578125,67.98561940831009,-32.014380591689914,3.6991036642456834,3.5641963340289102,0.00723366124188729,1642280400.0,-1.0
AAPL,2023-11-30,189.9499969482422,190.32000732421875,188.19000244140625,189.83999633789065,48794400.0,0.5800018310546875,0.0,0.5800018310546875,63.77690965015914,183.52999877929688,192.92999267578125,68.29789720763979,-31.702102792360208,3.550351258663312,3.5614273189557903,0.0012650372984117642,1691074800.0,1.0
AAPL,2023-12-01,191.2400054931641,191.55999755859372,189.22999572753903,190.3300018310547,45679300.0,1.2900085449219034,0.0,1.2900085449219034,69.50442873357179,184.2100067138672,192.92999267578125,80.61938184306203,-19.380618156937974,3.4962541723043614,3.548392689625505,0.008171242721326966,1736754100.0,1.0
AAPL,2023-12-04,189.42999267578125,190.0500030517578,187.4499969482422,189.97999572753903,43389500.0,-1.810012817382841,1.810012817382841,0.0,55.338491009880144,186.3000030517578,192.92999267578125,47.20957047477233,-52.79042952522768,3.2696385759378472,3.4926418668879733,-0.010551080201934071,1693364600.0,-1.0
AAPL,2023-12-05,193.4199981689453,194.3999938964844,190.17999267578125,190.2100067138672,66628400.0,3.9900054931640625,0.0,3.9900054931640625,70.5866425840027,187.4499969482422,194.3999938964844,85.89933585816969,-14.100664141830311,3.3731209420462562,3.46873768191963,0.014582452728689077,1759993000.0,1.0
AAPL,2023-12-06,192.32000732421875,194.75999450683597,192.1100006103516,194.4499969482422,41089700.0,-1.0999908447265625,1.0999908447265625,0.0,63.671625911036585,187.4499969482422,194.75999450683597,66.6212312239596,-33.3787687760404,3.3280081877991847,3.4405917830955417,0.005279440586034578,1718903300.0,-1.0
AAPL,2023-12-07,194.2700042724609,195.0,193.58999633789065,193.6300048828125,47477700.0,1.949996948242159,0.0,1.949996948242159,69.73604442444349,187.4499969482422,195.0,90.33118632489649,-9.668813675103499,3.4102927301970567,3.4345319725158445,0.022635168837853215,1766381000.0,1.0
AAPL,2023-12-08,195.7100067138672,195.9900054931641,193.6699981689453,194.1999969482422,53377300.0,1.4400024414062784,0.0,1.4400024414062784,73.50472127428566,187.4499969482422,195.9900054931641,96.72132904991767,-3.2786709500823332,3.550768931330964,3.457779364278869,0.031192442368703777,1819758300.0,1.0
AAPL,2023-12-11,193.17999267578125,193.4900054931641,191.4199981689453,193.1100006103516,60943700.0,-2.5300140380859375,2.5300140380859375,0.0,58.688871192082615,187.4499969482422,195.9900054931641,67.09590157197509,-32.90409842802491,3.4185395481973444,3.449931401062564,0.01460083439292692,1758814600.0,-1.0
AAPL,2023-12-12,194.7100067138672,194.72000122070312,191.72000122070312,193.0800018310547,52696900.0,1.5300140380859375,0.0,1.5300140380859375,63.78273554169378,187.4499969482422,195.9900054931641,85.01173889272017,-14.988261107279827,3.3980357148978158,3.439552263829614,0.028198826289112633,1811511500.0,1.0
AAPL,2023-12-13,197.9600067138672,198.0,194.8500061035156,195.08999633789065,70404200.0,3.25,0.0,3.25,72.18795547185749,187.4499969482422,198.0,99.62091682877619,-0.37908317122381235,3.6025066635673966,3.472143143777171,0.04216904392900611,1881915700.0,1.0
AAPL,2023-12-14,198.1100006103516,199.6199951171875,196.16000366210935,198.0200042724609,66831600.0,0.14999389648440342,0.0,0.14999389648440342,72.52747916148368,187.4499969482422,199.6199951171875,87.59248369741726,-12.407516302582728,3.733615818357805,3.524437678693298,0.03592342041337715,1948747300.0,1.0
AAPL,2023-12-15,197.57000732421875,198.3999938964844,197.0,197.52999877929688,128256700.0,-0.5399932861328409,0.5399932861328409,0.0,69.02706637296534,187.4499969482422,199.6199951171875,83.15539768773516,-16.844602312264833,3.7507119502159867,3.5696925329978355,0.042971097308595274,1820490600.0,-1.0
AAPL,2023-12-18,195.88999938964844,196.6300048828125,194.38999938964844,196.08999633789065,55751900.0,-1.6800079345703125,1.6800079345703125,0.0,58.83377830032736,187.4499969482422,199.6199951171875,69.35089327246534,-30.649106727534658,3.587345472415848,3.5732231208814382,0.01277014395660192,1764738700.0,-1.0
AAPL,2023-12-19,196.94000244140625,196.9499969482422,195.88999938964844,196.16000366210935,40714100.0,1.0500030517578125,0.0,1.0500030517578125,62.79577639767997,187.4499969482422,199.6199951171875,77.9786928594624,-22.021307140537605,3.502231290548366,3.559024754814824,0.024022436258537505,1805452800.0,1.0
AAPL,2023-12-20,194.8300018310547,197.67999267578125,194.8300018310547,196.8999938964844,52242800.0,-2.1100006103515625,2.1100006103515625,0.0,51.3390399331147,187.4499969482422,199.6199951171875,60.64096954134606,-39.35903045865394,3.2273157855182433,3.4926829609555083,0.0028825734610495868,1753210000.0,-1.0
AAPL,2023-12-21,194.67999267578125,197.0800018310547,193.5,196.1000061035156,46482500.0,-0.1500091552734375,0.1500091552734375,0.0,50.58201581964028,187.4499969482422,199.6199951171875,59.40835509727636,-40.59164490272364,2.9631810750537966,3.3867825837751666,-0.00526296051684183,1706727500.0,-1.0
AAPL,2023-12-22,193.6000061035156,195.41000366210935,192.97000122070312,195.17999267578125,37122800.0,-1.0799865722656534,1.0799865722656534,0.0,45.06221957180432,190.17999267578125,199.6199951171875,36.22894643261212,-63.77105356738788,2.6363167055341705,3.2366894081269675,0.0021742077008941596,1669604700.0,-1.0
AAPL,2023-12-26,193.0500030517578,193.88999938964844,192.8300018310547,193.6100006103516,28919300.0,-0.5500030517577841,0.5500030517577841,0.0,42.34676934116106,191.4199981689453,199.6199951171875,19.878115724932314,-80.12188427506769,2.306308004995003,3.050613127500575,-0.008525517974783958,1640685400.0,-1.0
AAPL,2023-12-27,193.1499938964844,193.5,191.08999633789065,192.4900054931641,48087700.0,0.09999084472659092,0.0,0.09999084472659092,43.06645122055636,191.08999633789065,199.6199951171875,24.15003345127749,-75.84996654872252,2.0294479451206655,2.846380091024593,-0.024297901870326877,1688773100.0,1.0
AAPL,2023-12-28,193.5800018310547,194.66000366210935,193.1699981689453,194.13999938964844,34049900.0,0.4300079345702841,0.0,0.4300079345702841,46.387297392181885,191.08999633789065,199.6199951171875,29.191158845268824,-70.80884115473117,1.8237098081463614,2.641846034448947,-0.02286607826631948,1722823000.0,1.0
AAPL,2023-12-29,192.52999877929688,194.3999938964844,191.72999572753903,193.8999938964844,42628800.0,-1.0500030517578125,1.0500030517578125,0.0,39.84000305406563,191.08999633789065,199.6199951171875,16.881625410090916,-83.11837458990908,1.557975015127198,2.4250718305845975,-0.025509988146384277,1680194200.0,-1.0
AAPL,2024-01-02,185.63999938964844,188.44000244140625,183.88999938964844,187.1499938964844,82488700.0,-6.8899993896484375,6.8899993896484375,0.0,19.258850640732746,183.88999938964844,199.6199951171875,11.125241419717698,-88.8747585802823,0.782393958002018,2.096536256068082,-0.05232528476153364,1597705500.0,-1.0
AAPL,2024-01-03,184.25,185.8800048828125,183.42999267578125,184.22000122070312,58414500.0,-1.3899993896484375,1.3899993896484375,0.0,17.191528524147444,183.42999267578125,199.6199951171875,5.064899324051768,-94.93510067594823,0.0549456689661838,1.6882181386477022,-0.06443588039043413,1539291000.0,-1.0
AAPL,2024-01-04,181.91000366210935,183.08999633789065,180.8800048828125,182.1499938964844,71983600.0,-2.3399963378906534,2.3399963378906534,0.0,14.22539557844928,180.8800048828125,199.6199951171875,5.496261024765674,-94.50373897523433,-0.7022849852265836,1.210117513872845,-0.0663142126341959,1467307400.0,-1.0
AAPL,2024-01-05,181.17999267578125,182.75999450683597,180.1699981689453,181.9900054931641,62303300.0,-0.7300109863280966,0.7300109863280966,0.0,13.393565803938344,180.1699981689453,198.3999938964844,5.540289322779117,-94.45971067722088,-1.3457881122330946,0.698936388651657,-0.0693445680495931,1405004100.0,-1.0
AAPL,2024-01-08,185.55999755859372,185.6000061035156,181.5,182.08999633789065,59144500.0,4.380004882812472,0.0,4.380004882812472,38.35056297200736,180.1699981689453,197.67999267578125,30.782416222598712,-69.21758377740129,-1.4852185132562,0.2621054082700855,-0.04152896844756804,1464148600.0,1.0
AAPL,2024-01-09,185.13999938964844,185.1499938964844,182.72999572753903,183.9199981689453,42841800.0,-0.4199981689452841,0.4199981689452841,0.0,37.16560198397793,180.1699981689453,197.67999267578125,28.38379657265356,-71.61620342734645,-1.6110374162727226,-0.11252315663847624,-0.04097385929586672,1421306800.0,-1.0
AAPL,2024-01-10,186.19000244140625,186.3999938964844,183.9199981689453,184.3500061035156,46792900.0,1.0500030517578125,0.0,1.0500030517578125,42.30770959290366,180.1699981689453,197.67999267578125,34.38038926917262,-65.61961073082739,-1.6074931519286793,-0.411517155696517,-0.036034127232788093,1468099700.0,1.0
AAPL,2024-01-11,185.58999633789065,187.0500030517578,183.6199951171875,186.5399932861328,49128400.0,-0.6000061035155966,0.6000061035155966,0.0,40.141737378160435,180.1699981689453,197.0800018310547,32.052022443318876,-67.94797755668112,-1.6342610311198484,-0.6560659307811835,-0.041274953081864574,1418971300.0,-1.0
AAPL,2024-01-12,185.9199981689453,186.7400054931641,185.19000244140625,186.05999755859372,40444700.0,0.3300018310546591,0.0,0.3300018310546591,42.02530168491895,180.1699981689453,195.41000366210935,37.72964519323294,-62.27035480676706,-1.6102840265146199,-0.8469095499278708,-0.034332315235345856,1459416000.0,1.0
AAPL,2024-01-16,183.6300048828125,184.25999450683597,180.92999267578125,182.16000366210935,65603000.0,-2.2899932861328125,2.2899932861328125,0.0,33.567754939285265,180.1699981689453,194.66000366210935,23.87857420412655,-76.12142579587345,-1.7558253360280673,-1.0286927071479102,-0.010827378331418003,1393813000.0,-1.0
AAPL,2024-01-17,182.67999267578125,182.92999267578125,180.3000030517578,181.2700042724609,47317400.0,-0.95001220703125,0.95001220703125,0.0,30.618202377739323,180.1699981689453,194.66000366210935,17.322246758430012,-82.67775324156999,-1.9256284715521588,-1.2080798600287599,-0.008521070959124799,1346495600.0,-1.0
AAPL,2024-01-18,188.6300048828125,189.13999938964844,185.8300018310547,186.08999633789065,78005800.0,5.95001220703125,0.0,5.95001220703125,57.56452439952063,180.1699981689453,194.66000366210935,58.38511736837073,-41.61488263162927,-1.562075783763106,-1.2788790447756293,0.03694135058776249,1424501400.0,1.0
AAPL,2024-01-19,191.55999755859372,191.9499969482422,188.82000732421875,189.3300018310547,68741000.0,2.9299926757812216,0.0,2.9299926757812216,65.23601976127449,180.1699981689453,194.3999938964844,80.04218418425467,-19.957815815745334,-1.0257080139656125,-1.228244838613626,0.05729112099804157,1493242400.0,1.0
AAPL,2024-01-22,193.88999938964844,195.3300018310547,192.25999450683597,192.3000030517578,60133900.0,2.330001831054716,0.0,2.330001831054716,70.1821437979097,180.1699981689453,195.3300018310547,90.50130545149297,-9.498694548507034,-0.40791878314027485,-1.064179627518956,0.044891150790322465,1553376300.0,1.0
AAPL,2024-01-23,195.17999267578125,195.75,193.8300018310547,195.0200042724609,42355600.0,1.2899932861328125,0.0,1.2899932861328125,72.66647894492228,180.1699981689453,195.75,96.34141683422278,-3.658583165777224,0.18365821293167528,-0.8146120594288296,0.05422919584763797,1595731900.0,1.0
AAPL,2024-01-24,194.5,196.3800048828125,194.33999633789065,195.4199981689453,53631300.0,-0.67999267578125,0.67999267578125,0.0,69.16167321042238,180.1699981689453,196.3800048828125,88.40219553268778,-11.597804467312223,0.5908070623510184,-0.5335282350728601,0.044631814005206216,1542100600.0,-1.0
AAPL,2024-01-25,194.1699981689453,196.2700042724609,193.1100006103516,195.22000122070312,54822100.0,-0.3300018310546875,0.3300018310546875,0.0,67.34288727272573,180.1699981689453,196.3800048828125,86.36640469755888,-13.633595302441122,0.8767405497338814,-0.2514744781115117,0.04623094994534971,1487278500.0,-1.0
AAPL,2024-01-26,192.4199981689453,194.75999450683597,191.94000244140625,194.2700042724609,44594000.0,-1.75,1.75,0.0,58.008656956540335,180.3000030517578,196.3800048828125,75.37309537975686,-24.626904620243135,0.9511700278858655,-0.010945576912036174,0.034961274010413046,1442684500.0,-1.0
AAPL,2024-01-29,191.72999572753903,192.1999969482422,189.5800018310547,192.00999450683597,47145600.0,-0.6900024414062784,0.6900024414062784,0.0,54.56767261363325,180.3000030517578,196.3800048828125,71.08203590939223,-28.917964090607768,0.9436012473185826,0.17996378793408765,0.04411038844058046,1395538900.0,-1.0
AAPL,2024-01-30,188.0399932861328,191.8000030517578,187.47000122070312,190.94000244140625,55859400.0,-3.6900024414062216,3.6900024414062216,0.0,39.94624496175207,180.3000030517578,196.3800048828125,48.13426214558667,-51.86573785441333,0.6325588313508774,0.2704827966174457,0.029340928537611832,1339679500.0,-1.0
AAPL,2024-01-31,184.3999938964844,187.1000061035156,184.3500061035156,187.0399932861328,55467800.0,-3.639999389648409,3.639999389648409,0.0,30.610527057298967,180.3000030517578,196.3800048828125,25.497452598596333,-74.50254740140367,0.09128566147430206,0.23464336958881696,-0.022424910548859978,1284211700.0,-1.0
AAPL,2024-02-01,186.8600006103516,186.9499969482422,183.82000732421875,183.9900054931641,64885400.0,2.4600067138671875,0.0,2.4600067138671875,41.30700748065005,180.3000030517578,196.3800048828125,40.79600007211882,-59.20399992788118,-0.13758919998915076,0.1601968556732234,-0.024535377991976137,1349097100.0,1.0
AAPL,2024-02-02,185.8500061035156,187.3300018310547,179.25,179.86000061035156,102518000.0,-1.0099945068359943,1.0099945068359943,0.0,38.495809727162744,179.25,196.3800048828125,38.528921320610685,-61.471078679389315,-0.3959085056697802,0.04897578340462265,-0.041466776581784326,1246579100.0,-1.0
AAPL,2024-02-05,187.67999267578125,189.25,185.83999633789065,188.1499938964844,69668800.0,1.8299865722656534,0.0,1.8299865722656534,46.156651963734596,179.25,196.3800048828125,49.211852147453484,-50.788147852546516,-0.447801813407807,-0.05037973595786331,-0.038426069686653075,1316247900.0,1.0
AAPL,2024-02-06,189.3000030517578,189.30999755859372,186.7700042724609,186.8600006103516,43490800.0,1.6200103759765625,0.0,1.6200103759765625,52.233930227816664,179.25,196.3800048828125,58.66900284331821,-41.330997156681796,-0.3541242118322714,-0.11112863113274496,-0.02673520281872588,1359738700.0,1.0
AAPL,2024-02-07,189.41000366210935,191.0500030517578,188.6100006103516,190.63999938964844,53439000.0,0.11000061035153408,0.0,0.11000061035153408,52.652625610154296,179.25,196.3800048828125,59.31115450120771,-40.68884549879229,-0.2679194985261688,-0.14248680461142973,-0.02451457254840339,1413177700.0,1.0
AAPL,2024-02-08,188.32000732421875,189.5399932861328,187.3500061035156,189.38999938964844,40962000.0,-1.0899963378905966,1.0899963378905966,0.0,47.85643076389465,179.25,196.3800048828125,52.948072030727786,-47.051927969272214,-0.28427825438839704,-0.1708450945668232,-0.02130750901019529,1372215700.0,-1.0
AAPL,2024-02-09,188.8500061035156,189.9900054931641,188.0,188.6499938964844,45155200.0,0.5299987792968466,0.0,0.5299987792968466,50.39172655067539,179.25,196.3800048828125,56.04205117972747,-43.95794882027253,-0.2515762003264399,-0.18699131571874655,-0.015021069671936393,1417370900.0,1.0
AAPL,2024-02-12,187.1499938964844,188.6699981689453,186.7899932861328,188.4199981689453,41781900.0,-1.7000122070311932,1.7000122070311932,0.0,42.70664603255377,179.25,196.3800048828125,46.117872998453805,-53.882127001546195,-0.35870147704591204,-0.2213333479841797,-0.004733032447486463,1375589000.0,-1.0
AAPL,2024-02-13,185.0399932861328,186.2100067138672,183.50999450683597,185.7700042724609,56529500.0,-2.110000610351591,2.110000610351591,0.0,35.05119966953238,179.25,196.2700042724609,34.01875342358913,-65.98124657641087,-0.606862908041677,-0.29843925999567916,0.0034707126400865818,1319059500.0,-1.0
AAPL,2024-02-14,184.1499938964844,185.52999877929688,182.44000244140625,185.32000732421875,54630500.0,-0.8899993896484091,0.8899993896484091,0.0,32.23860989037561,179.25,194.75999450683597,31.592492791178948,-68.40750720882104,-0.8653726653118667,-0.4118259410589168,-0.01450287223062896,1264429000.0,-1.0
AAPL,2024-02-15,183.8600006103516,184.4900054931641,181.3500061035156,183.5500030517578,65434500.0,-0.2899932861328125,0.2899932861328125,0.0,31.29451030102041,179.25,192.1999969482422,35.59846870062271,-64.4015312993773,-1.0811803707242973,-0.545696826991993,-0.010707589065429457,1198994500.0,-1.0
AAPL,2024-02-16,182.30999755859372,184.8500061035156,181.6699981689453,183.4199981689453,49701400.0,-1.5500030517578693,1.5500030517578693,0.0,26.50714122336018,179.25,191.8000030517578,24.38244473705625,-75.61755526294375,-1.3615863050683004,-0.7088747226072545,-0.028612507069223136,1149293100.0,-1.0
AAPL,2024-02-20,181.55999755859372,182.42999267578125,180.0,181.7899932861328,53665600.0,-0.75,0.75,0.0,24.421331418939744,179.25,191.0500030517578,19.576245433679002,-80.42375456632101,-1.6255899709495623,-0.8922177722757162,-0.04088750854931489,1095627500.0,-1.0
AAPL,2024-02-21,182.32000732421875,182.88999938964844,180.66000366210935,181.94000244140625,41529700.0,0.7600097656250284,0.0,0.7600097656250284,30.789165170202764,179.25,191.0500030517578,26.017004493582906,-73.9829955064171,-1.7532776484311796,-1.064429747506809,-0.03743200570619554,1137157200.0,1.0
AAPL,2024-02-22,184.3699951171875,184.9600067138672,182.4600067138672,183.47999572753903,52292200.0,2.04998779296875,0.0,2.04998779296875,45.167550963224485,179.25,191.0500030517578,43.38977790708952,-56.61022209291049,-1.6698056897719198,-1.185504935959831,-0.02097500028359045,1189449400.0,1.0
AAPL,2024-02-23,182.5200042724609,185.0399932861328,182.22999572753903,185.00999450683597,45119700.0,-1.849990844726591,1.849990844726591,0.0,37.13451043488123,180.0,191.0500030517578,22.805462230709807,-77.19453776929019,-1.7329559241364905,-1.294995133595163,-0.03351867422013732,1144329700.0,-1.0
AAPL,2024-02-26,181.16000366210935,182.75999450683597,180.6499938964844,182.2400054931641,40867400.0,-1.3600006103515625,1.3600006103515625,0.0,32.26678044978854,180.0,191.0500030517578,10.49776779857826,-89.50223220142173,-1.8711738952007124,-1.410230885916273,-0.03200636083209396,1103462300.0,-1.0
AAPL,2024-02-27,182.6300048828125,183.9199981689453,179.55999755859375,181.1000061035156,54318900.0,1.4700012207031534,0.0,1.4700012207031534,41.78414220019661,179.55999755859375,191.0500030517578,26.718936958256805,-73.2810630417432,-1.8408753546941057,-1.4963597796718398,-0.013024148782764366,1157781200.0,1.0
AAPL,2024-02-28,181.4199981689453,183.1199951171875,180.1300048828125,182.50999450683597,48953900.0,-1.2100067138671875,1.2100067138671875,0.0,36.86442325726474,179.55999755859375,189.9900054931641,17.833165823264395,-82.1668341767356,-1.8926832975151626,-1.5756244832405046,-0.014824848319428652,1108827300.0,-1.0
AAPL,2024-02-29,180.75,182.57000732421875,179.52999877929688,181.2700042724609,136682600.0,-0.6699981689453125,0.6699981689453125,0.0,34.28530883325942,179.52999877929688,189.9900054931641,11.663484107383262,-88.33651589261675,-1.9651516730598928,-1.6535299212043824,-0.016915047318761367,972144700.0,-1.0
AAPL,2024-03-01,179.66000366210938,180.52999877929688,177.3800048828125,179.5500030517578,73488000.0,-1.089996337890625,1.089996337890625,0.0,30.30532391321981,177.3800048828125,188.6699981689453,20.1948639074687,-79.8051360925313,-2.086485274323394,-1.740120991828185,-0.014535647698819432,898656700.0,-1.0
AAPL,2024-03-04,175.10000610351562,176.89999389648438,173.7899932861328,176.14999389648438,81510100.0,-4.55999755859375,4.55999755859375,0.0,19.42210866991833,173.7899932861328,186.2100067138672,10.547595821897444,-89.45240417810255,-2.521530091676084,-1.8964028117977647,-0.03558047775911266,817146600.0,-1.0
AAPL,2024-03-05,170.1199951171875,172.0399932861328,169.6199951171875,170.75999450683594,95132400.0,-4.980010986328125,4.980010986328125,0.0,13.371183955846675,169.6199951171875,185.52999877929688,3.142676837911609,-96.85732316208839,-3.2309076188056167,-2.1633037731993356,-0.06691537799982661,722014200.0,-1.0
AAPL,2024-03-06,169.1199951171875,171.24000549316406,168.67999267578125,171.05999755859375,68587700.0,-1.0,1.0,0.0,12.470974893743374,168.67999267578125,185.0399932861328,2.689501375249611,-97.31049862475038,-3.8296403523822846,-2.4965710890359256,-0.08271410969180171,653426500.0,-1.0
AAPL,2024-03-07,169.0,170.72999572753906,168.49000549316406,169.14999389648438,71765100.0,-0.1199951171875,0.1199951171875,0.0,12.355800513051378,168.49000549316406,185.0399932861328,3.081540078552857,-96.91845992144714,-4.2646625848759925,-2.850189388203939,-0.0740740957483138,581661400.0,-1.0
AAPL,2024-03-08,170.72999572753906,173.6999969482422,168.94000244140625,169.0,76114600.0,1.7299957275390625,0.0,1.7299957275390625,24.027666906212332,168.49000549316406,185.0399932861328,13.534694178606333,-86.46530582139367,-4.418886468708422,-3.163928804304836,-0.05757345839992267,657776000.0,1.0
AAPL,2024-03-11,172.75,174.3800048828125,172.0500030517578,172.94000244140625,60139500.0,2.0200042724609375,0.0,2.0200042724609375,35.585037770203044,168.49000549316406,185.0399932861328,25.74016706311888,-74.25983293688112,-4.328219524406933,-3.3967869483252553,-0.054098475708589944,717915500.0,1.0
AAPL,2024-03-12,173.22999572753906,174.02999877929688,171.00999450683594,173.14999389648438,59825400.0,0.4799957275390625,0.0,0.4799957275390625,38.164188027761845,168.49000549316406,185.0399932861328,28.640445501650348,-71.35955449834965,-4.169569472692871,-3.551343453198778,-0.04514387897732974,777740900.0,1.0
AAPL,2024-03-13,171.1300048828125,173.19000244140625,170.75999450683594,172.77000427246094,52488700.0,-2.0999908447265625,2.0999908447265625,0.0,31.747298045786053,168.49000549316406,185.0399932861328,15.95166970920691,-84.04833029079309,-4.165275175086634,-3.67412979757635,-0.05322265625,725252200.0,-1.0
AAPL,2024-03-14,173.0,174.30999755859375,172.0500030517578,172.91000366210938,72913500.0,1.8699951171875,0.0,1.8699951171875,41.80157365740549,168.49000549316406,183.9199981689453,29.228753386997887,-70.77124661300212,-3.9652697738805784,-3.732357792837196,-0.037070040778998226,798165700.0,1.0
AAPL,2024-03-15,172.6199951171875,172.6199951171875,170.2899932861328,171.1699981689453,121664700.0,-0.3800048828125,0.3800048828125,0.0,40.40593587225762,168.49000549316406,183.9199981689453,26.76598564110678,-73.23401435889322,-3.7936959057653894,-3.744625415422835,-0.014163397486474105,676501000.0,-1.0
AAPL,2024-03-18,173.72000122070312,177.7100067138672,173.52000427246094,175.57000732421875,75604200.0,1.100006103515625,0.0,1.100006103515625,46.38483911893421,168.49000549316406,183.1199951171875,35.74845821456397,-64.25154178543603,-3.5282891586053893,-3.7013581640593456,0.02116156952059489,752105200.0,1.0
AAPL,2024-03-19,176.0800018310547,176.61000061035156,173.02999877929688,174.33999633789062,55215200.0,2.3600006103515625,0.0,2.3600006103515625,57.051558259019465,168.49000549316406,182.57000732421875,53.906216980385736,-46.09378301961426,-3.0918788190234068,-3.579462295052158,0.04115425091541902,807320400.0,1.0
AAPL,2024-03-20,178.6699981689453,178.6699981689453,175.08999633789062,175.72000122070312,53423100.0,2.589996337890625,0.0,2.589996337890625,65.69418773848162,168.49000549316406,180.52999877929688,84.55148133268614,-15.448518667313857,-2.5081174055702036,-3.365193317155767,0.05721892407659945,860743500.0,1.0
AAPL,2024-03-21,171.3699951171875,177.49000549316406,170.83999633789062,177.0500030517578,106181300.0,-7.3000030517578125,7.3000030517578125,0.0,39.70779300986434,168.49000549316406,178.6699981689453,28.290684637476094,-71.70931536252391,-2.6045083660468435,-3.213056326933983,0.0037486054335160723,754562200.0,-1.0
AAPL,2024-03-22,172.27999877929688,173.0500030517578,170.05999755859375,171.75999450683594,71106600.0,0.910003662109375,0.0,0.910003662109375,42.95354795817512,168.49000549316406,178.6699981689453,37.22982330969069,-62.77017669030931,-2.5777544575791183,-3.0859959530630103,-0.0027207017117402144,825668800.0,1.0
AAPL,2024-03-25,170.85000610351562,171.94000244140625,169.4499969482422,170.57000732421875,54288300.0,-1.42999267578125,1.42999267578125,0.0,39.13371634259233,168.49000549316406,178.6699981689453,23.18273387333697,-76.81726612666303,-2.641490788812547,-2.997094920212918,-0.013738900206213378,771380500.0,-1.0
AAPL,2024-03-26,169.7100067138672,171.4199981689453,169.5800018310547,170.0,57388400.0,-1.1399993896484375,1.1399993896484375,0.0,36.17456481570416,168.49000549316406,178.6699981689453,11.984303521215429,-88.01569647878458,-2.7522643239809383,-2.9481288009665225,-0.008297774372867606,713992100.0,-1.0
AAPL,2024-03-27,173.30999755859375,173.60000610351562,170.11000061035156,170.41000366210938,60273300.0,3.5999908447265625,0.0,3.5999908447265625,49.9614339051026,168.94000244140625,178.6699981689453,44.912610853661405,-55.087389146338595,-2.5205091137901263,-2.8626048635312435,0.0017918934022760347,774265400.0,1.0
AAPL,2024-03-28,171.47999572753906,172.22999572753906,170.50999450683594,171.75,65672700.0,-1.8300018310546875,1.8300018310546875,0.0,44.34323311202786,169.4499969482422,178.6699981689453,22.017337424409426,-77.98266257559058,-2.4561938203767397,-2.781322654900343,-0.0066040981456089165,708592700.0,-1.0
AAPL,2024-04-01,170.02999877929688,171.25,169.47999572753906,171.19000244140625,46240500.0,-1.4499969482421875,1.4499969482421875,0.0,40.20939580380626,169.4499969482422,178.6699981689453,6.290691477917789,-93.70930852208221,-2.4934828049368605,-2.723754684907647,-0.021241091500559417,662352200.0,-1.0
AAPL,2024-04-02,168.83999633789062,169.33999633789062,168.22999572753906,169.0800018310547,49329500.0,-1.19000244140625,1.19000244140625,0.0,36.947709313697686,168.22999572753906,178.6699981689453,5.8429163573011245,-94.15708364269888,-2.5892110325541466,-2.6968459544369474,-0.041117704554039625,613022700.0,-1.0
AAPL,2024-04-03,169.64999389648438,170.67999267578125,168.5800018310547,168.7899932861328,47691700.0,0.80999755859375,0.0,0.80999755859375,40.724097306533736,168.22999572753906,178.6699981689453,13.6015118474823,-86.3984881525177,-2.570089912394309,-2.67149474602842,-0.05048415718867294,660714400.0,1.0
AAPL,2024-04-04,168.82000732421875,171.9199981689453,168.82000732421875,170.2899932861328,53704400.0,-0.829986572265625,0.829986572265625,0.0,38.03101910045215,168.22999572753906,178.6699981689453,5.651450753877544,-94.34854924612246,-2.592029958918289,-2.655601788606394,-0.014880013220663235,607010000.0,-1.0
AAPL,2024-04-05,169.5800018310547,170.38999938964844,168.9499969482422,169.58999633789062,42055200.0,0.7599945068359375,0.0,0.7599945068359375,42.07797550066693,168.22999572753906,178.6699981689453,12.931089921601412,-87.06891007839859,-2.5190543086818593,-2.628292292621487,-0.01567214399450445,649065200.0,1.0
AAPL,2024-04-08,168.4499969482422,169.1999969482422,168.24000549316406,169.02999877929688,37425500.0,-1.1300048828125,1.1300048828125,0.0,37.83855506663231,168.22999572753906,178.6699981689453,2.1072908932528103,-97.89270910674719,-2.523315321983887,-2.607296898493967,-0.014047463093558865,611639700.0,-1.0
AAPL,2024-04-09,169.6699981689453,170.0800018310547,168.35000610351562,168.6999969482422,42451200.0,1.220001220703125,0.0,1.220001220703125,44.77043634941065,168.22999572753906,178.6699981689453,13.79312360785506,-86.20687639214493,-2.400575957854045,-2.5659527103659827,-0.00023574652842561772,654090900.0,1.0
AAPL,2024-04-10,167.77999877929688,169.08999633789062,167.11000061035156,168.8000030517578,49709300.0,-1.8899993896484375,1.8899993896484375,0.0,37.32944422711559,167.11000061035156,177.49000549316406,6.454699940023286,-93.54530005997671,-2.4278248294866387,-2.538327134190114,-0.03190813488660549,604381600.0,-1.0
AAPL,2024-04-11,175.0399932861328,175.4600067138672,168.16000366210938,168.33999633789062,91070300.0,7.2599945068359375,0.0,7.2599945068359375,63.91299157859903,167.11000061035156,175.4600067138672,94.96990274584907,-5.0300972541509354,-1.842361280169257,-2.3991339633859425,0.020760424815091216,695451900.0,1.0
AAPL,2024-04-12,176.5500030517578,178.36000061035156,174.2100067138672,174.25999450683594,101593300.0,1.510009765625,0.0,1.510009765625,67.24717524384063,167.11000061035156,178.36000061035156,83.9111328125,-16.0888671875,-1.2422125775468942,-2.167749686218133,0.038346199607541376,797045200.0,1.0
AAPL,2024-04-15,172.69000244140625,176.6300048828125,172.5,175.36000061035156,73531800.0,-3.8600006103515625,3.8600006103515625,0.0,52.84578246565603,167.11000061035156,178.36000061035156,49.600016276041664,-50.39998372395833,-1.0657746104770922,-1.947354671069925,0.022802690043956186,723513400.0,-1.0
AAPL,2024-04-16,169.3800048828125,173.75999450683594,168.27000427246094,171.75,73711200.0,-3.30999755859375,3.30999755859375,0.0,43.60594452930873,167.11000061035156,178.36000061035156,20.177815755208332,-79.82218424479167,-1.1794395456751658,-1.7937716459909732,-0.0015914472348087516,649802200.0,-1.0
AAPL,2024-04-17,168.0,170.64999389648438,168.0,169.61000061035156,50901200.0,-1.3800048828125,1.3800048828125,0.0,40.22275239031122,167.11000061035156,178.36000061035156,7.911105685763889,-92.08889431423611,-1.3651382229273565,-1.7080449613782498,-0.004857287576370717,598901000.0,-1.0
AAPL,2024-04-18,167.0399932861328,168.63999938964844,166.5500030517578,168.02999877929688,43122900.0,-0.9600067138671875,0.9600067138671875,0.0,37.86468165296547,166.5500030517578,178.36000061035156,4.148944417168402,-95.8510555828316,-1.5716532409927026,-1.6807666173011404,-0.014978231616322168,555778100.0,-1.0
AAPL,2024-04-19,165.0,166.39999389648438,164.0800018310547,166.2100067138672,67772100.0,-2.0399932861328125,2.0399932861328125,0.0,33.10592837390789,164.0800018310547,178.36000061035156,6.442564759032926,-93.55743524096707,-1.8782766854818647,-1.7202686309372854,-0.020480837107419103,488006000.0,-1.0
AAPL,2024-04-22,165.83999633789062,167.25999450683594,164.77000427246094,165.52000427246094,48116400.0,0.839996337890625,0.0,0.839996337890625,36.87518378727236,164.0800018310547,178.36000061035156,12.324892558027214,-87.67510744197278,-2.0300956114980124,-1.7822340270494308,-0.022573241423867074,536122400.0,1.0
AAPL,2024-04-23,166.89999389648438,167.0500030517578,164.9199981689453,165.35000610351562,49537800.0,1.05999755859375,0.0,1.05999755859375,41.66147134338185,164.0800018310547,178.36000061035156,19.747845283559187,-80.25215471644081,-2.041348860978985,-1.8340569938353417,-0.005244992783496771,585660200.0,1.0
AAPL,2024-04-24,169.02000427246094,169.3000030517578,166.2100067138672,166.5399932861328,48251800.0,2.1200103759765625,0.0,2.1200103759765625,50.34919473911937,164.0800018310547,178.36000061035156,34.593857588897414,-65.40614241110259,-1.8577846377197602,-1.8388025226122255,-0.0343920774941483,633912000.0,1.0
AAPL,2024-04-25,169.88999938964844,170.61000061035156,168.14999389648438,169.52999877929688,50558300.0,0.8699951171875,0.0,0.8699951171875,53.619671512056556,164.0800018310547,178.36000061035156,40.686260891121904,-59.313739108878096,-1.623393859291184,-1.7957207899480174,-0.03772304472946919,684470300.0,1.0
AAPL,2024-04-26,169.3000030517578,171.33999633789062,169.17999267578125,169.8800048828125,44838400.0,-0.589996337890625,0.589996337890625,0.0,50.99144668336983,164.0800018310547,178.36000061035156,36.55463352189551,-63.44536647810449,-1.468319380533103,-1.7302405080650345,-0.019630548044022755,639631900.0,-1.0
AAPL,2024-04-29,173.5,176.02999877929688,173.10000610351562,173.3699951171875,68169400.0,4.1999969482421875,0.0,4.1999969482421875,65.05906213769747,164.0800018310547,178.36000061035156,65.96637937114123,-34.03362062885877,-0.9950468057998307,-1.5832017676119938,0.02432397566665534,707801300.0,1.0
AAPL,2024-04-30,170.3300018310547,174.99000549316406,170.0,173.3300018310547,65934800.0,-3.1699981689453125,3.1699981689453125,0.0,52.0480516830151,164.0800018310547,178.36000061035156,43.76751074419728,-56.23248925580272,-0.8657869865850785,-1.4397188114066108,0.013869058518182653,641866500.0,-1.0
AAPL,2024-05-01,169.3000030517578,172.7100067138672,169.11000061035156,169.5800018310547,50383100.0,-1.029998779296875,1.029998779296875,0.0,48.41782216491146,164.0800018310547,178.36000061035156,36.55463352189551,-63.44536647810449,-0.8368136748754296,-1.3191377841003746,0.013529752493186997,591483400.0,-1.0
AAPL,2024-05-02,173.02999877929688,173.4199981689453,170.88999938964844,172.50999450683594,94214900.0,3.7299957275390625,0.0,3.7299957275390625,60.05840117604452,164.0800018310547,176.6300048828125,71.31469937761177,-28.685300622388226,-0.5070279318818791,-1.1567158136566755,0.04866665926846592,685698300.0,1.0
AAPL,2024-05-03,183.3800048828125,187.0,182.66000366210935,186.6499938964844,163224100.0,10.350006103515625,0.0,10.350006103515625,76.81222993141213,164.0800018310547,187.0,84.2059537243232,-15.79404627567681,0.5827708201101416,-0.808818486903312,0.10576464623880599,848922400.0,1.0
AAPL,2024-05-06,181.7100067138672,184.1999969482422,180.4199981689453,182.3500061035156,78569700.0,-1.6699981689453125,1.6699981689453125,0.0,71.24824323302965,164.0800018310547,187.0,76.91974821664553,-23.080251783354473,1.2967412610984752,-0.38770653730295457,0.08873584996395123,770352700.0,-1.0
AAPL,2024-05-07,182.3999938964844,184.8999938964844,181.32000732421875,183.4499969482422,77305800.0,0.6899871826172159,0.0,0.6899871826172159,72.20797279227604,164.0800018310547,187.0,79.93016373906949,-20.069836260930515,1.8963838461146736,0.06911153938057117,0.07916216593187908,847658500.0,1.0
AAPL,2024-05-08,182.7400054931641,183.07000732421875,181.4499969482422,182.8500061035156,45057100.0,0.3400115966796875,0.0,0.3400115966796875,72.72562714685137,164.0800018310547,187.0,81.41363504728439,-18.586364952715602,2.3717015105078474,0.5296295336060266,0.07563721319489636,892715600.0,1.0
AAPL,2024-05-09,184.57000732421875,184.66000366210935,182.1100006103516,182.55999755859372,48983000.0,1.830001831054659,0.0,1.830001831054659,75.55339587081721,164.77000427246094,187.0,89.06885675748954,-10.931143242510458,2.8630565046264564,0.9963149278101128,0.0901949438700993,941698600.0,1.0
AAPL,2024-05-10,183.0500030517578,185.08999633789065,182.1300048828125,184.8999938964844,50759500.0,-1.5200042724609375,1.5200042724609375,0.0,68.72462296079959,164.9199981689453,187.0,82.1105225512859,-17.889477448714093,3.0941399169774684,1.4158799256435841,0.05504324525508819,890939100.0,-1.0
AAPL,2024-05-13,186.27999877929688,187.1000061035156,184.6199951171875,185.44000244140625,72044800.0,3.2299957275390625,0.0,3.2299957275390625,74.3982777622503,166.2100067138672,187.1000061035156,96.07464170331637,-3.925358296683621,3.497590797603408,1.832222100035549,0.09364173531837627,962983900.0,1.0
AAPL,2024-05-14,187.42999267578125,188.3000030517578,186.2899932861328,187.50999450683597,52393600.0,1.149993896484375,0.0,1.149993896484375,76.17391610933542,168.14999389648438,188.3000030517578,95.68233260207293,-4.317667397927077,3.8655636126555066,2.238890402559541,0.10708794623282314,1015377500.0,1.0
AAPL,2024-05-15,189.72000122070312,190.6499938964844,187.3699951171875,187.91000366210935,70400000.0,2.290008544921875,0.0,2.290008544921875,79.44890463624101,169.11000061035156,190.6499938964844,95.68248391061479,-4.317516089385205,4.292488139568661,2.649609949961365,0.09645727653673908,1085777500.0,1.0
AAPL,2024-05-16,189.83999633789065,191.1000061035156,189.66000366210935,190.47000122070312,52845200.0,0.11999511718752842,0.0,0.11999511718752842,79.61828854220988,169.11000061035156,191.1000061035156,94.27007980504307,-5.729920194956925,4.58762818408178,3.037213596785448,0.03522734912787451,1138622700.0,1.0
AAPL,2024-05-17,189.8699951171875,190.80999755859372,189.17999267578125,189.50999450683597,41282900.0,0.02999877929684658,0.0,0.02999877929684658,79.66663163294791,169.11000061035156,191.1000061035156,94.40649986781283,-5.593500132187171,4.768975663640447,3.383566010156448,0.044906654019167824,1179905600.0,1.0
AAPL,2024-05-20,191.0399932861328,191.9199981689453,189.00999450683597,189.3300018310547,44361300.0,1.1699981689453125,0.0,1.1699981689453125,81.62767578031378,169.11000061035156,191.9199981689453,96.14202114422868,-3.857978855771315,4.950042908525148,3.6968613898301883,0.04736841929145985,1224266900.0,1.0
AAPL,2024-05-21,192.3500061035156,192.72999572753903,190.9199981689453,191.08999633789065,42309400.0,1.310012817382784,0.0,1.310012817382784,83.66322929818404,170.88999938964844,192.72999572753903,98.2601204773822,-1.739879522617807,5.139996411647417,3.9854883941936343,0.05258837868816313,1266576300.0,1.0
AAPL,2024-05-22,190.8999938964844,192.82000732421875,190.2700042724609,192.2700042724609,34648500.0,-1.4500122070311932,1.4500122070311932,0.0,73.29223469781235,180.4199981689453,192.82000732421875,84.51603217633263,-15.483967823667367,5.114574434197749,4.211305602194457,0.03429585697066306,1231927800.0,-1.0
AAPL,2024-05-23,186.8800048828125,191.0,186.6300048828125,190.97999572753903,51005900.0,-4.019989013671903,4.019989013671903,0.0,52.48130354348704,180.4199981689453,192.82000732421875,52.096789873093726,-47.903210126906274,4.715688297678469,4.3121821412912595,0.020923254669226843,1180921900.0,-1.0
AAPL,2024-05-24,189.97999572753903,190.5800018310547,188.0399932861328,188.82000732421875,36294600.0,3.099990844726534,0.0,3.099990844726534,62.06542349738142,181.32000732421875,192.82000732421875,75.30424698539377,-24.695753014606225,4.5967233487292845,4.3690903827788645,0.019862556219070404,1217216500.0,1.0
AAPL,2024-05-28,189.9900054931641,193.0,189.1000061035156,191.50999450683597,52280100.0,0.010009765625056843,0.0,0.010009765625056843,62.09390796712321,181.4499969482422,193.0,73.93944838501308,-26.06055161498692,4.451931380300664,4.385658582283225,0.013658501400099832,1269496600.0,1.0
AAPL,2024-05-29,190.2899932861328,192.25,189.50999450683597,189.6100006103516,53068000.0,0.2999877929687216,0.0,0.2999877929687216,63.05325699486003,182.1100006103516,193.0,75.11472115927565,-24.88527884072436,4.31168676880219,4.370864219587018,0.003004385735622117,1322564600.0,1.0
AAPL,2024-05-30,191.2899932861328,192.17999267578125,190.6300048828125,190.75999450683597,49947900.0,1.0,0.0,1.0,66.33077489432885,182.1300048828125,193.0,84.26856042314733,-15.731439576852674,4.232444560148963,4.343180287699407,0.007637995028515254,1372512500.0,1.0
AAPL,2024-05-31,192.25,192.57000732421875,189.91000366210935,191.44000244140625,75158300.0,0.9600067138671875,0.0,0.9600067138671875,69.3432104321505,184.6199951171875,193.0,91.05012454660665,-8.94987545339335,4.198708954359944,4.314286021031514,0.012534918333692247,1447670800.0,1.0
AAPL,2024-06-03,194.02999877929688,194.9900054931641,192.5200042724609,192.8999938964844,50080500.0,1.779998779296875,0.0,1.779998779296875,74.26860772806033,186.2899932861328,194.9900054931641,88.96545555313881,-11.034544446861194,4.266423593707202,4.304713535566652,0.015651201833355,1497751300.0,1.0
AAPL,2024-06-04,194.3500061035156,195.32000732421875,193.02999877929688,194.63999938964844,47471400.0,0.3200073242187216,0.0,0.3200073242187216,75.09851202717255,186.6300048828125,195.32000732421875,88.83773362270558,-11.162266377294412,4.296383811723729,4.303047590798068,0.01039771217331631,1545222700.0,1.0
AAPL,2024-06-05,195.8699951171875,196.8999938964844,194.8699951171875,195.3999938964844,54156800.0,1.5199890136719034,0.0,1.5199890136719034,78.83900798161676,186.6300048828125,196.8999938964844,89.97078986232879,-10.029210137671225,4.392147962978612,4.320867665234177,0.02603458030175787,1599379500.0,1.0
AAPL,2024-06-06,194.47999572753903,196.5,194.1699981689453,195.69000244140625,41181800.0,-1.389999389648466,1.389999389648466,0.0,68.05273211661981,186.6300048828125,196.8999938964844,76.43621462765198,-23.563785372348026,4.306240745978641,4.31794228138307,0.040667758166489154,1558197700.0,-1.0
AAPL,2024-06-07,196.88999938964844,196.94000244140625,194.13999938964844,194.6499938964844,53103900.0,2.4100036621094034,0.0,2.4100036621094034,74.91782683952918,186.6300048828125,196.94000244140625,99.51500423279796,-0.48499576720203175,4.382111557603025,4.330776136627061,0.03637226980476105,1611301600.0,1.0
AAPL,2024-06-10,193.1199951171875,197.3000030517578,192.1499938964844,196.8999938964844,97262100.0,-3.7700042724609375,3.7700042724609375,0.0,53.980481677662254,186.6300048828125,197.3000030517578,60.82466118189137,-39.17533881810862,4.090874826370481,4.282795874575745,0.01647449620257002,1514039500.0,-1.0
AAPL,2024-06-11,207.1499938964844,207.16000366210935,193.6300048828125,193.6499938964844,172373300.0,14.029998779296903,0.0,14.029998779296903,79.08253348313674,186.6300048828125,207.16000366210935,99.95124322347726,-0.0487567765227407,4.935280425874453,4.413292784835487,0.08860161440543934,1686412800.0,1.0
AAPL,2024-06-12,213.07000732421875,220.1999969482422,206.8999938964844,207.3699951171875,198134300.0,5.920013427734347,0.0,5.920013427734347,83.47190961144648,186.6300048828125,220.1999969482422,78.76082422025388,-21.239175779746123,6.01286103595038,4.733206435058466,0.11385861677305442,1884547100.0,1.0
AAPL,2024-06-13,214.2400054931641,216.75,211.6000061035156,214.7400054931641,97862700.0,1.169998168945341,0.0,1.169998168945341,84.22670052106602,188.0399932861328,220.1999969482422,81.46769037187609,-18.532309628123905,6.881929903065895,5.162951128659952,0.11438234326743357,1982409800.0,1.0
AAPL,2024-06-14,212.4900054931641,215.1699981689453,211.3000030517578,213.8500061035156,70122700.0,-1.75,1.75,0.0,78.07340365328756,189.1000061035156,220.1999969482422,75.20902339305535,-24.790976606944646,7.344796623420592,5.59932022761208,0.09513996201620811,1912287100.0,-1.0
AAPL,2024-06-17,216.6699981689453,218.9499969482422,212.72000122070312,213.3699951171875,93728300.0,4.179992675781222,0.0,4.179992675781222,81.7483118812788,189.50999450683597,220.1999969482422,88.49788693879579,-11.502113061204208,7.957186812952614,6.070893544680187,0.11484430853859373,2006015400.0,1.0
AAPL,2024-06-18,214.2899932861328,218.6300048828125,213.0,217.58999633789065,79943300.0,-2.3800048828125,2.3800048828125,0.0,73.63985123968389,189.91000366210935,220.1999969482422,80.48859368742399,-19.511406312576018,8.156441565518833,6.488003148847917,0.09404195960654804,1926072100.0,-1.0
AAPL,2024-06-20,209.67999267578125,214.2400054931641,208.8500061035156,213.92999267578125,86172500.0,-4.6100006103515625,4.6100006103515625,0.0,60.27742419819985,189.91000366210935,220.1999969482422,65.26904389484585,-34.730956105154156,7.851852601427083,6.760773039363752,0.07815712300578714,1839899600.0,-1.0
AAPL,2024-06-21,207.4900054931641,211.88999938964844,207.1100006103516,210.38999938964844,246421400.0,-2.189987182617159,2.189987182617159,0.0,54.824429647639676,192.1499938964844,220.1999969482422,54.68809243398064,-45.31190756601936,7.349034890189984,6.878425409528997,0.053837199128321744,1593478200.0,-1.0
AAPL,2024-06-24,208.13999938964844,212.6999969482422,206.58999633789065,207.72000122070312,80727000.0,0.6499938964843466,0.0,0.6499938964843466,56.18195814849833,192.1499938964844,220.1999969482422,57.00536097503919,-42.994639024960804,6.923191069536415,6.887378541530481,0.07777550047754822,1674205200.0,1.0
AAPL,2024-06-25,209.07000732421875,211.3800048828125,208.6100006103516,209.1499938964844,56713900.0,0.9300079345703125,0.0,0.9300079345703125,58.25303176113267,192.1499938964844,220.1999969482422,60.32089692294716,-39.67910307705284,6.584844651331537,6.826871763490692,0.009268711003167063,1730919100.0,1.0
AAPL,2024-06-26,213.25,214.8600006103516,210.63999938964844,211.5,66213200.0,4.17999267578125,0.0,4.17999267578125,66.4715393108393,192.1499938964844,220.1999969482422,75.22282997467747,-24.77717002532254,6.578164170733828,6.77713024493932,0.0008447583873565367,1797132300.0,1.0
AAPL,2024-06-27,214.1000061035156,215.7400054931641,212.3500061035156,214.69000244140625,49772700.0,0.8500061035155966,0.0,0.8500061035155966,67.9518908454294,192.1499938964844,220.1999969482422,78.25315443470396,-21.746845565296038,6.565772096805432,6.734858615312543,-0.000653469875181445,1846905000.0,1.0
AAPL,2024-06-28,210.6199951171875,216.07000732421875,210.3000030517578,215.7700042724609,82542700.0,-3.4800109863280966,3.4800109863280966,0.0,56.22490388367787,192.1499938964844,220.1999969482422,65.84669950524534,-34.15330049475466,6.203631879327588,6.628613268115552,-0.008800462740054638,1764362300.0,-1.0
AAPL,2024-07-01,216.75,217.50999450683597,211.9199981689453,212.08999633789065,60402900.0,6.1300048828125,0.0,6.1300048828125,67.59230434803715,193.6300048828125,220.1999969482422,87.0154385453092,-12.984561454690802,6.338210367632541,6.570532688018951,0.00036923354285667287,1824765200.0,1.0
AAPL,2024-07-02,220.2700042724609,220.3800048828125,215.1000061035156,216.1499938964844,58046200.0,3.520004272460909,0.0,3.520004272460909,72.34965238155877,206.58999633789065,220.3800048828125,99.20231659035412,-0.797683409645881,6.65221709823723,6.586869570062609,0.027906160687322545,1882811400.0,1.0
AAPL,2024-07-03,221.5500030517578,221.5500030517578,219.02999877929688,220.0,37369800.0,1.2799987792969034,0.0,1.2799987792969034,73.95390815846302,206.58999633789065,221.5500030517578,100.0,-0.0,6.9245331903843805,6.654402294126964,0.056610123953650726,1920181200.0,1.0
AAPL,2024-07-05,226.33999633789065,226.4499969482422,221.6499938964844,221.6499938964844,60412400.0,4.789993286132841,0.0,4.789993286132841,79.17182823582564,206.58999633789065,226.4499969482422,99.44611980377182,-0.5538801962281863,7.441081921411836,6.8117382195839395,0.09084770516981644,1980593600.0,1.0
AAPL,2024-07-08,227.82000732421875,227.8500061035156,223.25,227.08999633789065,59085900.0,1.4800109863280966,0.0,1.4800109863280966,80.56025614408391,206.58999633789065,227.8500061035156,99.85889574074726,-0.1411042592527462,7.879050243246866,7.0252006243165255,0.09455178241702766,2039679500.0,1.0
AAPL,2024-07-09,228.67999267578125,229.3999938964844,226.3699951171875,227.92999267578125,48076100.0,0.8599853515625,0.0,0.8599853515625,81.39191989463143,206.58999633789065,229.3999938964844,96.843484008038,-3.1565159919619994,8.201000891040024,7.260360677661225,0.09379626280469777,2087755600.0,1.0
AAPL,2024-07-10,232.97999572753903,233.0800018310547,229.25,229.3000030517578,62627700.0,4.300003051757784,0.0,4.300003051757784,85.0755851884854,206.58999633789065,233.0800018310547,99.62247609370462,-0.37752390629537935,8.702802913912308,7.548849124911442,0.09252049579150778,2150383300.0,1.0
AAPL,2024-07-11,227.57000732421875,232.38999938964844,225.7700042724609,231.38999938964844,64710600.0,-5.409988403320284,5.409988403320284,0.0,66.0843675604543,206.58999633789065,233.0800018310547,79.19972304929179,-20.80027695070821,8.565209379272034,7.75212117578356,0.06291452983046875,2085672700.0,-1.0
AAPL,2024-07-12,230.5399932861328,232.63999938964844,228.67999267578125,228.9199981689453,53046500.0,2.9699859619140625,0.0,2.9699859619140625,70.28597369195603,206.58999633789065,233.0800018310547,90.41144575988349,-9.588554240116505,8.596720910298927,7.921041122686634,0.09457790632775365,2138719200.0,1.0
AAPL,2024-07-15,234.3999938964844,237.22999572753903,233.08999633789065,236.47999572753903,62631300.0,3.860000610351591,0.0,3.860000610351591,74.9413425869846,208.6100006103516,237.22999572753903,90.11180183830604,-9.888198161693964,8.831361378905882,8.103105173930484,0.08143019098724058,2201350500.0,1.0
AAPL,2024-07-16,234.82000732421875,236.2700042724609,232.3300018310547,235.0,43234300.0,0.4200134277343466,0.0,0.4200134277343466,75.42475103030787,210.3000030517578,237.22999572753903,91.05091326115495,-8.949086738845063,8.948059553629093,8.272096049870205,0.06605530834675233,2244584800.0,1.0
AAPL,2024-07-17,228.8800048828125,231.4600067138672,226.63999938964844,229.4499969482422,57345900.0,-5.94000244140625,5.94000244140625,0.0,57.36616931893775,210.3000030517578,237.22999572753903,68.99371290124458,-31.006287098755426,8.463671210252983,8.31041108194676,0.03308509018319561,2187238900.0,-1.0
AAPL,2024-07-18,224.17999267578125,230.44000244140625,222.2700042724609,230.27999877929688,66034600.0,-4.70001220703125,4.70001220703125,0.0,47.07586280796039,210.3000030517578,237.22999572753903,51.54100779428001,-48.45899220571998,7.6127828311466885,8.170885431786747,-0.009543181483863128,2121204300.0,-1.0
AAPL,2024-07-19,224.30999755859372,226.8000030517578,223.27999877929688,224.82000732421875,49151500.0,0.13000488281247158,0.0,0.13000488281247158,47.37713257713582,211.9199981689453,237.22999572753903,48.95298532117608,-51.04701467882392,6.869747791659279,7.910657903761253,-0.015406942554565983,2170355800.0,1.0
AAPL,2024-07-22,223.9600067138672,227.77999877929688,223.08999633789065,227.00999450683597,48201800.0,-0.3499908447265341,0.3499908447265341,0.0,46.553936849387924,215.1000061035156,237.22999572753903,40.036171552170664,-59.963828447829336,6.181390610240442,7.564804445057092,-0.020640135180544528,2122154000.0,-1.0
AAPL,2024-07-23,225.00999450683597,226.94000244140625,222.67999267578125,224.3699951171875,39960300.0,1.0499877929687784,0.0,1.0499877929687784,49.586149646874524,219.02999877929688,237.22999572753903,32.857124891532834,-67.14287510846717,5.6553959403600516,7.1829227441176835,-0.03420895084067077,2162114300.0,1.0
AAPL,2024-07-24,218.5399932861328,224.8000030517578,217.1300048828125,224.0,61777600.0,-6.470001220703153,6.470001220703153,0.0,35.33342926803627,217.1300048828125,237.22999572753903,7.014870873387682,-92.98512912661232,4.662717444182732,6.678881684130693,-0.03968015884105891,2100336700.0,-1.0
AAPL,2024-07-25,217.4900054931641,220.8500061035156,214.6199951171875,218.92999267578125,51391200.0,-1.0499877929687216,1.0499877929687216,0.0,33.528818981976684,214.6199951171875,237.22999572753903,12.693544000448254,-87.30645599955174,3.748081790539942,6.092721705412543,-0.056606177552767756,2048945500.0,-1.0
AAPL,2024-07-26,217.9600067138672,219.4900054931641,216.00999450683597,218.6999969482422,41601300.0,0.4700012207030966,0.0,0.4700012207030966,35.23720445018661,214.6199951171875,237.22999572753903,14.772275570618651,-85.22772442938134,3.026266697280022,5.479430703786039,-0.07013646591593958,2090546800.0,1.0
AAPL,2024-07-29,218.2400054931641,219.3000030517578,215.75,216.9600067138672,36311800.0,0.2799987792969034,0.0,0.2799987792969034,36.36149230527277,214.6199951171875,237.22999572753903,16.010660231115793,-83.98933976888421,2.4485907667521474,4.873262716379261,-0.07060727925181631,2126858600.0,1.0
AAPL,2024-07-30,218.8000030517578,220.3300018310547,216.1199951171875,219.19000244140625,41643800.0,0.5599975585937216,0.0,0.5599975585937216,38.81275976403414,214.6199951171875,237.22999572753903,18.487429552109695,-81.5125704478903,2.0127636661209465,4.3011629063275985,-0.044040552324418614,2168502400.0,1.0
AAPL,2024-07-31,222.0800018310547,223.82000732421875,220.6300048828125,221.44000244140625,50036300.0,3.279998779296875,0.0,3.279998779296875,51.450996547157054,214.6199951171875,237.22999572753903,32.99427913527686,-67.00572086472314,1.9100185335917672,3.822934031780432,-0.009367432033792866,2218538700.0,1.0
AAPL,2024-08-01,218.3600006103516,224.47999572753903,217.0200042724609,224.3699951171875,62501000.0,-3.7200012207030966,3.7200012207030966,0.0,40.50308990225911,214.6199951171875,237.22999572753903,16.541377232213804,-83.4586227677862,1.511001383279563,3.360547502080258,-0.026525776884678942,2156037700.0,-1.0
AAPL,2024-08-02,219.8600006103516,225.6000061035156,217.7100067138672,219.1499938964844,105568600.0,1.5,0.0,1.5,45.86266376912512,214.6199951171875,236.2700042724609,24.203248393951622,-75.79675160604837,1.3008198394933004,2.9486019695628665,-0.018306867211134725,2261606300.0,1.0
AAPL,2024-08-05,209.2700042724609,213.5,196.0,199.08999633789065,119548600.0,-10.589996337890682,10.589996337890682,0.0,26.451834143572896,196.0,231.4600067138672,37.422452791785474,-62.577547208214526,0.2765374994359604,2.4141890755374855,-0.06995240486482868,2142057700.0,-1.0
AAPL,2024-08-06,207.22999572753903,209.9900054931641,201.07000732421875,205.3000030517578,69660500.0,-2.040008544921875,2.040008544921875,0.0,24.17737542053449,196.0,230.44000244140625,32.607418500172706,-67.39258149982729,-0.691850058317101,1.7929812487665682,-0.05175252999932911,2072397200.0,-1.0
AAPL,2024-08-07,209.82000732421875,213.63999938964844,206.38999938964844,206.8999938964844,63516400.0,2.590011596679716,0.0,2.590011596679716,32.659700996631116,196.0,227.77999877929688,43.486494194649914,-56.513505805350086,-1.2360633159860583,1.1871723358160426,-0.035265979931139446,2135913600.0,1.0
AAPL,2024-08-08,213.30999755859372,214.1999969482422,208.8300018310547,213.1100006103516,47161100.0,3.4899902343749716,0.0,3.4899902343749716,42.637105738533805,196.0,227.77999877929688,54.468213415635326,-45.53178658436468,-1.3699512534005862,0.6757476179727168,-0.02133423110680066,2183074700.0,1.0
AAPL,2024-08-09,216.2400054931641,216.77999877929688,211.97000122070312,212.1000061035156,42201600.0,2.9300079345703693,0.0,2.9300079345703693,49.83689017288902,196.0,226.94000244140625,65.41694859751331,-34.58305140248669,-1.2255044032793307,0.2954972137223072,-0.009164222643234132,2225276300.0,1.0
AAPL,2024-08-12,217.52999877929688,219.50999450683597,215.6000061035156,216.07000732421875,38028100.0,1.289993286132784,0.0,1.289993286132784,52.843626840727154,196.0,225.6000061035156,72.7364673642407,-27.263532635759308,-0.9954624847374873,0.037305274030348216,-0.0058044070143843385,2263304400.0,1.0
AAPL,2024-08-13,221.2700042724609,221.88999938964844,219.00999450683597,219.00999450683597,44155300.0,3.740005493164034,0.0,3.740005493164034,60.719831317339775,196.0,225.6000061035156,85.37161845199616,-14.628381548003846,-0.5055378940065793,-0.07126335957703733,-0.003647323270512093,2307459700.0,1.0
AAPL,2024-08-14,221.72000122070312,223.02999877929688,219.6999969482422,220.57000732421875,41960600.0,0.4499969482422159,0.0,0.4499969482422159,61.61001527065147,196.0,225.6000061035156,86.8918780987966,-13.1081219012034,-0.0800355333860523,-0.07301779433884033,0.015387436348048178,2349420300.0,1.0
AAPL,2024-08-15,224.72000122070312,225.3500061035156,222.75999450683597,224.6000061035156,46414000.0,3.0,0.0,3.0,67.30896337587367,196.0,225.6000061035156,97.02701114406881,-2.972988855931193,0.4935635871387092,0.04029848195666961,0.022104978608476822,2395834300.0,1.0
AAPL,2024-08-16,226.0500030517578,226.8300018310547,223.6499938964844,223.9199981689453,44340200.0,1.3300018310546875,0.0,1.3300018310546875,69.61622767872646,196.0,226.8300018310547,97.47000086613296,-2.5299991338670362,1.0434369633930771,0.24092617824395116,0.08018348753627413,2440174500.0,1.0
AAPL,2024-08-19,225.88999938964844,225.9900054931641,223.0399932861328,225.72000122070312,40687800.0,-0.160003662109375,0.160003662109375,0.0,68.94081276731872,196.0,226.8300018310547,96.95101399423403,-3.0489860057659706,1.4495945932429777,0.4826598612437566,0.09004489720032183,2399486700.0,-1.0
AAPL,2024-08-20,226.50999450683597,227.1699981689453,225.4499969482422,225.7700042724609,30299000.0,0.6199951171875284,0.0,0.6199951171875284,70.23207649718721,196.0,227.1699981689453,97.88256753005872,-2.1174324699412677,1.8007479639466908,0.7462774817843436,0.07954430750175057,2429785700.0,1.0
AAPL,2024-08-21,226.3999938964844,227.97999572753903,225.0500030517578,226.5200042724609,34765500.0,-0.1100006103515625,0.1100006103515625,0.0,69.63937711305906,196.0,227.97999572753903,95.05940574690558,-4.940594253094408,2.046571804396507,1.0063363463067765,0.0613660704500969,2395020200.0,-1.0
AAPL,2024-08-22,224.52999877929688,228.33999633789065,223.8999938964844,227.7899932861328,43695300.0,-1.8699951171875284,1.8699951171875284,0.0,59.74880380490016,196.0,228.33999633789065,88.21893014833198,-11.781069851668024,2.066672675122618,1.2184036120699449,0.03833700090427916,2351324900.0,-1.0
AAPL,2024-08-23,226.83999633789065,228.22000122070312,224.3300018310547,225.66000366210935,38677300.0,2.3099975585937784,0.0,2.3099975585937784,66.52526156581645,201.07000732421875,228.33999633789065,94.49944772897426,-5.500552271025741,2.2431427047232546,1.423351430600607,0.04279868344981508,2390002200.0,1.0
AAPL,2024-08-26,227.17999267578125,227.27999877929688,223.88999938964844,226.75999450683597,30602200.0,0.3399963378905966,0.0,0.3399963378905966,67.45574553730299,206.38999938964844,228.33999633789065,94.71524454037659,-5.284755459623415,2.382962034587109,1.6152735513979077,0.026709397067860463,2420604400.0,1.0
AAPL,2024-08-27,228.02999877929688,228.8500061035156,224.88999938964844,226.0,35934600.0,0.850006103515625,0.0,0.850006103515625,69.87156249326927,208.8300018310547,228.8500061035156,95.90406019369982,-4.095939806300172,2.5331575857912583,1.798850358276578,0.028459306890913805,2456539000.0,1.0
AAPL,2024-08-28,226.4900054931641,229.8600006103516,225.67999267578125,227.9199981689453,38052200.0,-1.539993286132784,1.539993286132784,0.0,60.48545843304391,211.97000122070312,229.8600006103516,81.16268735516307,-18.837312644836928,2.4991158029600626,1.938903447213275,0.007876487463715387,2418486800.0,-1.0
AAPL,2024-08-29,229.7899932861328,232.9199981689453,228.8800048828125,230.1000061035156,51906300.0,3.2999877929687216,0.0,3.2999877929687216,70.33763347380476,215.6000061035156,232.9199981689453,81.92836999585056,-18.071630004149448,2.7072118277826007,2.09256512332714,0.01654496874091471,2470393100.0,1.0
AAPL,2024-08-30,229.0,230.3999938964844,227.47999572753903,230.19000244140625,52958500.0,-0.7899932861328125,0.7899932861328125,0.0,65.805562026037,219.00999450683597,232.9199981689453,71.81885595312004,-28.181144046879957,2.776379199587012,2.2293279385791145,0.013767765809707067,2417434600.0,-1.0
AAPL,2024-09-03,222.27200317382807,229.0,221.7700042724609,228.6100006103516,31994451.0,-6.727996826171932,6.727996826171932,0.0,40.293186679106086,219.6999969482422,232.9199981689453,19.455415946240624,-80.54458405375938,2.2622242118805787,2.2359071932394072,-0.018709952919450545,2385440149.0,-1.0
