symbol,datetime,close,high,low,open,volume,change_in_price,down_days,up_days,RSI,low_14,high_14,k_percent,r_percent,MACD,MACD_EMA,Price_Rate_Of_Change,On Balance Volume,Prediction
AMZN,2020-01-22,94.3730010986328,95.125,94.16699981689452,94.80449676513672,64326000.0,-0.22699737548829546,0.22699737548829546,0.0,51.600606320671936,92.75450134277344,95.89099884033205,51.60213764299737,-48.39786235700264,-0.0778555396262135,-0.08514824643231247,-0.002383779940907549,-65102000.0,-1.0
AMZN,2020-01-23,94.22899627685548,94.4990005493164,93.63800048828124,94.25550079345705,49692000.0,-0.14400482177731533,0.14400482177731533,0.0,49.78720450066435,92.75450134277344,95.89099884033205,47.01087551416079,-52.98912448583921,-0.06343332699108828,-0.0806468849673791,-0.008663650145147028,-114794000.0,-1.0
AMZN,2020-01-24,93.08200073242188,94.74949645996094,92.37200164794922,94.56849670410156,75324000.0,-1.146995544433608,1.146995544433608,0.0,37.63270072472335,92.37200164794922,95.89099884033205,20.17617649737006,-79.82382350262995,-0.12125745417705502,-0.08900423736650495,-0.011427562519461865,-190118000.0,-1.0
AMZN,2020-01-27,91.41699981689452,92.0500030517578,90.76699829101562,91.0,70570000.0,-1.665000915527358,1.665000915527358,0.0,26.710642661799227,90.76699829101562,95.89099884033205,12.685430448784926,-87.31456955121507,-0.26688945168284306,-0.12540085929453568,-0.033289298823444335,-260688000.0,-1.0
AMZN,2020-01-28,92.6624984741211,92.90550231933594,91.5009994506836,92.0250015258789,56160000.0,1.2454986572265767,0.0,1.2454986572265767,41.39217517506821,90.76699829101562,95.89099884033205,36.99258352652485,-63.00741647347515,-0.29661510644361044,-0.16027188935631975,-0.008660365102833523,-204528000.0,1.0
AMZN,2020-01-29,92.9000015258789,93.7375030517578,92.7509994506836,93.1999969482422,41760000.0,0.2375030517578125,0.0,0.2375030517578125,43.86633479886505,90.76699829101562,95.89099884033205,41.627693329342826,-58.37230667065717,-0.30061622348317485,-0.18875118610237332,-0.002158907030063273,-162768000.0,1.0
AMZN,2020-01-30,93.53399658203124,93.64350128173828,92.53050231933594,92.9000015258789,126548000.0,0.6339950561523295,0.0,0.6339950561523295,50.325418502489924,90.76699829101562,95.34700012207033,60.41478569405757,-39.58521430594243,-0.25874590343958914,-0.20291340888177048,-0.0038660082806356577,-36220000.0,1.0
AMZN,2020-01-31,100.43599700927734,102.78600311279295,100.1135025024414,102.57350158691406,311346000.0,6.902000427246108,0.0,6.902000427246108,79.68642369068357,90.76699829101562,102.78600311279295,80.44758165619822,-19.55241834380178,0.2333368055474807,-0.11485113488039411,0.0772233573247334,275126000.0,1.0
AMZN,2020-02-03,100.20999908447266,102.4250030517578,100.0124969482422,100.52999877929688,117834000.0,-0.2259979248046875,0.2259979248046875,0.0,77.94579252097638,90.76699829101562,102.78600311279295,78.56724357367078,-21.43275642632921,0.596373090522107,0.02845109401676933,0.059302332989849216,157292000.0,-1.0
AMZN,2020-02-04,102.4834976196289,102.98999786376952,100.76850128173828,101.49400329589844,105786000.0,2.27349853515625,0.0,2.27349853515625,82.4065741957769,90.76699829101562,102.98999786376952,95.8561706467728,-4.143829353227198,1.025311673838658,0.2290070835849917,0.08594085624679382,263078000.0,1.0
AMZN,2020-02-05,101.99349975585938,103.5510025024414,101.5999984741211,103.5510025024414,87524000.0,-0.48999786376953125,0.48999786376953125,0.0,78.46004361933711,90.76699829101562,103.5510025024414,87.81678478179784,-12.183215218202163,1.312670970683044,0.44676820884379626,0.08240036279481222,175554000.0,-1.0
AMZN,2020-02-06,102.5114974975586,102.81500244140624,101.23999786376952,102.0510025024414,63660000.0,0.5179977416992188,0.0,0.5179977416992188,79.64888368965018,90.76699829101562,103.5510025024414,91.86870570682582,-8.13129429317419,1.5567009202189013,0.6695965728770117,0.10130311650953039,239214000.0,1.0
AMZN,2020-02-07,103.96399688720705,104.92649841308594,101.90499877929688,102.09950256347656,101906000.0,1.4524993896484517,0.0,1.4524993896484517,82.73240207214447,90.76699829101562,104.92649841308594,93.20243287135082,-6.79756712864918,1.8304120244405482,0.9024634601711768,0.13725015145370967,341120000.0,1.0
AMZN,2020-02-10,106.69550323486328,106.77999877929688,104.2480010986328,104.25050354003906,101124000.0,2.731506347656236,0.0,2.731506347656236,87.00482768766895,90.76699829101562,106.77999877929688,99.4723315939731,-0.5276684060269022,2.215897741734338,1.16578699372105,0.1514421151147931,442244000.0,1.0
AMZN,2020-02-11,107.54000091552734,109.29750061035156,106.8000030517578,107.54499816894533,114920000.0,0.8444976806640625,0.0,0.8444976806640625,88.0588122797198,90.76699829101562,109.29750061035156,90.51563921723628,-9.484360782763718,2.5510308633245984,1.4433726964789113,0.15758879600847164,557164000.0,1.0
AMZN,2020-02-12,108.0,109.0124969482422,107.7645034790039,108.16000366210938,66686000.0,0.45999908447265625,0.0,0.45999908447265625,88.63799247760323,90.76699829101562,109.29750061035156,92.99802785703405,-7.001972142965955,2.8160056608590054,1.718324757060778,0.15466037961161838,623850000.0,1.0
AMZN,2020-02-13,107.49349975585938,108.51399993896484,107.0999984741211,107.24949645996094,60636000.0,-0.506500244140625,0.506500244140625,0.0,83.49297656962592,90.76699829101562,109.29750061035156,90.26469534714245,-9.735304652857549,2.953390727087452,1.9656441176050208,0.07026865821753248,563214000.0,-1.0
AMZN,2020-02-14,106.74349975585938,107.9520034790039,106.29450225830078,107.78399658203124,52124000.0,-0.75,0.75,0.0,75.95976863903235,91.5009994506836,109.29750061035156,85.64885967428084,-14.351140325719157,2.9716213285468456,2.1670390116358083,0.06519809131900356,511090000.0,-1.0
AMZN,2020-02-18,107.78350067138672,108.30349731445312,106.20549774169922,106.2509994506836,58912000.0,1.0400009155273438,0.0,1.0400009155273438,78.99244389516814,92.53050231933594,109.29750061035156,90.9703578858471,-9.029642114152898,3.028044335943619,2.339376616414958,0.051715673009414154,570002000.0,1.0
AMZN,2020-02-19,108.51100158691406,109.25499725341795,108.05599975585938,108.38999938964844,51224000.0,0.7275009155273438,0.0,0.7275009155273438,80.93377538528856,92.53050231933594,109.29750061035156,95.30924373112785,-4.69075626887214,3.091037130141899,2.489804063882383,0.06390114906004363,621226000.0,1.0
AMZN,2020-02-20,107.65499877929688,108.8395004272461,106.37249755859376,108.65350341796876,62626000.0,-0.8560028076171875,0.8560028076171875,0.0,71.91157406028964,100.0124969482422,109.29750061035156,82.31016496248161,-17.689835037518392,3.0408837613896367,2.600075917856585,0.05017487215871341,558600000.0,-1.0
AMZN,2020-02-21,104.79850006103516,107.22750091552734,104.4000015258789,107.10749816894533,92926000.0,-2.8564987182617188,2.8564987182617188,0.0,50.3149276526073,100.0124969482422,109.29750061035156,51.54551669509707,-48.454483304902936,2.7528212189895385,2.630637375283128,0.008026847743584531,465674000.0,-1.0
AMZN,2020-02-24,100.4645004272461,101.96499633789062,99.39849853515624,100.15899658203124,130940000.0,-4.3339996337890625,4.3339996337890625,0.0,32.97688947368022,99.39849853515624,109.29750061035156,10.768781378084755,-89.23121862191525,2.1698787556999264,2.5384557367144653,-0.05839986333726932,334734000.0,-1.0
AMZN,2020-02-25,98.63700103759766,101.7300033569336,97.9209976196289,101.3209991455078,124382000.0,-1.8274993896484375,1.8274993896484375,0.0,28.2419534788674,97.9209976196289,109.29750061035156,6.293703948855272,-93.70629605114473,1.5508067762800266,2.340874649644693,-0.08278779804849534,210352000.0,-1.0
AMZN,2020-02-26,98.97949981689452,100.7334976196289,98.02249908447266,98.51399993896484,104492000.0,0.3424987792968608,0.0,0.3424987792968608,30.402905997127363,97.9209976196289,109.29750061035156,9.304284437219428,-90.69571556278058,1.0745321663885505,2.0875535402574457,-0.08352314984356923,314844000.0,1.0
AMZN,2020-02-27,94.21499633789062,98.75,94.13800048828124,96.71900177001952,162880000.0,-4.764503479003892,4.764503479003892,0.0,20.495812160975376,94.13800048828124,109.29750061035156,0.5079049374279362,-99.49209506257206,0.3267531854276058,1.7353349469396184,-0.12352843146913128,151964000.0,-1.0
AMZN,2020-02-28,94.1875,94.48799896240234,90.55650329589844,90.73149871826172,189620000.0,-0.027496337890625,0.027496337890625,0.0,20.451434942339077,90.55650329589844,109.29750061035156,19.374618347025347,-80.62538165297465,-0.26439164839695195,1.335336458953454,-0.11762776922788831,-37656000.0,-1.0
AMZN,2020-03-02,97.69750213623048,97.72550201416016,93.5,95.32450103759766,135234000.0,3.510002136230483,0.0,3.510002136230483,39.68637408077683,90.55650329589844,109.29750061035156,38.10362234471311,-61.896377655286884,-0.4551049458119678,0.9772100954733004,-0.09357646088993443,97578000.0,1.0
AMZN,2020-03-03,95.44950103759766,99.81649780273438,94.40450286865234,98.76850128173828,150690000.0,-2.2480010986328267,2.2480010986328267,0.0,33.66995538062602,90.55650329589844,109.25499725341795,26.16787080721825,-73.83212919278175,-0.7719870002050726,0.6273409127592242,-0.12037028834218744,-53112000.0,-1.0
AMZN,2020-03-04,98.79149627685548,98.9000015258789,96.0999984741211,97.32849884033205,95458000.0,3.3419952392578267,0.0,3.3419952392578267,47.35912099837999,90.55650329589844,109.25499725341795,44.04094254684816,-55.95905745315184,-0.7536378606501017,0.35112635988899327,-0.08233247506334962,42346000.0,1.0
AMZN,2020-03-05,96.20149993896484,98.03600311279295,95.5,96.6500015258789,94964000.0,-2.589996337890639,2.589996337890639,0.0,39.98077342898772,90.55650329589844,109.25499725341795,30.189579202961937,-69.81042079703806,-0.9307846204024912,0.09473020429618528,-0.08203361801040454,-52618000.0,-1.0
AMZN,2020-03-06,95.05449676513672,95.5435028076172,93.4749984741211,93.75,105472000.0,-1.147003173828125,1.147003173828125,0.0,37.03259981575638,90.55650329589844,109.25499725341795,24.05537836072318,-75.94462163927682,-1.1476867501850876,-0.1537640100495955,-0.05384990358885189,-158090000.0,-1.0
AMZN,2020-03-09,90.03050231933594,93.13849639892578,88.06449890136719,88.69300079345703,156264000.0,-5.023994445800781,5.023994445800781,0.0,26.978349762858485,88.06449890136719,109.25499725341795,9.27775923579676,-90.72224076420325,-1.6944154116389285,-0.4619050275148303,-0.08725426186650953,-314354000.0,-1.0
AMZN,2020-03-10,94.59100341796876,94.7135009765625,90.90850067138672,93.54399871826172,142666000.0,4.560501098632827,0.0,4.560501098632827,43.14573683901427,88.06449890136719,108.8395004272461,31.415181888057486,-68.58481811194251,-1.7484334214118462,-0.7192178791296587,-0.04433742751826564,-171688000.0,1.0
AMZN,2020-03-11,91.04299926757812,93.56600189208984,90.0749969482422,92.89250183105467,112496000.0,-3.548004150390639,3.548004150390639,0.0,35.99226555037079,88.06449890136719,107.22750091552734,15.542973715757208,-84.45702628424279,-2.0472468313591037,-0.9848295929146985,-0.03366764521155974,-284184000.0,-1.0
AMZN,2020-03-12,83.83049774169922,88.25,83.75,86.0989990234375,226924000.0,-7.212501525878906,7.212501525878906,0.0,25.914379087387942,83.75,101.96499633789062,0.44193114401987704,-99.55806885598012,-2.820936007045333,-1.352057427304317,-0.10996153691626576,-511108000.0,-1.0
AMZN,2020-03-13,89.25,89.31549835205078,84.03099822998047,87.75,176194000.0,5.419502258300781,0.0,5.419502258300781,40.38634194802486,83.75,101.7300033569336,30.58953822652678,-69.41046177347322,-2.9708756986477454,-1.6758257025482406,-0.08646589678875505,-334914000.0,1.0
AMZN,2020-03-16,84.4574966430664,87.97250366210938,81.30149841308594,82.07550048828125,178346000.0,-4.792503356933594,4.792503356933594,0.0,33.674449999918565,81.30149841308594,100.7334976196289,16.24124309822846,-83.75875690177153,-3.429663643447256,-2.0265972958316216,-0.1151604175510722,-513260000.0,-1.0
AMZN,2020-03-17,90.39199829101562,92.88899993896484,84.46199798583984,88.77349853515625,218342000.0,5.934501647949219,0.0,5.934501647949219,46.40161981836536,81.30149841308594,99.81649780273438,49.09802958466259,-50.901970415337416,-3.284446831961148,-2.278169501014963,-0.08502247969097376,-294918000.0,1.0
AMZN,2020-03-18,91.5,92.08300018310548,87.25,87.5,192904000.0,1.108001708984375,0.0,1.108001708984375,48.5293413426352,81.30149841308594,99.81649780273438,55.082376036241996,-44.91762396375801,-3.04617787075361,-2.431772297416384,-0.048871378740952265,-102014000.0,1.0
AMZN,2020-03-19,94.04650115966795,97.25,91.63249969482422,93.0,207998000.0,2.5465011596679545,0.0,2.5465011596679545,53.43169775114105,81.30149841308594,99.81649780273438,68.83609595854283,-31.163904041457176,-2.6245625948620273,-2.470330582317499,-0.010604396843626906,105984000.0,1.0
AMZN,2020-03-20,92.30449676513672,97.8499984741211,91.0364990234375,96.31549835205078,196358000.0,-1.7420043945312358,1.7420043945312358,0.0,49.695614893020156,81.30149841308594,99.81649780273438,59.42748428175728,-40.57251571824272,-2.401421536879141,-2.4565487087746884,0.02525804463175141,-90374000.0,-1.0
AMZN,2020-03-23,95.1415023803711,95.97000122070312,90.5999984741211,91.3874969482422,156170000.0,2.837005615234375,0.0,2.837005615234375,55.537705073008055,81.30149841308594,98.9000015258789,78.64307480347219,-21.35692519652781,-1.9757176367749167,-2.3603821345728635,0.005819781401089852,65796000.0,1.0
AMZN,2020-03-24,97.00499725341795,97.75,95.01699829101562,97.5749969482422,142942000.0,1.8634948730468608,0.0,1.8634948730468608,59.134648172203434,81.30149841308594,98.03600311279295,93.8390416813887,-6.160958318611309,-1.4727521629920375,-2.1828556088922277,0.06548551820351767,208738000.0,1.0
AMZN,2020-03-25,94.29199981689452,97.51300048828124,94.28900146484376,96.03450012207033,129582000.0,-2.7129974365234375,2.7129974365234375,0.0,52.059855191820944,81.30149841308594,97.8499984741211,78.4995700872964,-21.500429912703602,-1.2760458615814656,-2.0014932251534434,0.12479351020233187,79156000.0,-1.0
AMZN,2020-03-26,97.77449798583984,97.82450103759766,94.4645004272461,95.0999984741211,124426000.0,3.4824981689453267,0.0,3.4824981689453267,59.27608932001966,81.30149841308594,97.8499984741211,99.54376234702369,-0.45623765297630986,-0.8323353061099823,-1.767661193411569,0.09551258247439609,203582000.0,1.0
AMZN,2020-03-27,95.00499725341795,96.989501953125,94.99600219726562,96.54299926757812,107758000.0,-2.769500732421889,2.769500732421889,0.0,52.08226786241829,81.30149841308594,97.8499984741211,82.80810218321881,-17.191897816781204,-0.694146922990825,-1.5529580102957494,0.12488530952944665,95824000.0,-1.0
AMZN,2020-03-30,98.19750213623048,98.68150329589844,95.61699676513672,96.1415023803711,122522000.0,3.1925048828125284,0.0,3.1925048828125284,58.74212561224772,81.30149841308594,98.68150329589844,97.21518398336818,-2.7848160166318183,-0.32546270652009923,-1.3074586485592778,0.08635171246115347,218346000.0,1.0
AMZN,2020-03-31,97.48600006103516,99.6510009765625,97.20050048828124,98.21749877929688,102472000.0,-0.7115020751953267,0.7115020751953267,0.0,56.71509697536054,81.30149841308594,99.6510009765625,88.20131004621003,-11.798689953789978,-0.08923741511014782,-1.0638141629036355,0.06542076569437327,115874000.0,-1.0
AMZN,2020-04-01,95.38500213623048,97.2480010986328,94.6500015258789,96.64849853515624,82438000.0,-2.1009979248046733,2.1009979248046733,0.0,50.748449693530354,81.30149841308594,99.6510009765625,76.7514196879473,-23.248580312052695,-0.06954129942694465,-0.864959434179377,0.014232331453671865,33436000.0,-1.0
AMZN,2020-04-02,95.94149780273438,96.37650299072266,94.5,95.08200073242188,86720000.0,0.556495666503892,0.0,0.556495666503892,52.282684254225344,81.30149841308594,99.6510009765625,79.78417583258285,-20.215824167417153,-0.009224622755183987,-0.6938123644637817,0.039402208614514045,120156000.0,1.0
AMZN,2020-04-03,95.32949829101562,96.31649780273438,94.4574966430664,95.55750274658205,72198000.0,-0.61199951171875,0.61199951171875,0.0,50.294619267955426,84.46199798583984,99.6510009765625,71.5484769593737,-28.451523040626302,-0.010382343743756905,-0.557126291680386,0.0019759611309577707,47958000.0,-1.0
AMZN,2020-04-06,99.87950134277344,99.9260025024414,96.5009994506836,96.8000030517578,115464000.0,4.5500030517578125,0.0,4.5500030517578125,62.520390739218826,87.25,99.9260025024414,99.6331559601774,-0.36684403982259073,0.34969303723671885,-0.3757623530368118,0.029632536165596468,163422000.0,1.0
AMZN,2020-04-07,100.58000183105467,101.78600311279295,99.88099670410156,100.85549926757812,102280000.0,0.7005004882812358,0.0,0.7005004882812358,64.08945083153272,90.5999984741211,101.78600311279295,89.21865920233095,-10.781340797669046,0.6833752964457744,-0.16393475506152944,0.0666864848170663,265702000.0,1.0
AMZN,2020-04-08,102.1500015258789,102.1999969482422,100.55750274658205,101.0500030517578,79546000.0,1.569999694824233,0.0,1.569999694824233,67.59747377613559,90.5999984741211,102.1999969482422,99.56900492293312,-0.43099507706688245,1.0616167652676154,0.08117561202464733,0.04475096911950138,345248000.0,1.0
AMZN,2020-04-09,102.13800048828124,102.6500015258789,100.88300323486328,102.21499633789062,92930000.0,-0.01200103759767046,0.01200103759767046,0.0,67.53928168671948,90.5999984741211,102.6500015258789,95.75102980971461,-4.248970190285401,1.3448812610422323,0.33391679381401007,0.07508029515370218,252318000.0,-1.0
AMZN,2020-04-13,108.44349670410156,109.0,101.9000015258789,102.0,134334000.0,6.305496215820327,0.0,6.305496215820327,78.67083412605305,94.28900146484376,109.0,96.21709366248314,-3.7829063375168586,2.052326846378463,0.6775988608799415,0.10434068428397181,386652000.0,1.0
AMZN,2020-04-14,114.16600036621094,114.5999984741211,109.3105010986328,110.02349853515624,161744000.0,5.722503662109375,0.0,5.722503662109375,84.3063749437716,94.28900146484376,114.5999984741211,97.86323582386467,-2.1367641761353298,3.0378599809836118,1.1496511470418107,0.17110149451954726,548396000.0,1.0
AMZN,2020-04-15,115.38400268554688,116.6685028076172,112.25,112.88400268554688,137332000.0,1.2180023193359375,0.0,1.2180023193359375,85.262667040086,94.4574966430664,116.6685028076172,94.21683055439239,-5.783169445607621,3.872132221806922,1.694147419336983,0.20966609111937196,685728000.0,1.0
AMZN,2020-04-16,120.40950012207033,123.0500030517578,116.75,117.3000030517578,240764000.0,5.025497436523452,0.0,5.025497436523452,88.57658702852437,94.4574966430664,123.0500030517578,90.7650525912453,-9.234947408754715,4.881125511855558,2.331543091541177,0.2550304391708027,926492000.0,1.0
AMZN,2020-04-17,118.75,120.0,115.8010025024414,118.6165008544922,158600000.0,-1.6595001220703267,1.6595001220703267,0.0,81.5864261359402,94.4574966430664,123.0500030517578,84.96108389276881,-15.038916107231184,5.483992814216947,2.9620330785712716,0.24567948147054963,767892000.0,-1.0
AMZN,2020-04-20,119.68049621582033,122.2490005493164,119.30249786376952,119.49749755859376,115414000.0,0.9304962158203267,0.0,0.9304962158203267,82.48089528792622,94.4574966430664,123.0500030517578,88.21541984541366,-11.784580154586335,5.967794615354904,3.5631854183420675,0.19824883591571463,883306000.0,1.0
AMZN,2020-04-21,116.40599822998048,121.41549682617188,113.98300170898438,120.83049774169922,149534000.0,-3.2744979858398438,3.2744979858398438,0.0,68.89226283141466,94.4574966430664,123.0500030517578,76.76312553082893,-23.23687446917108,6.018275824550912,4.054203520764352,0.15734734649845117,733772000.0,-1.0
AMZN,2020-04-22,118.17449951171876,119.6999969482422,117.5500030517578,118.4499969482422,84244000.0,1.7685012817382812,0.0,1.7685012817382812,71.7886391005348,94.4574966430664,123.0500030517578,82.94831705080249,-17.051682949197506,6.12994064691749,4.469350960321191,0.15687222463506445,818016000.0,1.0
AMZN,2020-04-23,119.97250366210938,121.21099853515624,119.10399627685548,119.9990005493164,101332000.0,1.7980041503906108,0.0,1.7980041503906108,74.56658887227827,94.4574966430664,123.0500030517578,89.23669248977437,-10.763307510225625,6.29064303591835,4.8336093854966995,0.1746118299611159,919348000.0,1.0
AMZN,2020-04-24,120.51100158691406,121.02149963378906,119.0999984741211,120.8499984741211,76498000.0,0.5384979248046875,0.0,0.5384979248046875,75.40356629908747,96.5009994506836,123.0500030517578,90.43654706219934,-9.563452937800667,6.387698807638486,5.144427276789653,0.11127919376981943,995846000.0,1.0
AMZN,2020-04-27,118.8000030517578,122.24400329589844,118.1500015258789,122.16000366210938,112912000.0,-1.7109985351562642,1.7109985351562642,0.0,67.28564120736522,99.88099670410156,123.0500030517578,81.6565288289546,-18.343471171045397,6.254698998656437,5.3664816250863705,0.04059004143687561,882934000.0,-1.0
AMZN,2020-04-28,115.7040023803711,118.6750030517578,115.3000030517578,118.6050033569336,105388000.0,-3.0960006713867045,3.0960006713867045,0.0,54.937040965269375,100.55750274658205,123.0500030517578,67.34022197747257,-32.659778022527426,5.832675492545974,5.4597203998962,0.0027733454151033232,777546000.0,-1.0
AMZN,2020-04-29,118.635498046875,119.59449768066406,115.5,116.50050354003906,91832000.0,2.9314956665039062,0.0,2.9314956665039062,62.463420985510375,100.88300323486328,123.0500030517578,80.08523913318078,-19.914760866819222,5.66900707409178,5.50157773520863,-0.014733073996626933,869378000.0,1.0
AMZN,2020-04-30,123.6999969482422,123.75,119.80049896240234,120.99199676513672,190692000.0,5.064498901367202,0.0,5.064498901367202,71.83918694490458,101.9000015258789,123.75,99.77115306521864,-0.22884693478135193,5.879533333551521,5.577168855561025,0.04168418482730285,1060070000.0,1.0
AMZN,2020-05-01,114.302001953125,118.12200164794922,112.90950012207033,116.83999633789062,195452000.0,-9.397994995117202,9.397994995117202,0.0,46.80659754979207,109.3105010986328,123.75,34.56838002889132,-65.43161997110867,5.228840601851715,5.507503204314992,-0.04494044086344917,864618000.0,-1.0
AMZN,2020-05-04,115.79949951171876,116.3489990234375,112.81900024414062,112.81900024414062,97318000.0,1.4974975585937642,0.0,1.4974975585937642,50.00927098686819,112.25,123.75,30.86521314538056,-69.13478685461945,4.778745164313321,5.361751595470814,-0.005210201600294506,961936000.0,1.0
AMZN,2020-05-05,115.88999938964844,117.5500030517578,115.35649871826172,117.0,64850000.0,0.09049987792967329,0.0,0.09049987792967329,50.21827499079952,112.81900024414062,123.75,28.094403202796304,-71.9055967972037,4.378852849024682,5.165171845271092,-0.019331582799246627,1026786000.0,1.0
AMZN,2020-05-06,117.56300354003906,117.87249755859376,116.0,116.47200012207033,62356000.0,1.673004150390625,0.0,1.673004150390625,54.29426201957612,112.81900024414062,123.75,43.399537113295565,-56.60046288670443,4.14894661246035,4.96192679795585,-0.0200837696015449,1089142000.0,1.0
AMZN,2020-05-07,118.38050079345705,118.8000030517578,117.15550231933594,118.73899841308594,67928000.0,0.817497253417983,0.0,0.817497253417983,56.311100627366834,112.81900024414062,123.75,50.878242370605435,-49.121757629394565,3.986677661727626,4.7668769701320235,-0.017678890436575445,1157070000.0,1.0
AMZN,2020-05-08,118.98049926757812,119.36199951171876,117.8499984741211,118.60700225830078,64132000.0,0.5999984741210795,0.0,0.5999984741210795,57.88490223415796,112.81900024414062,123.75,56.36720483992998,-43.63279516007002,3.861922024134614,4.585885980503336,0.0015193283769672217,1221202000.0,1.0
AMZN,2020-05-11,120.4499969482422,120.9834976196289,118.60549926757812,118.73500061035156,65184000.0,1.4694976806640767,0.0,1.4694976806640767,61.7760775439538,112.81900024414062,123.75,69.81060172479752,-30.18939827520249,3.837281166626255,4.436165017443878,0.04101841310786192,1286386000.0,1.0
AMZN,2020-05-12,117.84750366210938,120.9499969482422,117.75,120.59249877929688,61498000.0,-2.6024932861328267,2.6024932861328267,0.0,51.9648892623341,112.81900024414062,123.75,46.00222788655088,-53.997772113449116,3.5668091127445365,4.262293836240124,-0.006642146724535003,1224888000.0,-1.0
AMZN,2020-05-13,118.39600372314452,120.38500213623048,116.88999938964844,118.33999633789062,95658000.0,0.548500061035142,0.0,0.548500061035142,53.75111964905821,112.81900024414062,123.75,51.02006772998449,-48.97993227001551,3.3579712107770234,4.081429310927905,-0.04287787676597077,1320546000.0,1.0
AMZN,2020-05-14,119.44249725341795,119.56849670410156,117.6604995727539,118.05049896240234,72962000.0,1.0464935302734375,0.0,1.0464935302734375,57.250696197579316,112.81900024414062,123.75,60.593698263755954,-39.406301736244046,3.239501896441226,3.9130438278670105,0.044972924467246544,1393508000.0,1.0
AMZN,2020-05-15,120.48899841308594,120.5500030517578,117.81849670410156,118.4260025024414,84700000.0,1.046501159667983,0.0,1.046501159667983,60.68343613075693,112.81900024414062,123.75,70.16739859347213,-29.832601406527875,3.193189088052989,3.769072879792331,0.040496711308260824,1478208000.0,1.0
AMZN,2020-05-18,121.31300354003906,121.6500015258789,119.20050048828124,120.21749877929688,87144000.0,0.824005126953125,0.0,0.824005126953125,63.356715558700785,112.81900024414062,123.75,77.70563979150555,-22.294360208494446,3.1862029520465143,3.652498894170699,0.04679441003496132,1565352000.0,1.0
AMZN,2020-05-19,122.46649932861328,124.25,121.44850158691406,121.4915008544922,86410000.0,1.1534957885742188,0.0,1.1534957885742188,66.9828386278942,112.81900024414062,124.25,84.39768428415441,-15.602315715845593,3.236380029099024,3.5692751211149747,0.041709514395863456,1651762000.0,1.0
AMZN,2020-05-20,124.89700317382812,125.00050354003906,123.3635025024414,123.89350128173828,79962000.0,2.4305038452148438,0.0,2.4305038452148438,73.38590560823374,112.81900024414062,125.00050354003906,99.15034816560132,-0.8496518343986863,3.4325904897893906,3.541938194838982,0.055047092525319474,1731724000.0,1.0
AMZN,2020-05-21,122.33699798583984,126.27249908447266,122.1269989013672,125.0,102288000.0,-2.5600051879882812,2.5600051879882812,0.0,59.38861578235898,112.81900024414062,126.27249908447266,70.74737846756535,-29.25262153243464,3.3430783066927177,3.5021662171970696,0.028210494483749127,1629436000.0,-1.0
AMZN,2020-05-22,121.84400177001952,123.49250030517578,121.50650024414062,122.75050354003906,57342000.0,-0.4929962158203267,0.4929962158203267,0.0,56.973943351636514,115.35649871826172,126.27249908447266,59.431136259751526,-40.56886374024847,3.1955381120765907,3.440840596157358,0.011573307240317465,1572094000.0,-1.0
AMZN,2020-05-26,121.09300231933594,123.0999984741211,120.7030029296875,122.9000015258789,71364000.0,-0.7509994506835795,0.7509994506835795,0.0,53.17382711986961,116.0,126.27249908447266,49.57899998291788,-50.42100001708212,2.983642195829205,3.349400916073101,0.02753981676635253,1500730000.0,-1.0
AMZN,2020-05-27,120.51950073242188,120.6790008544922,116.5,120.24949645996094,101138000.0,-0.5735015869140625,0.5735015869140625,0.0,50.22221442101215,116.5,126.27249908447266,41.13073531834232,-58.869264681657675,2.7378924114801606,3.227099215134582,0.017935546323361695,1399592000.0,-1.0
AMZN,2020-05-28,120.05500030517578,121.84850311279295,118.9114990234375,119.21649932861328,63804000.0,-0.46450042724609375,0.46450042724609375,0.0,47.745405855740515,116.5,126.27249908447266,36.377596707317736,-63.622403292682264,2.4771106727794177,3.077101506643994,0.005128016123593815,1335788000.0,-1.0
AMZN,2020-05-29,122.11849975585938,122.11849975585938,119.91000366210938,120.7969970703125,70198000.0,2.0634994506835938,0.0,2.0634994506835938,58.28947772385732,116.5,126.27249908447266,57.49296784060595,-42.50703215939405,2.409119141932834,2.9435050336878286,0.013524067460390254,1405986000.0,1.0
AMZN,2020-06-01,123.552001953125,123.84649658203124,122.20850372314452,122.4000015258789,58578000.0,1.433502197265625,0.0,1.433502197265625,64.0966045738867,116.5,126.27249908447266,72.16170492489272,-27.83829507510729,2.4427118691391456,2.843346400769735,0.01845637604996697,1464564000.0,1.0
AMZN,2020-06-02,123.62049865722656,123.67649841308594,122.2655029296875,123.3499984741211,50598000.0,0.0684967041015625,0.0,0.0684967041015625,64.37009964956843,116.5,126.27249908447266,72.86261779794067,-27.137382202059328,2.4466549389909034,2.764008108408673,0.009422979630672401,1515162000.0,1.0
AMZN,2020-06-03,123.91999816894533,124.4000015258789,123.05850219726562,123.40049743652344,53420000.0,0.2994995117187642,0.0,0.2994995117187642,65.68873603915162,116.5,126.27249908447266,75.92733552397897,-24.07266447602103,2.4457462554852896,2.700355737820597,-0.007822485568553028,1568582000.0,1.0
AMZN,2020-06-04,123.02999877929688,125.3769989013672,122.50050354003906,123.87149810791016,58974000.0,-0.8899993896484517,0.8899993896484517,0.0,58.29168591084572,116.5,126.27249908447266,66.82015237711579,-33.1798476228842,2.3461818431308217,2.629520958879616,0.005664686929274243,1509608000.0,-1.0
AMZN,2020-06-05,124.1500015258789,124.43250274658205,121.85649871826172,122.22550201416016,66128000.0,1.1200027465820312,0.0,1.1200027465820312,64.15303205488088,116.5,126.27249908447266,78.28091320094215,-21.719086799057852,2.330762231184437,2.5697692133385384,0.018925837319525796,1575736000.0,1.0
AMZN,2020-06-08,126.2030029296875,126.5,124.36699676513672,125.01000213623048,79414000.0,2.0530014038085938,0.0,2.0530014038085938,72.36653102740152,116.5,126.5,97.030029296875,-2.969970703125,2.4558566700089983,2.546986704672008,0.04219897527089067,1655150000.0,1.0
AMZN,2020-06-09,130.04299926757812,131.32150268554688,126.25,126.47200012207033,103520000.0,3.839996337890625,0.0,3.839996337890625,81.50987555198779,116.5,131.32150268554688,91.37399597670027,-8.626004023299723,2.832141615238072,2.604017686786468,0.07902039485128953,1758670000.0,1.0
AMZN,2020-06-10,132.37249755859375,136.11749267578125,131.31300354003906,132.25,98920000.0,2.329498291015625,0.0,2.329498291015625,84.98697672495756,116.5,136.11749267578125,80.90991963610682,-19.090080363893183,3.2804702686049296,2.739308203152527,0.10259878574076309,1857590000.0,1.0
AMZN,2020-06-11,127.89800262451172,133.56900024414062,126.8115005493164,130.1750030517578,116002000.0,-4.474494934082031,4.474494934082031,0.0,59.98600195058525,116.5,136.11749267578125,58.10122023689147,-41.89877976310852,3.2374589189930276,2.838938346322022,0.04732700516471122,1741588000.0,-1.0
AMZN,2020-06-12,127.2509994506836,131.07400512695312,125.1675033569336,130.0605010986328,108722000.0,-0.647003173828125,0.647003173828125,0.0,57.17956243688011,116.5,136.11749267578125,54.80312712926981,-45.19687287073018,3.115260807682546,2.8942028385947456,0.029938790461379705,1632866000.0,-1.0
AMZN,2020-06-15,128.63400268554688,129.1999969482422,125.4000015258789,126.33000183105467,77302000.0,1.3830032348632812,0.0,1.3830032348632812,61.60946912632821,116.5,136.11749267578125,61.85297421075065,-38.14702578924935,3.0943285347690335,2.9342279778299623,0.04055560431139904,1710168000.0,1.0
AMZN,2020-06-16,130.7635040283203,131.0,128.8000030517578,131.0,71712000.0,2.1295013427734375,0.0,2.1295013427734375,67.57009406657201,118.9114990234375,136.11749267578125,68.88300230930497,-31.116997690695026,3.2125170103430634,2.9898857843329814,0.05522519335454601,1781880000.0,1.0
AMZN,2020-06-17,132.0489959716797,132.75,131.59100341796875,132.375,59186000.0,1.285491943359375,0.0,1.285491943359375,70.73496545790664,119.91000366210938,136.11749267578125,74.89742735182749,-25.102572648172522,3.3710377843308095,3.0661161843329845,0.07330730132381746,1841066000.0,1.0
AMZN,2020-06-18,132.69900512695312,132.98199462890625,131.8054962158203,132.35049438476562,49756000.0,0.6500091552734375,0.0,0.6500091552734375,72.31151489622331,121.85649871826172,136.11749267578125,76.02910737490618,-23.970892625093825,3.5086643539783324,3.15462581826246,0.06886027785744475,1890822000.0,1.0
AMZN,2020-06-19,133.75050354003906,134.8715057373047,132.9499969482422,133.9040069580078,115540000.0,1.0514984130859375,0.0,1.0514984130859375,74.8413009172111,121.85649871826172,136.11749267578125,83.40235510376804,-16.59764489623195,3.6603771765441167,3.2557760899191623,0.05980444549767627,2006362000.0,1.0
AMZN,2020-06-22,135.6909942626953,135.75,133.4499969482422,134.22500610351562,64176000.0,1.94049072265625,0.0,1.94049072265625,78.93879760187733,121.85649871826172,136.11749267578125,97.00933599469724,-2.9906640053027553,3.8923078214205304,3.3830824362198095,0.043431749705309386,2070538000.0,1.0
AMZN,2020-06-23,138.2205047607422,139.15550231933594,135.90199279785156,136.30099487304688,84634000.0,2.529510498046875,0.0,2.529510498046875,83.08288996594895,121.85649871826172,139.15550231933594,94.59507853657139,-5.404921463428618,4.231428248897203,3.5527515987556866,0.04417841553197155,2155172000.0,1.0
AMZN,2020-06-24,136.72000122070312,139.8000030517578,136.0500030517578,139.0,90532000.0,-1.5005035400390625,1.5005035400390625,0.0,73.22159609537917,121.85649871826172,139.8000030517578,82.8350038330858,-17.164996166914197,4.329210287272389,3.708043336459319,0.06897682852867848,2064640000.0,-1.0
AMZN,2020-06-25,137.72900390625,137.81149291992188,135.60699462890625,136.9774932861328,59374000.0,1.009002685546875,0.0,1.009002685546875,75.47973508258993,124.36699676513672,139.8000030517578,86.58071469002661,-13.419285309973377,4.436967707375061,3.853828210642686,0.0823412350456798,2124014000.0,1.0
AMZN,2020-06-26,134.64349365234375,139.1284942626953,134.39999389648438,138.7530059814453,130016000.0,-3.08551025390625,3.08551025390625,0.0,58.1713145689303,125.1675033569336,139.8000030517578,64.75988718976011,-35.24011281023989,4.22470875679727,3.928004319873692,0.04671774835062403,1993998000.0,-1.0
AMZN,2020-06-29,134.0189971923828,134.83999633789062,131.50399780273438,134.50050354003906,84468000.0,-0.6244964599609375,0.6244964599609375,0.0,55.21445464328476,125.1675033569336,139.8000030517578,60.49201448868066,-39.50798551131935,3.9604497370584397,3.934493403310648,0.024896037990519426,1909530000.0,-1.0
AMZN,2020-06-30,137.9409942626953,138.48150634765625,133.75149536132812,134.2534942626953,75394000.0,3.9219970703125,0.0,3.9219970703125,67.27012593804545,125.1675033569336,139.8000030517578,87.29534373597106,-12.704656264028936,4.021122155283081,3.9518191537051477,0.04461978864480942,1984924000.0,1.0
AMZN,2020-07-01,143.93499755859375,144.75,137.6999969482422,137.89950561523438,127268000.0,5.9940032958984375,0.0,5.9940032958984375,77.8056078473915,125.1675033569336,144.75,95.83810759035765,-4.161892409642356,4.500959128984675,4.0616471487611205,0.08467277068800283,2112192000.0,1.0
AMZN,2020-07-02,144.51499938964844,147.7779998779297,143.55499267578125,145.60049438476562,131868000.0,0.5800018310546875,0.0,0.5800018310546875,78.5755875654837,125.4000015258789,147.7779998779297,85.4187115534298,-14.581288446570198,4.871871602613027,4.223692039531581,0.08048190896258545,2244060000.0,1.0
AMZN,2020-07-06,152.8520050048828,152.99400329589844,146.5,146.74850463867188,137612000.0,8.337005615234375,0.0,8.337005615234375,86.40059288636884,128.8000030517578,152.99400329589844,99.41308469214381,-0.5869153078561887,5.771979745441968,4.5333495807137805,0.1264712579890459,2381672000.0,1.0
AMZN,2020-07-07,150.00599670410156,153.4774932861328,149.5,152.92750549316406,105150000.0,-2.84600830078125,2.84600830078125,0.0,75.53402660427996,131.50399780273438,153.4774932861328,84.20143675067966,-15.798563249320338,6.184392513204642,4.863558167212056,0.08526587255458162,2276522000.0,-1.0
AMZN,2020-07-08,154.0554962158203,154.19850158691406,150.6215057373047,151.1304931640625,100752000.0,4.04949951171875,0.0,4.04949951171875,79.72128001004826,131.50399780273438,154.19850158691406,99.36986782150558,-0.6301321784944197,6.760053309637243,5.242857195697189,0.12679560298666903,2377274000.0,1.0
AMZN,2020-07-09,159.13150024414062,159.69400024414062,153.6999969482422,155.79949951171875,127774000.0,5.0760040283203125,0.0,5.0760040283203125,83.74495902350756,131.50399780273438,159.69400024414062,98.00461173719593,-1.995388262804066,7.538938911983166,5.702073538954477,0.1553957099149499,2505048000.0,1.0
AMZN,2020-07-10,160.0,160.75,156.78500366210938,159.58799743652344,109720000.0,0.868499755859375,0.0,0.868499755859375,84.3577028854632,131.50399780273438,160.75,97.43554693410329,-2.5644530658967186,8.132541835732752,6.18816719831021,0.18832329479750443,2614768000.0,1.0
AMZN,2020-07-13,155.1999969482422,167.21449279785156,153.41949462890625,162.55299377441406,154408000.0,-4.8000030517578125,4.8000030517578125,0.0,68.00919094608699,131.50399780273438,167.21449279785156,66.35584062541794,-33.64415937458205,8.122042631906254,6.5749422850294685,0.15804475633744874,2460360000.0,-1.0
AMZN,2020-07-14,154.1999969482422,156.36900329589844,147.5,154.4499969482422,144638000.0,-1.0,1.0,0.0,64.98191251856343,131.50399780273438,167.21449279785156,63.555543401487746,-36.44445659851226,7.941487787557065,6.848251385535016,0.1178692583191272,2315722000.0,-1.0
AMZN,2020-07-15,150.44349670410156,154.91749572753906,148.65899658203125,154.01150512695312,115778000.0,-3.756500244140625,3.756500244140625,0.0,54.47219665221288,131.50399780273438,167.21449279785156,53.036226196127636,-46.96377380387237,7.409870503985047,6.960575209225032,0.0452183225477063,2199944000.0,-1.0
AMZN,2020-07-16,149.9949951171875,151.60000610351562,145.9114990234375,148.55299377441406,127884000.0,-0.4485015869140625,0.4485015869140625,0.0,53.28497523287068,131.50399780273438,167.21449279785156,51.78028844736389,-48.21971155263611,6.873141088647316,6.943088385109488,0.03791990970268522,2072060000.0,-1.0
AMZN,2020-07-17,148.09849548339844,151.1999969482422,147.42250061035156,150.4499969482422,95226000.0,-1.8964996337890625,1.8964996337890625,0.0,48.16332430635171,131.50399780273438,167.21449279785156,46.469525787679736,-53.530474212320264,6.223016000041497,6.799073908095881,-0.03109877113703885,1976834000.0,-1.0
AMZN,2020-07-20,159.8419952392578,160.0679931640625,149.7010040283203,150.00999450683594,151964000.0,11.743499755859375,0.0,11.743499755859375,69.26828911725221,133.75149536132812,167.21449279785156,77.96820929571902,-22.031790704280972,6.579523231415152,6.755163772759733,0.06557070218038352,2128798000.0,1.0
AMZN,2020-07-21,156.9145050048828,162.0290069580078,155.28599548339844,161.62449645996094,122426000.0,-2.927490234375,2.927490234375,0.0,62.006696168629475,137.6999969482422,167.21449279785156,65.10193551855953,-34.898064481440464,6.550330275368054,6.714197073281396,0.018558304372712886,2006372000.0,-1.0
AMZN,2020-07-22,154.99549865722656,157.5,153.26300048828125,156.25,82084000.0,-1.91900634765625,1.91900634765625,0.0,57.45129989436036,143.55499267578125,167.21449279785156,48.35480852265875,-51.64519147734126,6.299730279202294,6.631303714465573,-0.025991092779044878,1924288000.0,-1.0
AMZN,2020-07-23,149.32749938964844,154.9134979248047,148.5,154.9134979248047,113138000.0,-5.667999267578125,5.667999267578125,0.0,45.94730046156892,145.9114990234375,167.21449279785156,16.035306597675117,-83.96469340232488,5.579459333467014,6.420934838265857,-0.06670312881469731,1811150000.0,-1.0
AMZN,2020-07-24,150.44549560546875,151.57899475097656,144.39999389648438,146.5,112648000.0,1.1179962158203125,0.0,1.1179962158203125,48.30327440682489,144.39999389648438,167.21449279785156,26.498507528570308,-73.50149247142969,5.040744255307146,6.14489672167411,-0.03063467420272581,1923798000.0,1.0
AMZN,2020-07-27,152.760498046875,154.89999389648438,150.7884979248047,153.10000610351562,83410000.0,2.31500244140625,0.0,2.31500244140625,53.17913778526719,144.39999389648438,167.21449279785156,36.645574318924055,-63.354425681075945,4.745899309715895,5.865097239282463,-0.009335271918652244,2007208000.0,1.0
AMZN,2020-07-28,150.01649475097656,153.85450744628906,149.78799438476562,152.7135009765625,62534000.0,-2.7440032958984375,2.7440032958984375,0.0,47.103117369481254,144.39999389648438,167.21449279785156,24.618120602927693,-75.38187939707231,4.2419193059478175,5.540461652615529,-0.002838287878703327,1944674000.0,-1.0
AMZN,2020-07-29,151.67649841308594,151.95799255371094,149.8385009765625,151.54949951171875,59482000.0,1.660003662109375,0.0,1.660003662109375,51.01022772259916,144.39999389648438,167.21449279785156,31.89421143133461,-68.10578856866539,3.931142374126523,5.2185977969177255,0.011210396017445223,2004156000.0,1.0
AMZN,2020-07-30,152.593994140625,154.60000610351562,150.25,150.6999969482422,122566000.0,0.9174957275390625,0.0,0.9174957275390625,53.214085832523836,144.39999389648438,167.21449279785156,35.91575813067535,-64.08424186932464,3.716046426299073,4.918087522793993,0.030354789510542268,2126722000.0,1.0
AMZN,2020-07-31,158.23399353027344,162.34100341796875,157.5500030517578,162.1999969482422,161710000.0,5.6399993896484375,0.0,5.6399993896484375,64.53143550187124,144.39999389648438,162.34100341796875,77.10825646250751,-22.891743537492495,3.95508517947178,4.725487054129549,-0.01005994517634401,2288432000.0,1.0
AMZN,2020-08-03,155.59449768066406,159.1999969482422,155.1999969482422,159.02549743652344,101494000.0,-2.639495849609375,2.639495849609375,0.0,57.07600061146045,144.39999389648438,162.34100341796875,62.39617548150933,-37.603824518490676,3.8867380922616235,4.557737261755963,-0.008412270899861518,2186938000.0,-1.0
AMZN,2020-08-04,156.94149780273438,158.36199951171875,155.0605010986328,155.0605010986328,93886000.0,1.3470001220703125,0.0,1.3470001220703125,59.8100931736233,144.39999389648438,162.34100341796875,69.90411487843835,-30.09588512156165,3.8963483862704607,4.425459486658862,0.012555197811333851,2280824000.0,1.0
AMZN,2020-08-05,160.25149536132812,160.67950439453125,156.36500549316406,157.18850708007812,78330000.0,3.30999755859375,0.0,3.30999755859375,65.95810514538076,144.39999389648438,162.34100341796875,88.35345327620257,-11.646546723797439,4.123517935048227,4.365071176336734,0.07315461664013467,2359154000.0,1.0
AMZN,2020-08-06,161.25,162.37350463867188,158.27149963378906,159.71800231933594,78812000.0,0.998504638671875,0.0,0.998504638671875,67.67906952060147,144.39999389648438,162.37350463867188,93.7491085921529,-6.2508914078471065,4.334160162569333,4.3588889735832534,0.07181673569586411,2437966000.0,1.0
AMZN,2020-08-07,158.3730010986328,162.04049682617188,157.0334930419922,161.20050048828125,78722000.0,-2.8769989013671875,2.8769989013671875,0.0,57.94083133742896,144.39999389648438,162.37350463867188,77.74222522565353,-22.25777477434647,4.2202986144948795,4.331170901765579,0.03674053910216757,2359244000.0,-1.0
AMZN,2020-08-10,157.4080047607422,158.62550354003906,155.0760040283203,158.5155029296875,63346000.0,-0.964996337890625,0.964996337890625,0.0,54.88443889008789,144.39999389648438,162.37350463867188,72.37323331454301,-27.626766685456978,4.006017015236296,4.266140124459722,0.04927131527793227,2295898000.0,-1.0
AMZN,2020-08-11,154.0334930419922,157.96099853515625,153.64999389648438,155.66000366210938,74362000.0,-3.37451171875,3.37451171875,0.0,45.25274802485811,144.39999389648438,162.37350463867188,53.59831634281677,-46.40168365718322,3.5232898838595474,4.117570076339687,0.015539616575845905,2221536000.0,-1.0
AMZN,2020-08-12,158.11199951171875,158.71949768066406,155.0709991455078,155.39999389648438,70442000.0,4.0785064697265625,0.0,4.0785064697265625,56.016849092283195,144.39999389648438,162.37350463867188,76.29007939472558,-23.70992060527442,3.4302823553935298,3.980112532150455,0.036161353545858255,2291978000.0,1.0
AMZN,2020-08-13,158.05099487304688,160.87600708007812,157.75,159.14950561523438,62980000.0,-0.061004638671875,0.061004638671875,0.0,55.82740872692977,149.78799438476562,162.37350463867188,65.65487073292564,-34.345129267074356,3.3134552022814034,3.846781066176644,-0.0011565065959834309,2228998000.0,-1.0
AMZN,2020-08-14,157.4010009765625,158.91200256347656,156.0,158.90899658203125,55034000.0,-0.649993896484375,0.649993896484375,0.0,53.59895069272994,149.78799438476562,162.37350463867188,60.49024980480211,-39.50975019519789,3.1323126649929804,3.7038873859399115,0.011610328917967427,2173964000.0,-1.0
AMZN,2020-08-17,159.12049865722656,159.74850463867188,157.70899963378906,158.656005859375,53824000.0,1.7194976806640625,0.0,1.7194976806640625,58.63851855552631,149.8385009765625,162.37350463867188,74.048623605285,-25.95137639471499,3.091863222707161,3.5814825532933616,0.013884159925828143,2227788000.0,1.0
AMZN,2020-08-18,165.62449645996094,166.0,160.29100036621094,160.60000610351562,106920000.0,6.503997802734375,0.0,6.503997802734375,71.93958128261144,150.25,166.0,97.61585053943452,-2.384149460565476,3.543772227259012,3.5739404880864925,0.03352855514089281,2334708000.0,1.0
AMZN,2020-08-19,163.0240020751953,165.7949981689453,162.8000030517578,165.15049743652344,83702000.0,-2.600494384765625,2.600494384765625,0.0,62.64555384120468,153.64999389648438,166.0,75.90286272038746,-24.09713727961254,3.6500010925688002,3.5891526089829537,0.011001563257025282,2251006000.0,-1.0
AMZN,2020-08-20,164.86849975585938,165.63099670410156,161.89999389648438,162.60000610351562,66650000.0,1.8444976806640625,0.0,1.8444976806640625,66.21744812631454,153.64999389648438,166.0,90.83805923125394,-9.161940768746062,3.8387721997819426,3.639076527142752,0.04101392669310622,2317656000.0,1.0
AMZN,2020-08-21,164.23599243164062,165.72000122070312,163.76950073242188,164.75,71518000.0,-0.63250732421875,0.63250732421875,0.0,63.80345599119417,153.64999389648438,166.0,85.71654496707316,-14.283455032926845,3.8924668223876893,3.6897545861917393,0.04337763941088557,2246138000.0,-1.0
AMZN,2020-08-24,165.3730010986328,169.01600646972656,162.8780059814453,165.50750732421875,93326000.0,1.1370086669921875,0.0,1.1370086669921875,66.34805691007264,153.64999389648438,169.01600646972656,76.29179753869558,-23.708202461304413,3.9808778828012237,3.747979245513636,0.07361715840300587,2339464000.0,1.0
AMZN,2020-08-25,167.32449340820312,167.8699951171875,163.35000610351562,164.74949645996094,79856000.0,1.9514923095703125,0.0,1.9514923095703125,70.46055641944733,153.64999389648438,169.01600646972656,88.99185424025373,-11.008145759746263,4.160453775641969,3.830474151539303,0.05826562136292246,2419320000.0,1.0
AMZN,2020-08-26,172.09249877929688,172.58700561523438,167.22850036621094,167.5554962158203,130174000.0,4.76800537109375,0.0,4.76800537109375,78.02973571933623,153.64999389648438,172.58700561523438,97.38867545058402,-2.6113245494159814,4.634087158854868,3.9911967530024164,0.08884160405019093,2549494000.0,1.0
AMZN,2020-08-27,170.0,172.64999389648438,168.89999389648438,172.50250244140625,85296000.0,-2.092498779296875,2.092498779296875,0.0,69.06786091875293,153.64999389648438,172.64999389648438,86.05266370271382,-13.947336297286183,4.7854347584080585,4.150044354083545,0.08004395744162718,2464198000.0,-1.0
AMZN,2020-08-28,170.08999633789062,171.6685028076172,169.3249969482422,171.14999389648438,57940000.0,0.089996337890625,0.0,0.089996337890625,69.2431633476953,153.64999389648438,172.64999389648438,86.52632863898026,-13.473671361019738,4.85665622069024,4.291366727404884,0.06893830633534082,2522138000.0,1.0
AMZN,2020-08-31,172.54800415039062,174.75,170.25,170.44949340820312,83718000.0,2.4580078125,0.0,2.4580078125,73.90394872236499,155.0709991455078,174.75,88.81042860920087,-11.189571390799134,5.053189933715117,4.44373136866693,0.04180243767324243,2605856000.0,1.0
AMZN,2020-09-01,174.95599365234375,175.69349670410156,173.35000610351562,174.47900390625,68644000.0,2.407989501953125,0.0,2.407989501953125,77.72028253002625,156.0,175.69349670410156,96.25509343089786,-3.744906569102138,5.341673034706332,4.623319701874811,0.07319162470103491,2674500000.0,1.0
AMZN,2020-09-02,176.57249450683594,177.6125030517578,174.33450317382812,177.35000610351562,78630000.0,1.6165008544921875,0.0,1.6165008544921875,79.98726076342732,156.0,177.6125030517578,95.18793106734906,-4.812068932650945,5.635770152748506,4.825809792049551,0.07098987840799231,2753130000.0,1.0
AMZN,2020-09-03,168.39999389648438,174.42050170898438,165.14999389648438,174.25,163222000.0,-8.172500610351562,8.172500610351562,0.0,50.19407019195228,157.70899963378906,177.6125030517578,53.71413282469434,-46.285867175305654,5.150026592738811,4.8906531521874035,0.02535376931202782,2589908000.0,-1.0
AMZN,2020-09-04,164.7310028076172,169.0749969482422,155.55650329589844,165.89999389648438,175636000.0,-3.6689910888671875,3.6689910888671875,0.0,42.07572677446915,155.55650329589844,177.6125030517578,41.596389251325874,-58.403610748674126,4.418085941839735,4.79613971011787,-0.003882122757346118,2414272000.0,-1.0
AMZN,2020-09-08,157.49200439453125,162.54249572753906,156.5,157.1999969482422,121884000.0,-7.2389984130859375,7.2389984130859375,0.0,30.752405515751818,155.55650329589844,177.6125030517578,8.775394994818265,-91.22460500518173,3.216810534368676,4.480273874968032,-0.05876299884969405,2292388000.0,-1.0
AMZN,2020-09-09,163.4304962158203,165.15899658203125,159.25,160.14950561523438,103774000.0,5.9384918212890625,0.0,5.9384918212890625,44.8109590220602,155.55650329589844,177.6125030517578,35.70000456601419,-64.29999543398581,2.712706713685918,4.126760442711609,-0.05033341153692761,2396162000.0,1.0
AMZN,2020-09-10,158.7554931640625,167.4945068359375,158.52749633789062,165.36099243164062,106614000.0,-4.6750030517578125,4.6750030517578125,0.0,37.833923002721235,155.55650329589844,177.6125030517578,14.50394406770984,-85.49605593229016,1.9139053150743734,3.6841894171841614,-0.06614415785845584,2289548000.0,-1.0
AMZN,2020-09-11,155.81100463867188,160.86700439453125,154.19900512695312,160.4344940185547,101880000.0,-2.944488525390625,2.944488525390625,0.0,33.98809844557742,154.19900512695312,177.6125030517578,6.884915346249773,-93.11508465375023,1.0313651945678544,3.1536245726609002,-0.08394962670734007,2187668000.0,-1.0
AMZN,2020-09-14,155.14849853515625,159.3695068359375,154.8000030517578,158.64700317382812,90592000.0,-0.662506103515625,0.662506103515625,0.0,33.11422094283766,154.19900512695312,177.6125030517578,4.055324886749256,-95.94467511325074,0.27531351050529906,2.57796236022978,-0.10083863734563503,2097076000.0,-1.0
AMZN,2020-09-15,157.80650329589844,158.75100708007812,155.4459991455078,156.80799865722656,80430000.0,2.6580047607421875,0.0,2.6580047607421875,40.22851064902411,154.19900512695312,177.6125030517578,15.407771109345703,-84.5922288906543,-0.10813779678468904,2.0407423288268864,-0.09802173677183745,2177506000.0,1.0
AMZN,2020-09-16,153.90499877929688,159.36199951171875,153.70750427246094,158.99949645996094,90244000.0,-3.9015045166015625,3.9015045166015625,0.0,34.08777169968512,153.70750427246094,177.6125030517578,0.8261640532145907,-99.1738359467854,-0.7185610955336301,1.488881643954783,-0.12837500988389505,2087262000.0,-1.0
AMZN,2020-09-17,150.43649291992188,151.47149658203125,148.62750244140625,150.46249389648438,128982000.0,-3.468505859375,3.468505859375,0.0,29.472825163635264,148.62750244140625,177.6125030517578,6.241126239167892,-93.7588737608321,-1.4653139091925027,0.8980425333253258,-0.10667162486718784,1958280000.0,-1.0
AMZN,2020-09-18,147.74549865722656,151.88999938964844,145.27699279785156,151.58700561523438,177852000.0,-2.6909942626953125,2.6909942626953125,0.0,26.286964705129336,145.27699279785156,177.6125030517578,7.634040223864398,-92.3659597761356,-2.24834394356364,0.2687652379475325,-0.10311054908241724,1780428000.0,-1.0
AMZN,2020-09-21,148.02349853515625,148.10000610351562,143.5500030517578,145.3249969482422,122358000.0,0.2779998779296875,0.0,0.2779998779296875,27.224675408300953,143.5500030517578,177.6125030517578,13.133197749426607,-86.8668022505734,-2.8140302392499166,-0.3477938574919575,-0.06012054958457169,1902786000.0,1.0
AMZN,2020-09-22,156.44949340820312,156.69949340820312,150.00999450683594,151.69200134277344,138976000.0,8.425994873046875,0.0,8.425994873046875,49.632491770747215,143.5500030517578,177.6125030517578,37.870063431766056,-62.129936568233944,-2.553004366542666,-0.7888359593020995,-0.04271542318759369,2041762000.0,1.0
AMZN,2020-09-23,149.9929962158203,156.35000610351562,149.61900329589844,156.02149963378906,113054000.0,-6.4564971923828125,6.4564971923828125,0.0,39.012141143851764,143.5500030517578,174.42050170898438,20.871036893841175,-79.12896310615882,-2.8344507186702685,-1.1979589111757336,-0.055194921281790044,1928708000.0,-1.0
AMZN,2020-09-24,150.989501953125,153.46499633789062,148.25,148.88949584960938,110588000.0,0.9965057373046875,0.0,0.9965057373046875,41.250887191092474,143.5500030517578,169.0749969482422,29.145938022699585,-70.85406197730042,-2.9431623954807264,-1.5469996080367323,-0.030944558099269104,2039296000.0,1.0
AMZN,2020-09-25,154.75650024414062,155.07699584960938,149.9499969482422,152.7429962158203,92304000.0,3.766998291015625,0.0,3.766998291015625,49.35912009592179,143.5500030517578,167.4945068359375,46.801960455689326,-53.198039544310674,-2.694293926934904,-1.7764584718163667,-0.002526600609845997,2131600000.0,1.0
AMZN,2020-09-28,158.70249938964844,158.7519989013672,155.85850524902344,157.4425048828125,84484000.0,3.9459991455078125,0.0,3.9459991455078125,56.59903924719453,143.5500030517578,167.4945068359375,63.28173043160741,-36.71826956839259,-2.153826908640042,-1.851932159181102,0.005677814760713273,2216084000.0,1.0
AMZN,2020-09-29,157.24400329589844,159.41299438476562,156.6269989013672,158.76950073242188,69916000.0,-1.45849609375,1.45849609375,0.0,53.34641494723073,143.5500030517578,167.4945068359375,57.19057854599748,-42.80942145400251,-1.822186263293986,-1.8459829800036789,0.021695231104155166,2146168000.0,-1.0
AMZN,2020-09-30,157.43649291992188,160.6439971923828,156.69949340820312,157.0570068359375,97922000.0,0.1924896240234375,0.0,0.1924896240234375,53.75115454826469,143.5500030517578,160.86700439453125,80.1899219922336,-19.810078007766414,-1.5262329026559485,-1.782032964534133,0.04653126288796261,2244090000.0,1.0
AMZN,2020-10-01,161.06300354003906,161.1999969482422,158.60000610351562,160.39999389648438,99438000.0,3.6265106201171875,0.0,3.6265106201171875,61.08934180935247,143.5500030517578,161.1999969482422,99.2238331128805,-0.7761668871195027,-0.9876734694530853,-1.6231610655179238,0.09013814298132661,2343528000.0,1.0
AMZN,2020-10-02,156.25,159.7899932861328,156.14999389648438,157.68150329589844,112262000.0,-4.8130035400390625,4.8130035400390625,0.0,49.14765161553206,143.5500030517578,161.1999969482422,71.95468181307328,-28.045318186926714,-0.9384128139290908,-1.4862114152001573,0.055575645395855355,2231266000.0,-1.0
AMZN,2020-10-05,159.9600067138672,160.12649536132812,157.04249572753906,157.29200744628906,75506000.0,3.7100067138671875,0.0,3.7100067138671875,56.679480300872015,143.5500030517578,161.1999969482422,92.97455714915579,-7.025442850844205,-0.5931692732707461,-1.3076029868142751,0.022438636451858285,2306772000.0,1.0
AMZN,2020-10-06,154.9980010986328,159.10000610351562,154.5,158.25,101738000.0,-4.962005615234375,4.962005615234375,0.0,46.13450143106645,143.5500030517578,161.1999969482422,64.86120116537421,-35.13879883462579,-0.7117489343531815,-1.1884321763220564,0.03336825724589798,2205034000.0,-1.0
AMZN,2020-10-07,159.7845001220703,160.0,156.6195068359375,156.75,86188000.0,4.7864990234375,0.0,4.7864990234375,55.37519935117986,143.5500030517578,161.1999969482422,91.98018518038229,-8.019814819617709,-0.41471326183071255,-1.0336883934237877,0.05824907066503027,2291222000.0,1.0
AMZN,2020-10-08,159.52749633789062,161.6645050048828,158.74949645996094,161.24949645996094,63482000.0,-0.2570037841796875,0.2570037841796875,0.0,54.79284491297966,143.5500030517578,161.6645050048828,88.20277437093144,-11.797225629068562,-0.19776864975443686,-0.8665044446899175,0.030829051356313864,2227740000.0,-1.0
AMZN,2020-10-09,164.33250427246094,164.44949340820312,159.89149475097656,160.5,98158000.0,4.8050079345703125,0.0,4.8050079345703125,63.15240983681757,148.25,164.44949340820312,99.27782225780625,-0.7221777421937551,0.3577613496581762,-0.6216512858202987,0.03547521245389862,2325898000.0,1.0
AMZN,2020-10-12,172.14649963378906,174.81199645996094,166.9774932861328,167.4969940185547,167284000.0,7.813995361328125,0.0,7.813995361328125,72.64427683730428,148.25,174.81199645996094,89.96499818758053,-10.035001812419468,1.4122671078623057,-0.21486760708377772,0.09477306622528192,2493182000.0,1.0
AMZN,2020-10-13,172.18150329589844,174.61900329589844,171.21099853515625,173.39950561523438,114894000.0,0.035003662109375,0.0,0.035003662109375,72.68065168051928,148.25,174.81199645996094,90.09677917837368,-9.903220821626329,2.2251449321967414,0.2731349007723263,0.09365687778294474,2608076000.0,1.0
AMZN,2020-10-14,168.1855010986328,173.24400329589844,167.0,172.35000610351562,116254000.0,-3.996002197265625,3.996002197265625,0.0,61.847916082088396,149.9499969482422,174.81199645996094,73.34689288283224,-26.653107117167764,2.5178879029174936,0.72208550120136,0.04422181011186188,2491822000.0,-1.0
AMZN,2020-10-15,166.9324951171875,167.79400634765625,164.0,164.60049438476562,104468000.0,-1.2530059814453125,1.2530059814453125,0.0,58.68338185822726,154.5,174.81199645996094,61.2076471246658,-38.7923528753342,2.618596176626454,1.101387636286379,0.06836796875000006,2387354000.0,-1.0
AMZN,2020-10-16,163.635498046875,169.98300170898438,158.0,168.1614990234375,129488000.0,-3.2969970703125,3.2969970703125,0.0,50.79293878832209,154.5,174.81199645996094,44.97587455217865,-55.02412544782135,2.404648850785321,1.3620398791861676,0.022977564258186423,2257866000.0,-1.0
AMZN,2020-10-19,160.36050415039062,166.4499969482422,159.63699340820312,164.98049926757812,104472000.0,-3.274993896484375,3.274993896484375,0.0,44.01054713073959,154.5,174.81199645996094,28.852427982364347,-71.14757201763565,1.9483698645847483,1.479305876265884,0.03459724005308562,2153394000.0,-1.0
AMZN,2020-10-20,160.85049438476562,163.3000030517578,159.60049438476562,161.11399841308594,90194000.0,0.489990234375,0.0,0.489990234375,45.27212183072812,154.5,174.81199645996094,31.264747398335444,-68.73525260166456,1.6077702174759168,1.5049987445078907,0.006671449745631941,2243588000.0,1.0
AMZN,2020-10-21,159.2469940185547,161.69400024414062,158.0,160.625,91854000.0,-1.6035003662109375,1.6035003662109375,0.0,41.722315226656285,154.5,174.81199645996094,23.370396050983835,-76.62960394901617,1.194681933369111,1.442935382280135,-0.001758332110608829,2151734000.0,-1.0
AMZN,2020-10-22,158.82000732421875,159.9375,156.0970001220703,159.49349975585938,84240000.0,-0.4269866943359375,0.4269866943359375,0.0,40.7408010154766,154.5,174.81199645996094,21.26825559828331,-78.73174440171668,0.8233610454743712,1.3190205149189824,-0.0335447754091458,2067494000.0,-1.0
AMZN,2020-10-23,160.22000122070312,160.26649475097656,157.0,159.5500030517578,69334000.0,1.399993896484375,0.0,1.399993896484375,45.58381773645131,154.5,174.81199645996094,28.160704103992963,-71.83929589600704,0.634737501612392,1.1821639122576644,-0.06928109742839639,2136828000.0,1.0
AMZN,2020-10-26,160.3520050048828,164.1490020751953,157.6649932861328,159.93699645996094,118024000.0,0.1320037841796875,0.0,0.1320037841796875,46.06338773114946,156.0970001220703,174.81199645996094,22.73580398302169,-77.26419601697832,0.49025226230787666,1.0437815822677068,-0.06870365320650218,2254852000.0,1.0
AMZN,2020-10-27,164.31649780273438,164.58299255371094,160.56500244140625,161.2469940185547,85820000.0,3.9644927978515625,0.0,3.9644927978515625,58.68201752495307,156.0970001220703,174.81199645996094,43.9193122577468,-56.0806877422532,0.6877204588717234,0.9725693575885102,-0.0230043807024094,2340672000.0,1.0
AMZN,2020-10-28,158.13900756835938,163.2010040283203,158.12350463867188,162.46499633789062,111766000.0,-6.177490234375,6.177490234375,0.0,41.30702032089305,156.0970001220703,174.81199645996094,10.91107585286986,-89.08892414713014,0.34180354192105256,0.8464161944550188,-0.05267690716930251,2228906000.0,-1.0
AMZN,2020-10-29,160.55050659179688,162.8625030517578,158.1999969482422,160.06350708007812,131930000.0,2.4114990234375,0.0,2.4114990234375,48.21353449009976,156.0970001220703,174.81199645996094,23.796459210146548,-76.20354078985345,0.25926109296364075,0.7289851741567432,-0.01885282528485599,2360836000.0,1.0
AMZN,2020-10-30,151.8074951171875,158.35000610351562,150.9499969482422,157.8874969482422,167728000.0,-8.743011474609375,8.743011474609375,0.0,32.309069501489276,150.9499969482422,174.61900329589844,3.6228735433594728,-96.37712645664053,-0.505811610643832,0.4820258171966282,-0.05333613210134258,2193108000.0,-1.0
AMZN,2020-11-02,150.2239990234375,153.98550415039062,147.50599670410156,153.08700561523438,145148000.0,-1.58349609375,1.58349609375,0.0,30.22541269885015,147.50599670410156,173.24400329589844,10.560267399271742,-89.43973260072826,-1.225782078055289,0.14046423814624465,-0.06606442461972672,2047960000.0,-1.0
AMZN,2020-11-03,152.42050170898438,153.7449951171875,149.0489959716797,150.92649841308594,97958000.0,2.196502685546875,0.0,2.196502685546875,36.753703426938884,147.50599670410156,169.98300170898438,21.864590072454963,-78.13540992754504,-1.6006729017917394,-0.20776318984135228,-0.042867322875651426,2145918000.0,1.0
AMZN,2020-11-04,162.05799865722656,162.24249267578125,156.9864959716797,157.99949645996094,136780000.0,9.637496948242188,0.0,9.637496948242188,57.08267082284771,147.50599670410156,169.98300170898438,64.7417302703976,-35.2582697296024,-1.1073463714315324,-0.3876798261593884,0.020387804959596245,2282698000.0,1.0
AMZN,2020-11-05,166.10000610351562,168.33999633789062,164.44400024414062,165.99850463867188,115786000.0,4.0420074462890625,0.0,4.0420074462890625,62.8597210435769,147.50599670410156,168.33999633789062,89.24839073750327,-10.751609262496732,-0.38577832892127617,-0.387299526711766,0.03669956833112731,2398484000.0,1.0
AMZN,2020-11-06,165.56849670410156,166.10000610351562,161.60000610351562,165.23199462890625,92946000.0,-0.5315093994140625,0.5315093994140625,0.0,61.60158646301854,147.50599670410156,168.33999633789062,86.6972272127039,-13.30277278729611,0.1415494845405476,-0.28152972446130325,0.032531502796362854,2305538000.0,-1.0
AMZN,2020-11-09,157.18699645996094,164.4499969482422,155.60549926757812,161.55149841308594,143808000.0,-8.381500244140625,8.381500244140625,0.0,45.156569906848,147.50599670410156,168.33999633789062,46.46731269092712,-53.53268730907288,-0.11552471489997629,-0.24832872254903787,-0.04338883458514653,2161730000.0,-1.0
AMZN,2020-11-10,151.75100708007812,155.6999969482422,150.9739990234375,154.75100708007812,131820000.0,-5.4359893798828125,5.4359893798828125,0.0,37.637445043574296,147.50599670410156,168.33999633789062,20.375398150107994,-79.624601849892,-0.7492597612421434,-0.34851493028765906,-0.04039484366638557,2029910000.0,-1.0
AMZN,2020-11-11,156.8695068359375,156.95750427246094,152.5,153.08900451660156,87338000.0,5.118499755859375,0.0,5.118499755859375,47.19102389725367,147.50599670410156,168.33999633789062,44.94341123367393,-55.05658876632607,-0.8289238973811166,-0.4445967237063506,-0.02292736307097676,2117248000.0,1.0
AMZN,2020-11-12,155.51400756835938,158.79400634765625,154.30250549316406,157.99749755859375,87240000.0,-1.355499267578125,1.355499267578125,0.0,45.080754615499856,147.50599670410156,168.33999633789062,38.437222832961154,-61.56277716703885,-0.9900233838319821,-0.5536820557314769,0.024415872538510852,2030008000.0,-1.0
AMZN,2020-11-13,156.4405059814453,157.08599853515625,154.26950073242188,156.10000610351562,75124000.0,0.9264984130859375,0.0,0.9264984130859375,46.95162566939927,147.50599670410156,168.33999633789062,42.88427298833948,-57.11572701166051,-1.03104990979935,-0.6491556265450515,0.04138158349144949,2105132000.0,1.0
AMZN,2020-11-16,156.55299377441406,157.13499450683594,153.63450622558594,154.66000366210938,76174000.0,0.11248779296875,0.0,0.11248779296875,47.20358610017684,147.50599670410156,168.33999633789062,43.42419712650792,-56.57580287349209,-1.0424699578932177,-0.7278184928146849,0.027112442349257027,2181306000.0,1.0
AMZN,2020-11-17,156.7830047607422,159.46249389648438,156.76300048828125,159.177001953125,68894000.0,0.230010986328125,0.0,0.230010986328125,47.788667285744715,147.50599670410156,168.33999633789062,44.528214551731864,-55.47178544826813,-1.021188835283482,-0.7864925613084445,-0.032550037271789733,2250200000.0,1.0
AMZN,2020-11-18,155.2729949951172,157.0,155.2550048828125,156.6999969482422,58336000.0,-1.510009765625,1.510009765625,0.0,44.08775513535671,147.50599670410156,168.33999633789062,37.28039947941118,-62.71960052058881,-1.113334727253175,-0.8518609944973906,-0.0651836888052304,2191864000.0,-1.0
AMZN,2020-11-19,155.8509979248047,156.25,154.04600524902344,155.2655029296875,60206000.0,0.5780029296875,0.0,0.5780029296875,45.93694963693903,147.50599670410156,168.33999633789062,40.05472481226796,-59.94527518773203,-1.126732732310927,-0.906835342060098,-0.05869171353692759,2252070000.0,1.0
AMZN,2020-11-20,154.97000122070312,156.64450073242188,154.90249633789062,155.8509979248047,67488000.0,-0.8809967041015625,0.8809967041015625,0.0,43.4118632476382,149.0489959716797,168.33999633789062,30.693095933969015,-69.30690406603098,-1.1946684232401594,-0.9644019582961103,-0.01410418984513473,2184582000.0,-1.0
AMZN,2020-11-23,154.91949462890625,156.9875030517578,153.2729949951172,155.8350067138672,94178000.0,-0.050506591796875,0.050506591796875,0.0,43.254585266349906,150.9739990234375,168.33999633789062,22.71966034559414,-77.28033965440586,-1.2383089526542506,-1.0191833571677384,0.020879515792314507,2090404000.0,-1.0
AMZN,2020-11-24,155.9029998779297,156.71249389648438,154.31300354003906,155.02499389648438,72042000.0,0.9835052490234375,0.0,0.9835052490234375,47.5260769009533,150.9739990234375,168.33999633789062,28.38305664362823,-71.61694335637178,-1.1799322101946643,-1.0513331277731237,-0.006161216271423853,2162446000.0,1.0
AMZN,2020-11-25,159.2534942626953,159.89999389648438,157.01300048828125,157.093505859375,75808000.0,3.350494384765625,0.0,3.350494384765625,59.50739549184724,150.9739990234375,166.10000610351562,54.736819805951384,-45.263180194048616,-0.8534730253798841,-1.0117611072944759,0.0240459798625674,2238254000.0,1.0
AMZN,2020-11-27,159.76699829101562,160.8094940185547,159.50250244140625,160.56300354003906,47858000.0,0.5135040283203125,0.0,0.5135040283203125,61.07894669028467,150.9739990234375,164.4499969482422,65.24933675889955,-34.750663241100455,-0.5470106879649848,-0.9188110234285777,0.02126362535521875,2286112000.0,1.0
AMZN,2020-11-30,158.40199279785156,161.41949462890625,156.27749633789062,160.4239959716797,81278000.0,-1.3650054931640625,1.3650054931640625,0.0,54.58158001338256,150.9739990234375,161.41949462890625,71.11193240582216,-28.88806759417783,-0.40956045322388945,-0.8169609093876401,0.011810690928733214,2204834000.0,-1.0
AMZN,2020-12-01,161.00399780273438,162.44749450683594,157.85899353027344,159.4250030517578,90740000.0,2.6020050048828125,0.0,2.6020050048828125,63.19337157680869,152.5,162.44749450683594,85.48884140514389,-14.511158594856111,-0.08963681986617189,-0.6714960914833465,0.026922516559965137,2295574000.0,1.0
AMZN,2020-12-02,160.17649841308594,161.60000610351562,158.66299438476562,161.08250427246094,62586000.0,-0.8274993896484375,0.8274993896484375,0.0,59.082553956509436,153.2729949951172,162.44749450683594,75.24664870438745,-24.753351295612546,0.0960257552818291,-0.5179917221303114,0.03157988559519276,2232988000.0,-1.0
AMZN,2020-12-03,159.3365020751953,161.4320068359375,159.0655059814453,160.2729949951172,57840000.0,-0.839996337890625,0.839996337890625,0.0,54.89959645866385,153.2729949951172,162.44749450683594,66.09087582742906,-33.909124172570934,0.17338532224221126,-0.37971631325580685,0.022364336429031573,2175148000.0,-1.0
AMZN,2020-12-04,158.12899780273438,159.91050720214844,157.93800354003906,159.91050720214844,58272000.0,-1.2075042724609375,1.2075042724609375,0.0,49.130181808819955,153.2729949951172,162.44749450683594,52.92934836842631,-47.070651631573696,0.1356936425555375,-0.276634322093538,0.020384568349665955,2116876000.0,-1.0
AMZN,2020-12-07,157.89999389648438,159.03799438476562,157.08450317382812,157.82400512695312,55026000.0,-0.22900390625,0.22900390625,0.0,48.02575007108618,153.2729949951172,162.44749450683594,50.433256827329274,-49.566743172670726,0.08634864032924838,-0.2040377296089807,0.01923902007760625,2061850000.0,-1.0
AMZN,2020-12-08,158.864501953125,159.2064971923828,156.00100708007812,157.94500732421875,65726000.0,0.964508056640625,0.0,0.964508056640625,53.14447924495609,153.2729949951172,162.44749450683594,60.94617968931909,-39.053820310680905,0.12364480874299488,-0.13850122193858558,0.018995799166880323,2127576000.0,1.0
AMZN,2020-12-09,155.2100067138672,158.72149658203125,154.39999389648438,158.39450073242188,82016000.0,-3.6544952392578125,3.6544952392578125,0.0,37.149174035126464,153.2729949951172,162.44749450683594,21.112996041645875,-78.88700395835411,-0.14007028689334788,-0.13881503492953803,-0.025390259520197578,2045560000.0,-1.0
AMZN,2020-12-10,155.07449340820312,157.10499572753906,153.8000030517578,154.44949340820312,60604000.0,-0.1355133056640625,0.1355133056640625,0.0,36.67686202107756,153.2729949951172,162.44749450683594,19.63593121112331,-80.3640687888767,-0.3558986135740838,-0.1822317506584472,-0.029370927244092737,1984956000.0,-1.0
AMZN,2020-12-11,155.8209991455078,155.93350219726562,153.64100646972656,154.83299255371094,61294000.0,0.7465057373046875,0.0,0.7465057373046875,41.41154588925024,153.2729949951172,162.44749450683594,27.772677377507232,-72.22732262249276,-0.46138874153447773,-0.23806314883365334,-0.01629394685480723,2046250000.0,1.0
AMZN,2020-12-14,157.84849548339844,159.52349853515625,156.3000030517578,157.14999389648438,83116000.0,2.027496337890625,0.0,2.027496337890625,52.53369720312068,153.64100646972656,162.44749450683594,47.777150164084404,-52.222849835915596,-0.37704211253387143,-0.265858941573697,-0.019598906625922008,2129366000.0,1.0
AMZN,2020-12-15,158.25599670410156,159.4250030517578,156.52450561523438,159.05050659179688,66390000.0,0.407501220703125,0.0,0.407501220703125,54.535255559848494,153.64100646972656,162.44749450683594,52.40443426401128,-47.595565735988714,-0.2741545754451522,-0.267518068347988,-0.011989909431229462,2195756000.0,1.0
AMZN,2020-12-16,162.04800415039062,162.35000610351562,158.1840057373047,158.80050659179688,88552000.0,3.7920074462890625,0.0,3.7920074462890625,68.70463985873948,153.64100646972656,162.44749450683594,95.46368138170503,-4.536318618294978,0.11207590532819722,-0.19159927361275095,0.017017457016319293,2284308000.0,1.0
AMZN,2020-12-17,161.8040008544922,163.17550659179688,161.0500030517578,162.5,69486000.0,-0.2440032958984375,0.2440032958984375,0.0,67.15081546930676,153.64100646972656,163.17550659179688,85.61533672719823,-14.384663272801761,0.3939362652743057,-0.0744921658353396,0.023240538439017744,2214822000.0,-1.0
AMZN,2020-12-18,160.08250427246094,162.4709930419922,158.5800018310547,162.19949340820312,119914000.0,-1.72149658203125,1.72149658203125,0.0,56.710010707580345,153.64100646972656,163.17550659179688,67.55989008614827,-32.44010991385174,0.47295036758015385,0.03499634084775912,0.013822105511969607,2094908000.0,-1.0
AMZN,2020-12-21,160.3090057373047,161.34849548339844,158.3000030517578,160.00050354003906,76736000.0,0.22650146484375,0.0,0.22650146484375,57.70828690944135,153.64100646972656,163.17550659179688,69.9354888269721,-30.064511173027896,0.5475347483232156,0.13750402234285045,0.009092678140305344,2171644000.0,1.0
AMZN,2020-12-22,160.3260040283203,161.10000610351562,159.00399780273438,160.14199829101562,47388000.0,0.016998291015625,0.0,0.016998291015625,57.79256880849518,153.64100646972656,163.17550659179688,70.11377075888248,-29.886229241117512,0.6010860812400551,0.23022043412229146,0.032961774970376556,2219032000.0,1.0
AMZN,2020-12-23,159.2635040283203,160.50650024414062,159.20849609375,160.25,41876000.0,-1.0625,1.0625,0.0,50.52985877589075,153.64100646972656,163.17550659179688,58.97002975099743,-41.02997024900257,0.5514344355601395,0.2944632344098611,0.02701289250122163,2177156000.0,-1.0
AMZN,2020-12-24,158.63450622558594,160.10000610351562,158.4499969482422,159.69500732421875,29038000.0,-0.628997802734375,0.628997802734375,0.0,46.535227956349466,153.64100646972656,163.17550659179688,52.37295811974977,-47.62704188025024,0.45607295777168133,0.32678517908222515,0.018056020019810326,2148118000.0,-1.0
AMZN,2020-12-28,164.197998046875,165.1999969482422,158.63450622558594,159.6999969482422,113736000.0,5.5634918212890625,0.0,5.5634918212890625,70.40940755784938,153.64100646972656,165.1999969482422,91.33143241851808,-8.668567581481922,0.8199734481876533,0.42542283290331084,0.040225296693717105,2261854000.0,1.0
AMZN,2020-12-29,166.10000610351562,167.53250122070312,164.06100463867188,165.4969940185547,97458000.0,1.902008056640625,0.0,1.902008056640625,74.84106163671062,153.64100646972656,167.53250122070312,89.6879699206826,-10.312030079317394,1.2474633810903413,0.589830942540717,0.0495653217746963,2359312000.0,1.0
AMZN,2020-12-30,164.29249572753906,167.10499572753906,164.12350463867188,167.0500030517578,64186000.0,-1.8075103759765625,1.8075103759765625,0.0,64.28424258073568,153.64100646972656,167.53250122070312,76.67633648325504,-23.323663516744965,1.4239864228733552,0.7566620386072447,0.013850781988437255,2295126000.0,-1.0
AMZN,2020-12-31,162.84649658203125,164.14599609375,162.05999755859375,163.75,59144000.0,-1.4459991455078125,1.4459991455078125,0.0,56.878382239731536,153.64100646972656,167.53250122070312,66.26709563891639,-33.73290436108362,1.4307098270073482,0.8914715962872655,0.0064429539568466865,2235982000.0,-1.0
AMZN,2021-01-04,159.3314971923828,163.60000610351562,157.2010040283203,163.5,88228000.0,-3.5149993896484375,3.5149993896484375,0.0,42.98777871282481,156.3000030517578,167.53250122070312,26.98860124461205,-73.01139875538796,1.1392742549611228,0.941032128022037,-0.0046913751349111354,2147754000.0,-1.0
AMZN,2021-01-05,160.92550659179688,161.16900634765625,158.2530059814453,158.30050659179688,53110000.0,1.5940093994140625,0.0,1.5940093994140625,49.44771456514045,156.52450561523438,167.53250122070312,39.98003936680436,-60.019960633195645,1.0251158040426276,0.9578488632261551,0.003845703188393834,2200864000.0,1.0
AMZN,2021-01-06,156.91900634765625,159.87550354003906,156.55799865722656,157.32400512695312,87896000.0,-4.006500244140625,4.006500244140625,0.0,37.21759397476711,156.55799865722656,167.53250122070312,3.2895130174840976,-96.7104869825159,0.6043863346234843,0.887156357505621,-0.02125043720332631,2112968000.0,-1.0
AMZN,2021-01-07,158.10800170898438,160.427001953125,157.75,157.85000610351562,70290000.0,1.188995361328125,0.0,1.188995361328125,42.11965298922602,156.55799865722656,167.53250122070312,14.123674788835206,-85.8763252111648,0.36271602297560435,0.7822682905996178,-0.007255286302946473,2183258000.0,1.0
AMZN,2021-01-08,159.13499450683594,159.53199768066406,157.11000061035156,159.0,70754000.0,1.0269927978515625,0.0,1.0269927978515625,46.29855061335532,156.55799865722656,167.53250122070312,23.4816642914248,-76.51833570857521,0.25116502150160613,0.6760476367800156,0.0031549773952603832,2254012000.0,1.0
AMZN,2021-01-11,155.7104949951172,157.81900024414062,155.5,157.40049743652344,73668000.0,-3.42449951171875,3.42449951171875,0.0,36.2334538054305,155.5,167.53250122070312,1.7493868586109906,-98.25061314138901,-0.11227421389085634,0.5183832666458412,-0.051690660986833836,2180344000.0,-1.0
AMZN,2021-01-12,156.04150390625,157.10699462890625,154.3000030517578,156.0,70292000.0,0.3310089111328125,0.0,0.3310089111328125,37.74294172069797,154.3000030517578,167.53250122070312,13.160786665206036,-86.83921333479397,-0.36933530614325605,0.3408395520880217,-0.06055690444103323,2250636000.0,1.0
AMZN,2021-01-13,158.29449462890625,159.49749755859375,156.10400390625,156.4219970703125,66424000.0,2.25299072265625,0.0,2.25299072265625,47.50274313483497,154.3000030517578,167.53250122070312,30.186980010493482,-69.81301998950651,-0.3868017420951446,0.1953112932513884,-0.036508064912348925,2317060000.0,1.0
AMZN,2021-01-14,156.37350463867188,158.89999389648438,156.0294952392578,158.37600708007812,61418000.0,-1.920989990234375,1.920989990234375,0.0,41.15538935484452,154.3000030517578,167.53250122070312,15.66976666416822,-84.33023333583178,-0.5493196411181032,0.04638510637749006,-0.039749040226350285,2255642000.0,-1.0
AMZN,2021-01-15,155.21249389648438,157.12750244140625,154.7584991455078,156.1510009765625,84880000.0,-1.1610107421875,1.1610107421875,0.0,37.647327734863346,154.3000030517578,167.53250122070312,6.895832012038676,-93.10416798796133,-0.7630046678923748,-0.11549284847648296,-0.02585178303399105,2170762000.0,-1.0
AMZN,2021-01-19,156.03799438476562,157.25,154.8000030517578,155.35000610351562,66102000.0,0.82550048828125,0.0,0.82550048828125,41.72271437295903,154.3000030517578,167.53250122070312,13.134264677901996,-86.865735322098,-0.855874611054503,-0.263569200992087,-0.030371271220720142,2236864000.0,1.0
AMZN,2021-01-20,163.16900634765625,163.99000549316406,158.75,159.09950256347656,106196000.0,7.131011962890625,0.0,7.131011962890625,64.71190551514444,154.3000030517578,167.10499572753906,69.26207238425717,-30.737927615742837,-0.3500267512847586,-0.2808607110506213,0.039829464546525584,2343060000.0,1.0
AMZN,2021-01-21,165.34950256347656,167.42750549316406,164.47850036621094,164.64999389648438,98722000.0,2.1804962158203125,0.0,2.1804962158203125,69.02324634255734,154.3000030517578,167.42750549316406,84.17061479163664,-15.82938520836336,0.2242244236724673,-0.17984368410600357,0.04580097639726666,2441782000.0,1.0
AMZN,2021-01-22,164.6114959716797,166.0955047607422,164.1580047607422,165.2154998779297,56438000.0,-0.738006591796875,0.738006591796875,0.0,65.87991619693369,154.3000030517578,167.42750549316406,78.54877929710202,-21.451220702897977,0.6127087281415413,-0.021333201656494556,0.034414187035451294,2385344000.0,-1.0
AMZN,2021-01-25,164.6999969482422,168.1945037841797,162.15750122070312,166.4250030517578,74996000.0,0.0885009765625,0.0,0.0885009765625,66.09357087148769,154.3000030517578,168.1945037841797,74.84971282355396,-25.15028717644604,0.9171542442549594,0.1663642875257963,0.05773215192339398,2460340000.0,1.0
AMZN,2021-01-26,166.30650329589844,166.89999389648438,164.14349365234375,164.8179931640625,59104000.0,1.60650634765625,0.0,1.60650634765625,70.0249467046333,154.3000030517578,168.1945037841797,86.41188679866899,-13.588113201331007,1.2733823856916615,0.3877679071589694,0.06578377632027732,2519444000.0,1.0
AMZN,2021-01-27,161.62899780273438,167.3260040283203,160.35400390625,167.07449340820312,93204000.0,-4.6775054931640625,4.6775054931640625,0.0,50.39465501267291,154.3000030517578,168.1945037841797,52.7474494558473,-47.2525505441527,1.164832686708337,0.543180863068843,0.021065187274170727,2426240000.0,-1.0
AMZN,2021-01-28,161.88099670410156,165.08399963378906,161.4344940185547,161.7519989013672,62984000.0,0.2519989013671875,0.0,0.2519989013671875,51.24428867537132,154.3000030517578,168.1945037841797,54.561108731701424,-45.438891268298576,1.0866146561242829,0.651867621679931,0.03522011019805249,2489224000.0,1.0
AMZN,2021-01-29,160.30999755859375,161.84950256347656,159.2274932861328,161.5,85872000.0,-1.5709991455078125,1.5709991455078125,0.0,45.62327200258289,154.3000030517578,168.1945037841797,43.2544833569444,-56.7455166430556,0.8876277812623243,0.6990196535964097,0.032842096239424245,2403352000.0,-1.0
AMZN,2021-02-01,167.1439971923828,167.51300048828125,161.75149536132812,162.1179962158203,83204000.0,6.8339996337890625,0.0,6.8339996337890625,64.93124439050271,154.3000030517578,168.1945037841797,92.43940741716908,-7.560592582830912,1.2667733308371112,0.8125703890445501,0.07117499075405642,2486556000.0,1.0
AMZN,2021-02-02,169.0,171.38699340820312,168.05650329589844,169.0,141972000.0,1.8560028076171875,0.0,1.8560028076171875,68.44261151277016,154.7584991455078,171.38699340820312,85.64516203034599,-14.354837969654008,1.6974457279541184,0.989545456826464,0.03573591445375324,2628528000.0,1.0
AMZN,2021-02-03,165.62649536132812,171.6999969482422,165.43099975585938,171.25050354003906,141776000.0,-3.373504638671875,3.373504638671875,0.0,56.56443158160595,154.7584991455078,171.6999969482422,64.15014978230677,-35.84985021769322,1.7464115298555498,1.1409186714322812,0.0016751958340197604,2486752000.0,-1.0
AMZN,2021-02-04,166.5500030517578,167.35000610351562,163.8874969482422,166.5,73414000.0,0.9235076904296875,0.0,0.9235076904296875,58.82177710007036,154.7584991455078,171.6999969482422,69.60130706003362,-30.398692939966388,1.8385430532756573,1.2804435478009566,0.01177625577506225,2560166000.0,1.0
AMZN,2021-02-05,167.6074981689453,168.85000610351562,165.135498046875,165.9499969482422,72416000.0,1.0574951171875,0.0,1.0574951171875,61.46762040851089,154.8000030517578,171.6999969482422,75.78402214601854,-24.215977853981464,1.974132397984306,1.4191813178376267,0.01765331678552995,2632582000.0,1.0
AMZN,2021-02-08,166.14700317382812,168.25,165.1999969482422,167.9250030517578,65148000.0,-1.4604949951171875,1.4604949951171875,0.0,55.758404491798615,158.75,171.6999969482422,57.119729088678916,-42.880270911321084,1.9413594075518574,1.523616935780473,-0.0009590732707940308,2567434000.0,-1.0
AMZN,2021-02-09,165.25,166.89999389648438,164.89199829101562,165.62449645996094,44070000.0,-0.897003173828125,0.897003173828125,0.0,52.31492509771809,159.2274932861328,171.6999969482422,48.28626935715526,-51.71373064284474,1.822003000555327,1.583294148735444,0.022403171748209383,2523364000.0,-1.0
AMZN,2021-02-10,164.32899475097656,165.8975067138672,162.6999969482422,165.6999969482422,63032000.0,-0.9210052490234375,0.9210052490234375,0.0,48.748260231979316,159.2274932861328,171.6999969482422,40.90198410076854,-59.09801589923146,1.6342560749463075,1.593486533977617,0.015122207650782205,2460332000.0,-1.0
AMZN,2021-02-11,163.10650634765625,164.60000610351562,162.4029998779297,164.60000610351562,46028000.0,-1.2224884033203125,1.2224884033203125,0.0,44.13939872486466,159.2274932861328,171.6999969482422,31.100516517045552,-68.89948348295445,1.371016462061732,1.54899251959444,0.017444381708261014,2414304000.0,-1.0
AMZN,2021-02-12,163.885498046875,164.0124969482422,161.66549682617188,162.5,46706000.0,0.77899169921875,0.0,0.77899169921875,47.77009376609608,159.2274932861328,171.6999969482422,37.34618875994314,-62.65381124005687,1.2112922688395997,1.481452469443472,-0.019495161060180233,2461010000.0,1.0
AMZN,2021-02-16,163.44749450683594,165.4149932861328,162.67950439453125,162.70249938964844,51494000.0,-0.4380035400390625,0.4380035400390625,0.0,45.83725569368438,159.2274932861328,171.6999969482422,33.834435611538076,-66.16556438846193,1.0374078775898852,1.3926435510727548,-0.032855062089728215,2409516000.0,-1.0
AMZN,2021-02-17,165.4320068359375,166.04550170898438,162.97500610351562,163.17999267578125,65950000.0,1.9845123291015625,0.0,1.9845123291015625,55.293777721065844,159.2274932861328,171.6999969482422,49.745533999349156,-50.254466000650844,1.0476600317043676,1.3236468471990774,-0.0011742597400634658,2475466000.0,1.0
AMZN,2021-02-18,166.4114990234375,166.89999389648438,163.69700622558594,164.12100219726562,60548000.0,0.9794921875,0.0,0.9794921875,59.33698016955555,159.2274932861328,171.6999969482422,57.5987462655891,-42.4012537344109,1.121889329416291,1.2832953436425203,-0.0008316062790900691,2536014000.0,1.0
AMZN,2021-02-19,162.4949951171875,166.6750030517578,162.28750610351562,166.4114990234375,86104000.0,-3.91650390625,3.91650390625,0.0,41.86749841673841,161.66549682617188,171.6999969482422,8.266463510137298,-91.7335364898627,0.8548334610571544,1.1976029671254471,-0.030502830169354955,2449910000.0,-1.0
AMZN,2021-02-22,159.03700256347656,161.61599731445312,158.61300659179688,160.406494140625,70314000.0,-3.4579925537109375,3.4579925537109375,0.0,32.207364171272744,158.61300659179688,171.6999969482422,3.2398279522752946,-96.76017204772471,0.3600087057186272,1.0300841148440831,-0.042793432770574014,2379596000.0,-1.0
AMZN,2021-02-23,159.72500610351562,160.2364959716797,154.67999267578125,156.35150146484375,93544000.0,0.6880035400390625,0.0,0.6880035400390625,35.61762553515189,154.67999267578125,171.6999969482422,29.64166957288849,-70.3583304271115,0.023106302801892298,0.8286885524356449,-0.03343415368523073,2473140000.0,1.0
AMZN,2021-02-24,157.97650146484375,158.56149291992188,156.2689971923828,158.33749389648438,60226000.0,-1.748504638671875,1.748504638671875,0.0,31.038983807676757,154.67999267578125,168.85000610351562,23.263977877468918,-76.73602212253108,-0.38059374245713684,0.5868320934570885,-0.038657166349489014,2412914000.0,-1.0
AMZN,2021-02-25,152.85800170898438,158.91299438476562,152.38800048828125,156.83700561523438,90676000.0,-5.118499755859375,5.118499755859375,0.0,21.641933357499653,152.38800048828125,168.85000610351562,2.8550665799079393,-97.14493342009206,-1.100859071839352,0.24929386039780033,-0.06283320554256444,2322238000.0,-1.0
AMZN,2021-02-26,154.64649963378906,156.1219940185547,151.8350067138672,154.75999450683594,85518000.0,1.7884979248046875,0.0,1.7884979248046875,30.165961633681633,151.8350067138672,168.25,17.127591043835455,-82.87240895616455,-1.5099519134529658,-0.10255529437235299,-0.05637471602547395,2407756000.0,1.0
AMZN,2021-03-01,157.3070068359375,157.47799682617188,154.89950561523438,156.39450073242188,54582000.0,2.6605072021484375,0.0,2.6605072021484375,41.1536131583792,151.8350067138672,166.89999389648438,36.32263377153223,-63.67736622846777,-1.6010246261065788,-0.4022491607191983,-0.037568564078794275,2462338000.0,1.0
AMZN,2021-03-02,154.72650146484375,158.17599487304688,154.3560028076172,157.17349243164062,51916000.0,-2.58050537109375,2.58050537109375,0.0,34.99199647495554,151.8350067138672,166.89999389648438,19.193476343032863,-80.80652365696714,-1.8599848764055196,-0.6937963038564627,-0.06471241917358006,2410422000.0,-1.0
AMZN,2021-03-03,150.25,155.38900756835938,149.75,154.0590057373047,79774000.0,-4.47650146484375,4.47650146484375,0.0,26.923393081375735,149.75,166.89999389648438,2.9154529326246372,-97.08454706737535,-2.3987773844526714,-1.0347925199757046,-0.09711768188063319,2330648000.0,-1.0
AMZN,2021-03-04,148.8784942626953,152.906494140625,147.27149963378906,150.60000610351562,109632000.0,-1.3715057373046875,1.3715057373046875,0.0,24.894151385760026,147.27149963378906,166.89999389648438,8.187049945855518,-91.81295005414448,-2.902979637484947,-1.4084299434775531,-0.08379643228194378,2221016000.0,-1.0
AMZN,2021-03-05,150.0229949951172,150.4499969482422,144.0500030517578,150.25,107772000.0,1.144500732421875,0.0,1.144500732421875,29.97595123820024,144.0500030517578,166.89999389648438,26.140018978335185,-73.85998102166482,-3.1736282999621324,-1.7614696147744695,-0.0566786812066683,2328788000.0,1.0
AMZN,2021-03-08,147.59750366210938,153.22950744628906,147.5655059814453,150.75,83700000.0,-2.4254913330078125,2.4254913330078125,0.0,25.72042310316428,144.0500030517578,166.89999389648438,15.525173005354937,-84.47482699464507,-3.542994756650984,-2.1177746431497724,-0.07592738755975736,2245088000.0,-1.0
AMZN,2021-03-09,153.1425018310547,154.54800415039062,150.25750732421875,150.89950561523438,80600000.0,5.5449981689453125,0.0,5.5449981689453125,45.958101045210846,144.0500030517578,166.89999389648438,39.79213313949877,-60.20786686050123,-3.3496723858469863,-2.3641541916892153,-0.030599485296646023,2325688000.0,1.0
AMZN,2021-03-10,152.8820037841797,155.822998046875,151.50250244140625,154.92250061035156,60250000.0,-0.260498046875,0.260498046875,0.0,45.28923793613571,144.0500030517578,166.6750030517578,39.03646732562155,-60.96353267437845,-3.1808165562093507,-2.5274866645932423,0.0001570220395854527,2265438000.0,-1.0
AMZN,2021-03-11,155.67950439453125,156.58900451660156,154.14649963378906,155.20050048828125,55528000.0,2.7975006103515625,0.0,2.7975006103515625,53.64824961351516,144.0500030517578,161.61599731445312,66.20462906259094,-33.79537093740906,-2.7891110392340295,-2.5798115395214,0.006679781069655055,2320966000.0,1.0
AMZN,2021-03-12,154.47450256347656,154.94900512695312,152.27499389648438,153.75,48438000.0,-1.2050018310546875,1.2050018310546875,0.0,49.86193482121642,144.0500030517578,160.2364959716797,64.40245928065475,-35.59754071934525,-2.5465600134266992,-2.57316123430246,-0.01800621809183034,2272528000.0,-1.0
AMZN,2021-03-15,154.08399963378906,154.11199951171875,151.60450744628906,153.72850036621094,58272000.0,-0.3905029296875,0.3905029296875,0.0,48.579892944735505,144.0500030517578,158.91299438476562,67.50994034254528,-32.490059657454715,-2.358657762371621,-2.5302605399162923,-0.004152500217945332,2214256000.0,-1.0
AMZN,2021-03-16,154.59300231933594,156.44549560546875,153.79299926757812,155.24850463867188,50776000.0,0.509002685546875,0.0,0.509002685546875,50.494290188373384,144.0500030517578,158.91299438476562,70.93457185946261,-29.065428140537396,-2.1439574054370496,-2.452999913020444,0.028905173506395654,2265032000.0,1.0
AMZN,2021-03-17,156.7864990234375,158.65249633789062,153.51100158691406,153.66099548339844,62372000.0,2.1934967041015625,0.0,2.1934967041015625,58.22741852680311,144.0500030517578,158.65249633789062,87.22137872013158,-12.778621279868421,-1.7763325180020217,-2.3176664340167594,0.05311717316799669,2327404000.0,1.0
AMZN,2021-03-18,151.39950561523438,155.8314971923828,151.25,155.0500030517578,72992000.0,-5.386993408203125,5.386993408203125,0.0,40.3615216851609,144.0500030517578,158.65249633789062,50.33046356854677,-49.66953643145324,-1.8977958835407378,-2.2336923239215554,0.009175330889521272,2254412000.0,-1.0
AMZN,2021-03-19,153.7480010986328,153.864501953125,150.8314971923828,151.4615020751953,92508000.0,2.3484954833984375,0.0,2.3484954833984375,48.33558999583365,144.0500030517578,158.65249633789062,66.41330255624672,-33.58669744375327,-1.7839878164676577,-2.143751422430776,0.041670741604164174,2346920000.0,1.0
AMZN,2021-03-22,155.5435028076172,156.32899475097656,153.00250244140625,153.3925018310547,58044000.0,1.795501708984375,0.0,1.795501708984375,53.786469100111816,144.0500030517578,158.65249633789062,78.70915966641205,-21.29084033358795,-1.5312607009120995,-2.0212532781270407,0.015678214394141632,2404964000.0,1.0
AMZN,2021-03-23,156.875,159.10000610351562,156.04249572753906,156.35000610351562,76346000.0,1.3314971923828125,0.0,1.3314971923828125,57.61303935442973,144.0500030517578,159.10000610351562,85.21590928677088,-14.784090713229114,-1.2095885614067186,-1.8589203347829761,0.026118157251896923,2481310000.0,1.0
AMZN,2021-03-24,154.35350036621094,158.0155029296875,154.25750732421875,157.552001953125,59180000.0,-2.5214996337890625,2.5214996337890625,0.0,48.78621944901537,144.0500030517578,159.10000610351562,68.46176229346143,-31.53823770653857,-1.1449270147782897,-1.716121670782039,-0.008517524727981396,2422130000.0,-1.0
AMZN,2021-03-25,152.31300354003906,155.48899841308594,151.85699462890625,153.64950561523438,71270000.0,-2.040496826171875,2.040496826171875,0.0,42.68048704599497,147.5655059814453,159.10000610351562,41.15910970003638,-58.84089029996362,-1.2439933331502004,-1.621696003255671,-0.013992594166466366,2350860000.0,-1.0
AMZN,2021-03-26,152.60150146484375,152.83299255371094,149.8000030517578,152.2030029296875,66258000.0,0.2884979248046875,0.0,0.2884979248046875,43.82737242830076,149.8000030517578,159.10000610351562,30.12362896543803,-69.87637103456197,-1.2844187528807254,-1.5542405531806822,-0.009621363493086621,2417118000.0,1.0
AMZN,2021-03-29,153.7864990234375,154.5625,151.42250061035156,152.77200317382812,54920000.0,1.18499755859375,0.0,1.18499755859375,48.692774389981984,149.8000030517578,159.10000610351562,42.8655340164237,-57.1344659835763,-1.2069241197606857,-1.4847772664966832,-0.005216945681878138,2472038000.0,1.0
AMZN,2021-03-30,152.76449584960938,153.64999389648438,151.6999969482422,153.50050354003906,46752000.0,-1.022003173828125,1.022003173828125,0.0,44.828803631481826,149.8000030517578,159.10000610351562,31.876256183499187,-68.12374381650082,-1.2139821490461316,-1.430618243006573,-0.025652739227418397,2425286000.0,-1.0
AMZN,2021-03-31,154.70399475097656,155.9665069580078,153.125,153.2030029296875,61878000.0,1.9394989013671875,0.0,1.9394989013671875,52.99626165471557,149.8000030517578,159.10000610351562,52.731076236494744,-47.268923763505256,-1.0509595285920454,-1.3546865001236676,0.02182628749224702,2487164000.0,1.0
AMZN,2021-04-01,158.0500030517578,158.1219940185547,155.77749633789062,155.89700317382812,58806000.0,3.34600830078125,0.0,3.34600830078125,63.6948814049029,149.8000030517578,159.10000610351562,88.70964830963847,-11.290351690361534,-0.6443404654623066,-1.2126172931913954,0.027980864286913043,2545970000.0,1.0
AMZN,2021-04-05,161.3365020751953,161.79800415039062,158.06199645996094,158.64999389648438,66698000.0,3.2864990234375,0.0,3.2864990234375,71.13965194666143,149.8000030517578,161.79800415039062,96.15350864363647,-3.84649135636353,-0.056250502851469264,-0.9813439351234102,0.037243595283714015,2612668000.0,1.0
AMZN,2021-04-06,161.1909942626953,162.36549377441406,160.8520050048828,161.1875,50756000.0,-0.1455078125,0.1455078125,0.0,70.40213837193906,149.8000030517578,162.36549377441406,90.65297537802431,-9.347024621975685,0.3935373119047654,-0.7063676857177751,0.02751231402514942,2561912000.0,-1.0
AMZN,2021-04-07,163.96949768066406,165.1804962158203,161.1824951171875,161.69000244140625,66924000.0,2.77850341796875,0.0,2.77850341796875,75.90571332976548,149.8000030517578,165.1804962158203,92.12639983491671,-7.873600165083296,0.9630974130778043,-0.3724746659586592,0.06229853739396085,2628836000.0,1.0
AMZN,2021-04-08,164.96499633789062,166.22500610351562,164.60000610351562,165.5449981689453,56242000.0,0.9954986572265625,0.0,0.9954986572265625,77.62565063146609,149.8000030517578,166.22500610351562,92.32870909275019,-7.671290907249804,1.4777714887814568,-0.002425435010635902,0.08306574293589897,2685078000.0,1.0
AMZN,2021-04-09,168.61000061035156,168.61000061035156,164.44500732421875,165.23500061035156,86830000.0,3.6450042724609375,0.0,3.6450042724609375,82.8098663585168,149.8000030517578,168.61000061035156,100.0,-0.0,2.154935034337967,0.4290466588590849,0.10490394256832292,2771908000.0,1.0
AMZN,2021-04-12,168.96949768066406,169.7519989013672,167.5574951171875,167.760498046875,65636000.0,0.3594970703125,0.0,0.3594970703125,83.25149171697689,149.8000030517578,169.7519989013672,96.07808047575128,-3.921919524248723,2.6895964384952435,0.8811566147863168,0.09872777359287332,2837544000.0,1.0
AMZN,2021-04-13,170.0,171.60000610351562,169.781494140625,170.04249572753906,66316000.0,1.0305023193359375,0.0,1.0305023193359375,84.5631896756076,149.8000030517578,171.60000610351562,92.66052348838268,-7.339476511617327,3.1600453425697594,1.3369343603430055,0.1128240174821662,2903860000.0,1.0
AMZN,2021-04-14,166.64999389648438,170.2064971923828,166.3000030517578,170.20199584960938,62904000.0,-3.350006103515625,3.350006103515625,0.0,65.36201925178537,149.8000030517578,171.60000610351562,77.2935251647494,-22.7064748352506,3.2253817994161977,1.7146238481576441,0.07721842713070859,2840956000.0,-1.0
AMZN,2021-04-15,168.95449829101562,169.85000610351562,167.60000610351562,168.5500030517578,64672000.0,2.30450439453125,0.0,2.30450439453125,70.65149034115703,149.8000030517578,171.60000610351562,87.86464476074151,-12.135355239258478,3.4236499517839434,2.056429068882904,0.0689939577899712,2905628000.0,1.0
AMZN,2021-04-16,169.9720001220703,170.33999633789062,167.7794952392578,169.0,63720000.0,1.0175018310546875,0.0,1.0175018310546875,72.76992052489474,151.42250061035156,171.60000610351562,91.93157954041016,-8.068420459589836,3.6211405311660485,2.369371361339533,0.053524763062299474,2969348000.0,1.0
AMZN,2021-04-19,168.60049438476562,171.79649353027344,168.00799560546875,169.51649475097656,54508000.0,-1.3715057373046875,1.3715057373046875,0.0,65.42507496481113,151.6999969482422,171.79649353027344,84.09673480916355,-15.90326519083645,3.625195193733873,2.620536127818401,0.045967208999250664,2914840000.0,-1.0
AMZN,2021-04-20,166.7344970703125,169.14950561523438,165.8000030517578,168.67999267578125,52460000.0,-1.865997314453125,1.865997314453125,0.0,56.47639409856363,153.125,171.79649353027344,72.88917219314267,-27.110827806857323,3.438204671303879,2.784069836515497,0.016862888700393208,2862380000.0,-1.0
AMZN,2021-04-21,168.1009979248047,168.14300537109375,165.1905059814453,165.8000030517578,44224000.0,1.3665008544921875,0.0,1.3665008544921875,60.985473954211535,155.77749633789062,171.79649353027344,76.93054339739822,-23.069456602601775,3.361528920796502,2.8995616533716984,0.01901010309175355,2906604000.0,1.0
AMZN,2021-04-22,165.45199584960938,168.64349365234375,165.07249450683594,168.58399963378906,51612000.0,-2.6490020751953125,2.6490020751953125,0.0,49.512023790774016,158.06199645996094,171.79649353027344,53.806115737736974,-46.193884262263026,3.0518309003477384,2.930015502766907,-0.01872964088316542,2854992000.0,-1.0
AMZN,2021-04-23,167.04400634765625,168.75,165.4250030517578,165.9550018310547,63856000.0,1.592010498046875,0.0,1.592010498046875,55.338577062426225,160.8520050048828,171.79649353027344,56.57643414224728,-43.42356585775272,2.9014092898637216,2.92429426018627,-0.011395496580375752,2918848000.0,1.0
AMZN,2021-04-26,170.4499969482422,171.42250061035156,166.5469970703125,167.39999389648438,97614000.0,3.4059906005859375,0.0,3.4059906005859375,65.24091102021552,161.1824951171875,171.79649353027344,87.31395531045905,-12.686044689540957,3.022196061297052,2.943874620408427,0.0026470408720129512,3016462000.0,1.0
AMZN,2021-04-27,170.8715057373047,173.0,169.90049743652344,172.17349243164062,76542000.0,0.4215087890625,0.0,0.4215087890625,66.30762440112241,164.44500732421875,173.0,75.11985873791602,-24.88014126208397,3.1160132236691425,2.9783023410605702,0.025331605133106283,3093004000.0,1.0
AMZN,2021-04-28,172.9250030517578,174.49400329589844,171.25,171.74000549316406,92638000.0,2.053497314453125,0.0,2.053497314453125,71.26474830660953,164.44500732421875,174.49400329589844,84.38649743156014,-15.613502568439849,3.317818327834175,3.0462055384152915,0.023500438289030923,3185642000.0,1.0
AMZN,2021-04-29,173.5655059814453,175.72250366210938,171.75,175.2550048828125,153648000.0,0.6405029296875,0.0,0.6405029296875,72.70978851086727,165.07249450683594,175.72250366210938,79.7465180619492,-20.2534819380508,3.489212095256306,3.134806849783495,0.02114175191675227,3339290000.0,1.0
AMZN,2021-04-30,173.37100219726562,177.6999969482422,173.125,176.25599670410156,140186000.0,-0.1945037841796875,0.1945037841796875,0.0,71.45078548553849,165.07249450683594,177.6999969482422,65.71772786373369,-34.28227213626631,3.568215889282044,3.2214886576832056,0.028294743914648146,3199104000.0,-1.0
AMZN,2021-05-03,169.32449340820312,174.33250427246094,168.63499450683594,174.2364959716797,117510000.0,-4.0465087890625,4.0465087890625,0.0,50.47184972228317,165.07249450683594,177.6999969482422,33.67252488049147,-66.32747511950853,3.2666515978484654,3.230521245716258,0.01553365610236268,3081594000.0,-1.0
AMZN,2021-05-04,165.593505859375,168.3990020751953,163.60650634765625,167.8094940185547,108788000.0,-3.730987548828125,3.730987548828125,0.0,38.45858672550944,163.60650634765625,177.6999969482422,14.098703919638902,-85.9012960803611,2.695527843141093,3.1235225652012253,-0.01491658048663902,2972806000.0,-1.0
AMZN,2021-05-05,163.52699279785156,167.73500061035156,163.21800231933594,166.9429931640625,74226000.0,-2.0665130615234375,2.0665130615234375,0.0,33.38083744723025,163.21800231933594,177.6999969482422,2.133618237220417,-97.86638176277958,2.052497901148257,2.909317632390632,-0.011634813118287068,2898580000.0,-1.0
AMZN,2021-05-06,165.31849670410156,165.72000122070312,162.36000061035156,163.5,88954000.0,1.79150390625,0.0,1.79150390625,41.152808664423034,162.36000061035156,177.6999969482422,19.28615906147483,-80.71384093852517,1.6682212165960664,2.661098349231719,-0.010329671092559334,2987534000.0,1.0
AMZN,2021-05-07,164.58050537109375,166.54449462890625,164.45350646972656,165.95449829101562,94206000.0,-0.7379913330078125,0.7379913330078125,0.0,38.99071444163489,162.36000061035156,177.6999969482422,14.475262652165178,-85.52473734783483,1.289267568612047,2.3867321931077847,-0.03443526947630704,2893328000.0,-1.0
AMZN,2021-05-10,159.52450561523438,164.14999389648438,159.5,164.11599731445312,116772000.0,-5.055999755859375,5.055999755859375,0.0,27.549119889418748,159.5,177.6999969482422,0.13464626012886133,-99.86535373987114,0.5743464386018218,2.024255042206592,-0.0664066256869944,2776556000.0,-1.0
AMZN,2021-05-11,161.19549560546875,161.89999389648438,156.36849975585938,156.81399536132812,92396000.0,1.670989990234375,0.0,1.670989990234375,34.84062193673087,156.36849975585938,177.6999969482422,22.628490659028984,-77.37150934097102,0.14097613438300982,1.6475992606418755,-0.06783002596089782,2868952000.0,1.0
AMZN,2021-05-12,157.5970001220703,160.39700317382812,156.65499877929688,159.25,98728000.0,-3.5984954833984375,3.5984954833984375,0.0,27.870849956400107,156.36849975585938,177.6999969482422,5.759091146446196,-94.2409088535538,-0.4872250386441408,1.2206344007846723,-0.09200276154573062,2770224000.0,-1.0
AMZN,2021-05-13,158.07350158691406,160.19200134277344,156.64999389648438,159.27349853515625,67018000.0,0.47650146484375,0.0,0.47650146484375,30.010088909141587,156.36849975585938,177.6999969482422,7.992884023459547,-92.00711597654046,-0.9358415099042645,0.7893392186468849,-0.08823563581264704,2837242000.0,1.0
AMZN,2021-05-14,161.14500427246094,161.4429931640625,159.14999389648438,159.2779998779297,66500000.0,3.071502685546875,0.0,3.071502685546875,42.65888479785397,156.36849975585938,177.6999969482422,22.39179216312668,-77.60820783687332,-1.0316366334422469,0.42514404822905855,-0.048306591510203334,2903742000.0,1.0
AMZN,2021-05-17,163.51950073242188,164.6374969482422,161.72950744628906,162.29649353027344,74478000.0,2.3744964599609375,0.0,2.3744964599609375,50.61935995287316,156.36849975585938,177.6999969482422,33.52320238973205,-66.47679761026795,-0.9055147290560228,0.1590122927720422,-0.012524676714764427,2978220000.0,1.0
AMZN,2021-05-18,161.61399841308594,165.60000610351562,161.51849365234375,164.62899780273438,56568000.0,-1.9055023193359375,1.9055023193359375,0.0,44.853606275459875,156.36849975585938,177.6999969482422,24.590391428781935,-75.40960857121807,-0.9483878980555858,-0.06246774539348345,-0.011698340145778974,2921652000.0,-1.0
AMZN,2021-05-19,161.58999633789062,161.7375030517578,159.1999969482422,159.75,53594000.0,-0.0240020751953125,0.0240020751953125,0.0,44.77947428813048,156.36849975585938,177.6999969482422,24.477872016858598,-75.5221279831414,-0.9730848438906889,-0.2445911650929246,-0.022553437398384224,2868058000.0,-1.0
AMZN,2021-05-20,162.38400268554688,162.98399353027344,161.8090057373047,162.22000122070312,52664000.0,0.79400634765625,0.0,0.79400634765625,48.05637739406667,156.36849975585938,174.33250427246094,33.48642516833165,-66.51357483166835,-0.9180054792034014,-0.3792740279150201,-0.013346068421616675,2920722000.0,1.0
AMZN,2021-05-21,160.1540069580078,162.83450317382812,159.85049438476562,162.5,82098000.0,-2.2299957275390625,2.2299957275390625,0.0,40.30543305487992,156.36849975585938,168.3990020751953,31.46591141139808,-68.53408858860192,-1.0422819269673766,-0.5118756077254915,0.003946110601287689,2838624000.0,-1.0
AMZN,2021-05-24,162.24949645996094,162.8975067138672,160.52499389648438,160.77499389648438,48456000.0,2.095489501953125,0.0,2.095489501953125,49.1907990052428,156.36849975585938,167.73500061035156,51.73972869387783,-48.26027130612218,-0.9606101018182187,-0.6016225065440369,0.006538649548073483,2887080000.0,1.0
AMZN,2021-05-25,162.95249938964844,163.99099731445312,160.68800354003906,163.33349609375,65222000.0,0.7030029296875,0.0,0.7030029296875,51.95884622578882,156.36849975585938,166.54449462890625,64.70128686118034,-35.298713138819664,-0.8295950751671626,-0.6472170202686621,0.033982241181176764,2952302000.0,1.0
AMZN,2021-05-26,163.25799560546875,164.7864990234375,162.92550659179688,163.72950744628906,47680000.0,0.3054962158203125,0.0,0.3054962158203125,53.2362753992629,156.36849975585938,166.54449462890625,67.70341313612059,-32.29658686387942,-0.6931238310855008,-0.65639838243203,0.03279799565712849,2999982000.0,1.0
AMZN,2021-05-27,161.5054931640625,163.01800537109375,161.5019989013672,162.8000030517578,51224000.0,-1.75250244140625,1.75250244140625,0.0,45.26876325251226,156.36849975585938,165.60000610351562,55.64631832276577,-44.35368167723423,-0.7181038336852055,-0.6687394726826651,0.002237046647701524,2948758000.0,-1.0
AMZN,2021-05-28,161.15350341796875,162.39950561523438,160.98500061035156,162.10000610351562,46596000.0,-0.35198974609375,0.35198974609375,0.0,43.75127589682758,156.36849975585938,165.60000610351562,51.8334005514086,-48.1665994485914,-0.7575704954253695,-0.686505677231206,-0.014469205836952548,2902162000.0,-1.0
AMZN,2021-06-01,160.9324951171875,162.5489959716797,160.4530029296875,162.1750030517578,48600000.0,-0.22100830078125,0.22100830078125,0.0,42.71393263589167,156.64999389648438,165.60000610351562,47.84911038823762,-52.15088961176237,-0.7974886789544655,-0.708702277575858,-0.0042168580852539606,2853562000.0,-1.0
AMZN,2021-06-02,161.69949340820312,161.75,160.39999389648438,161.15499877929688,40290000.0,0.766998291015625,0.0,0.766998291015625,47.68125977615434,156.64999389648438,165.60000610351562,56.41891200720146,-43.581087992798544,-0.7584903701404073,-0.7186598960887679,0.0006776228281084595,2893852000.0,1.0
AMZN,2021-06-03,159.35049438476562,160.7220001220703,159.20150756835938,160.2115020751953,47966000.0,-2.3489990234375,2.3489990234375,0.0,36.497788031677025,159.14999389648438,165.60000610351562,3.1085288189483045,-96.89147118105168,-0.9066769121682228,-0.756263299304659,-0.018681078496725845,2845886000.0,-1.0
AMZN,2021-06-04,160.31100463867188,161.0500030517578,159.9405059814453,160.60000610351562,44994000.0,0.96051025390625,0.0,0.96051025390625,42.824866058046766,159.1999969482422,165.60000610351562,17.359470330042367,-82.64052966995763,-0.9358230782639794,-0.7921752550965232,0.0009802919305368363,2890880000.0,1.0
AMZN,2021-06-07,159.90049743652344,160.39999389648438,158.61000061035156,159.8665008544922,44316000.0,-0.4105072021484375,0.4105072021484375,0.0,40.819257738835155,158.61000061035156,165.60000610351562,18.462028784296773,-81.53797121570322,-0.9807407563934021,-0.829888355355899,-0.014477696847688959,2846564000.0,-1.0
AMZN,2021-06-08,163.20550537109375,163.97650146484375,160.90049743652344,161.1304931640625,68334000.0,3.3050079345703125,0.0,3.3050079345703125,58.76080577716561,158.61000061035156,164.7864990234375,74.40307522796165,-25.596924772038353,-0.7411087800176404,-0.8121324402882475,0.0015526363964526446,2914898000.0,1.0
AMZN,2021-06-09,164.0574951171875,164.87899780273438,163.53500366210938,163.64349365234375,49110000.0,0.85198974609375,0.0,0.85198974609375,62.17197266105685,158.61000061035156,164.87899780273438,86.8957879492266,-13.104212050773405,-0.4769522514877451,-0.7450964025281471,0.004897153788723685,2964008000.0,1.0
AMZN,2021-06-10,167.4824981689453,167.5500030517578,164.0574951171875,164.10049438476562,69530000.0,3.4250030517578125,0.0,3.4250030517578125,72.66125667905261,158.61000061035156,167.5500030517578,99.24491203156896,-0.7550879684310419,0.008662961619990028,-0.5943445296985197,0.037008060145738764,3033538000.0,1.0
AMZN,2021-06-11,167.3415069580078,168.32899475097656,166.67250061035156,167.4824981689453,56348000.0,-0.1409912109375,0.1409912109375,0.0,71.71669268094956,158.61000061035156,168.32899475097656,89.83960913361301,-10.160390866386997,0.37778483584196465,-0.3999186565904228,0.03839819432277447,2977190000.0,-1.0
AMZN,2021-06-14,169.19349670410156,169.25,166.77499389648438,167.3415069580078,51394000.0,1.85198974609375,0.0,1.85198974609375,76.37201373490088,158.61000061035156,169.25,99.46895395545408,-0.5310460445459148,0.8104147189139326,-0.1578519814895517,0.051332091638165434,3028584000.0,1.0
AMZN,2021-06-15,169.156494140625,169.84950256347656,168.15550231933594,169.1999969482422,48524000.0,-0.0370025634765625,0.0370025634765625,0.0,76.08331160116684,158.61000061035156,169.84950256347656,93.83417142733019,-6.165828572669809,1.1371824886911384,0.10115491254658639,0.046116413695848735,2980060000.0,-1.0
AMZN,2021-06-16,170.7624969482422,171.3175048828125,168.02650451660156,169.60000610351562,84056000.0,1.6060028076171875,0.0,1.6060028076171875,79.89031610238168,158.61000061035156,171.3175048828125,95.63243952022037,-4.367560479779635,1.508351962614853,0.38259432256023984,0.0716157336538994,3064116000.0,1.0
AMZN,2021-06-17,174.46200561523438,174.86000061035156,170.0500030517578,170.15899658203125,102730000.0,3.6995086669921875,0.0,3.6995086669921875,85.86895458106139,158.61000061035156,174.86000061035156,97.55080003004808,-2.449199969951923,2.0770825613450086,0.7214919703171938,0.0882721745051609,3166846000.0,1.0
AMZN,2021-06-18,174.34500122070312,175.35000610351562,173.6855010986328,173.99949645996094,104954000.0,-0.11700439453125,0.11700439453125,0.0,84.94733259549696,158.61000061035156,175.35000610351562,93.99638857213695,-6.00361142786305,2.489665072337999,1.0751265907213552,0.09033432675788777,3061892000.0,-1.0
AMZN,2021-06-21,172.697998046875,174.10000610351562,171.6999969482422,173.8209991455078,65542000.0,-1.647003173828125,1.647003173828125,0.0,72.33722815912323,158.61000061035156,175.35000610351562,84.15766316370924,-15.842336836290748,2.653156358282615,1.3907325442336074,0.05816282149427132,2996350000.0,-1.0
AMZN,2021-06-22,175.27200317382812,176.18899536132812,172.80450439453125,172.9029998779297,66902000.0,2.574005126953125,0.0,2.574005126953125,78.17859546862529,158.61000061035156,176.18899536132812,94.78359143688203,-5.21640856311797,2.9563461638560966,1.7038552681581054,0.06835718202713026,3063252000.0,1.0
AMZN,2021-06-23,175.1909942626953,176.0500030517578,174.16000366210938,175.25,56266000.0,-0.0810089111328125,0.0810089111328125,0.0,77.58367289137378,158.61000061035156,176.18899536132812,94.32276354381771,-5.677236456182289,3.153735230424701,1.9938312606114246,0.0460256813579063,3006986000.0,-1.0
AMZN,2021-06-24,172.45399475097656,176.2429962158203,171.54249572753906,175.3820037841797,76640000.0,-2.73699951171875,2.73699951171875,0.0,59.83336637714125,158.61000061035156,176.2429962158203,78.51186746925396,-21.48813253074604,3.054108637993238,2.2058867360877876,0.030551223578090925,2930346000.0,-1.0
AMZN,2021-06-25,170.072998046875,173.24099731445312,169.70899963378906,173.1999969482422,78820000.0,-2.3809967041015625,2.3809967041015625,0.0,48.65883730830713,160.90049743652344,176.2429962158203,59.784919929268035,-40.215080070731965,2.751311899573153,2.314971768784861,0.005198198275383925,2851526000.0,-1.0
AMZN,2021-06-28,172.1945037841797,172.39999389648438,170.67550659179688,170.8000030517578,44856000.0,2.1215057373046875,0.0,2.1215057373046875,56.928840514044325,163.53500366210938,176.2429962158203,68.14215609169207,-31.857843908307927,2.6519609308572,2.382369601199329,0.017959757672851184,2896382000.0,1.0
AMZN,2021-06-29,172.40699768066406,172.80149841308594,171.15150451660156,171.9409942626953,41968000.0,0.212493896484375,0.0,0.212493896484375,57.716006166167645,164.0574951171875,176.2429962158203,68.5199771096271,-31.480022890372894,2.560851155874957,2.418065912134455,0.009630338990184173,2938350000.0,1.0
AMZN,2021-06-30,172.00799560546875,173.5800018310547,171.75,172.05299377441406,48080000.0,-0.3990020751953125,0.3990020751953125,0.0,55.51770262498957,166.67250061035156,176.2429962158203,55.74941168217444,-44.25058831782555,2.4284561392109083,2.4201439575497457,-0.014066157276546476,2890270000.0,-1.0
AMZN,2021-07-01,171.64849853515625,172.85000610351562,170.4709930419922,171.73049926757812,40742000.0,-0.3594970703125,0.3594970703125,0.0,53.40311312660392,166.77499389648438,176.2429962158203,51.47342041434661,-48.52657958565339,2.2683753069938177,2.38979022743856,-0.015466475474874009,2849528000.0,-1.0
AMZN,2021-07-02,175.5489959716797,175.58599853515625,171.8459930419922,172.58200073242188,63388000.0,3.9004974365234375,0.0,3.9004974365234375,68.44811962149552,168.02650451660156,176.2429962158203,91.55356970412795,-8.446430295872053,2.428256213361209,2.39748342462309,0.01650857541516393,2912916000.0,1.0
AMZN,2021-07-06,183.78700256347656,184.2740020751953,176.4499969482422,176.5054931640625,134896000.0,8.238006591796875,0.0,8.238006591796875,82.34206229114552,168.02650451660156,184.2740020751953,97.00261834191714,-2.9973816580828627,3.1830095152639046,2.554588642751253,0.04858162875678196,3047812000.0,1.0
AMZN,2021-07-07,184.82899475097656,186.7100067138672,183.94549560546875,185.86900329589844,106562000.0,1.0419921875,0.0,1.0419921875,83.40836306853514,169.70899963378906,186.7100067138672,88.93587918627006,-11.064120813729943,3.8211887209966733,2.807908658400337,0.055014246187959026,3154374000.0,1.0
AMZN,2021-07-08,186.57049560546875,187.9994964599609,181.05599975585935,182.1779937744141,103612000.0,1.7415008544921875,0.0,1.7415008544921875,85.13896055336635,169.70899963378906,187.9994964599609,92.18719497850161,-7.812805021498398,4.416563509082948,3.12963962853686,0.0818566184846945,3257986000.0,1.0
AMZN,2021-07-09,185.9669952392578,187.3999938964844,184.6699981689453,186.12600708007807,74964000.0,-0.6035003662109375,0.6035003662109375,0.0,81.73024029882397,169.70899963378906,187.9994964599609,88.8876653268664,-11.11233467313361,4.784551550204014,3.4606220128702914,0.0934539719703309,3183022000.0,-1.0
AMZN,2021-07-12,185.9275054931641,187.864501953125,184.8394927978516,187.1999969482422,51432000.0,-0.03948974609372158,0.03948974609372158,0.0,81.48392597199089,169.70899963378906,187.9994964599609,88.6717622463267,-11.328237753673314,5.015186285864559,3.7715348674691453,0.07975284580625575,3131590000.0,-1.0
AMZN,2021-07-13,183.8679962158203,188.6540069580078,183.5659942626953,185.10499572753903,76918000.0,-2.0595092773437784,2.0595092773437784,0.0,68.97485609574431,169.70899963378906,188.6540069580078,74.73735079495482,-25.262649205045186,4.974438557652519,4.012115605505821,0.0664764115687726,3054672000.0,-1.0
AMZN,2021-07-14,184.08399963378903,185.88299560546875,183.04150390625,185.4425048828125,65932000.0,0.21600341796872158,0.0,0.21600341796872158,69.54072702522484,169.70899963378906,188.6540069580078,75.87751091351328,-24.122489086486723,4.903055982764187,4.190303680957494,0.0702060621415459,3120604000.0,1.0
AMZN,2021-07-15,181.55999755859372,184.7700042724609,181.04600524902344,184.7100067138672,63706000.0,-2.5240020751953125,2.5240020751953125,0.0,55.81509787531601,169.70899963378906,188.6540069580078,62.55472865220108,-37.44527134779892,4.589909287234832,4.270224802212962,0.05774299867474486,3056898000.0,-1.0
AMZN,2021-07-16,178.68150329589844,182.3029937744141,178.5229949951172,181.66549682617188,80874000.0,-2.878494262695284,2.878494262695284,0.0,44.307307117837226,170.4709930419922,188.6540069580078,45.15483677144646,-54.84516322855354,4.06263630212095,4.2287071021945595,0.017844062888995982,2976024000.0,-1.0
AMZN,2021-07-19,177.47950744628906,177.510498046875,174.95799255371094,176.62899780273438,75692000.0,-1.201995849609375,1.201995849609375,0.0,40.30353867828594,170.4709930419922,188.6540069580078,38.54429434343536,-61.45570565656464,3.507347128605687,4.084435107476785,-0.03431959294841325,2900332000.0,-1.0
AMZN,2021-07-20,178.6595001220703,179.60000610351562,175.89999389648438,178.36599731445312,65114000.0,1.17999267578125,0.0,1.17999267578125,45.84652928396441,170.4709930419922,188.6540069580078,45.03382727362748,-54.96617272637252,3.1264522103456898,3.8928385280505657,-0.03337947402256081,2965446000.0,1.0
AMZN,2021-07-21,179.25999450683594,179.32249450683594,177.1820068359375,178.81900024414062,46380000.0,0.600494384765625,0.0,0.600494384765625,48.646436780925406,170.4709930419922,188.6540069580078,48.336329199541474,-51.663670800458526,2.8403038667860585,3.6823315957976646,-0.03918358620910756,3011826000.0,1.0
AMZN,2021-07-22,181.9015045166016,182.00100708007807,179.11349487304688,179.3614959716797,65308000.0,2.6415100097656534,0.0,2.6415100097656534,59.3215599460979,171.8459930419922,188.6540069580078,59.8256969851027,-40.17430301489729,2.794464181109106,3.504758112859953,-0.021861356190789216,3077134000.0,1.0
AMZN,2021-07-23,182.83200073242188,183.3054962158203,181.1020050048828,182.0,48726000.0,0.9304962158202841,0.0,0.9304962158202841,62.49076793213127,174.95799255371094,188.6540069580078,57.49123756938085,-42.50876243061915,2.8009317701614123,3.363992844320245,-0.01664898774676471,3125860000.0,1.0
AMZN,2021-07-26,184.99099731445312,185.60400390625,182.3625030517578,183.6584930419922,58002000.0,2.15899658203125,0.0,2.15899658203125,68.96420063410184,174.95799255371094,188.6540069580078,73.25492267001789,-26.74507732998211,2.9463071667586007,3.2804557088079163,0.006107648539959376,3183862000.0,1.0
AMZN,2021-07-27,181.3195037841797,184.9250030517578,179.3074951171875,184.9250030517578,82638000.0,-3.6714935302734375,3.6714935302734375,0.0,51.51820058232857,174.95799255371094,188.6540069580078,46.44790113883745,-53.55209886116255,2.7337464446775073,3.171113855981835,-0.015017578144265409,3101224000.0,-1.0
AMZN,2021-07-28,181.51600646972656,182.92100524902344,180.0500030517578,181.68899536132807,59988000.0,0.196502685546875,0.0,0.196502685546875,52.26394889970529,174.95799255371094,188.6540069580078,47.882644705441955,-52.117355294558045,2.551731888678347,3.047237462521138,-0.00024229505099526705,3161212000.0,1.0
AMZN,2021-07-29,179.99600219726562,181.8975067138672,179.00050354003906,181.3874969482422,110400000.0,-1.5200042724609375,1.5200042724609375,0.0,45.95482707749711,174.95799255371094,188.6540069580078,36.78449434146407,-63.21550565853593,2.258794424053349,2.8895488548275803,0.0073566590672251575,3050812000.0,-1.0
AMZN,2021-07-30,166.37950134277344,168.40699768066406,165.3489990234375,167.3975067138672,199312000.0,-13.616500854492188,13.616500854492188,0.0,20.444610403044535,165.3489990234375,188.6540069580078,4.4218063440660975,-95.5781936559339,0.9173271750679817,2.4951045188756606,-0.06254246624430615,2851500000.0,-1.0
AMZN,2021-08-02,166.57400512695312,167.9459991455078,165.85000610351562,167.65499877929688,67078000.0,0.1945037841796875,0.0,0.1945037841796875,21.16589654527843,165.3489990234375,185.88299560546875,5.965746115822357,-94.03425388417764,-0.12861782839129887,1.9703600494222688,-0.06764540921059159,2918578000.0,1.0
AMZN,2021-08-03,168.31199645996094,169.5500030517578,164.98849487304688,167.03599548339844,83146000.0,1.7379913330078125,0.0,1.7379913330078125,27.905120085684317,164.98849487304688,185.60400390625,16.121365626050103,-83.87863437394991,-0.807981495951168,1.4146917403475814,-0.06107329232601033,3001724000.0,1.0
AMZN,2021-08-04,167.73599243164062,169.44400024414062,167.2779998779297,168.96749877929688,43678000.0,-0.5760040283203125,0.5760040283203125,0.0,27.021765099828272,164.98849487304688,185.60400390625,13.327333097468799,-86.6726669025312,-1.3769877506181842,0.8563558421544282,-0.07787462848427473,2958046000.0,-1.0
AMZN,2021-08-05,168.79949951171875,169.4499969482422,167.04600524902344,167.81100463867188,48670000.0,1.063507080078125,0.0,1.063507080078125,31.632437212640454,164.98849487304688,185.60400390625,18.48610496366551,-81.51389503633449,-1.7222600320677088,0.34063266731000064,-0.07675079397747198,3006716000.0,1.0
AMZN,2021-08-06,167.2469940185547,168.75,166.45199584960938,168.75,52752000.0,-1.5525054931640625,1.5525054931640625,0.0,28.5899741586245,164.98849487304688,185.60400390625,10.955340185247413,-89.04465981475259,-2.096992200383795,-0.14689230622875865,-0.09591819901233711,2953964000.0,-1.0
AMZN,2021-08-09,167.093505859375,167.74400329589844,166.42599487304688,167.1804962158203,42964000.0,-0.1534881591796875,0.1534881591796875,0.0,28.27969188113248,164.98849487304688,185.60400390625,10.210812563191217,-89.78918743680879,-2.3789325022140133,-0.5933003454258098,-0.07845817812151945,2911000000.0,-1.0
AMZN,2021-08-10,166.03399658203125,167.89999389648438,165.75,167.25050354003906,48252000.0,-1.05950927734375,1.05950927734375,0.0,26.029656068564492,164.98849487304688,185.60400390625,5.071432906655376,-94.92856709334461,-2.657234817769819,-1.0060872398946117,-0.08529280799419425,2862748000.0,-1.0
AMZN,2021-08-11,164.60549926757812,166.88499450683594,163.88949584960938,166.57249450683594,58944000.0,-1.428497314453125,1.428497314453125,0.0,23.162667852357018,163.88949584960938,185.60400390625,3.297350398641821,-96.70264960135817,-2.9589502659506195,-1.3966598451058134,-0.08550469311435238,2803804000.0,-1.0
AMZN,2021-08-12,165.1750030517578,165.72549438476562,163.48350524902344,164.5,46282000.0,0.5695037841796875,0.0,0.5695037841796875,26.868023362418796,163.48350524902344,185.60400390625,7.646743542925413,-92.35325645707458,-3.116186280847728,-1.7405651322541966,-0.007239463283004621,2850086000.0,1.0
AMZN,2021-08-13,164.69850158691406,165.30349731445312,164.14999389648438,165.2834930419922,41134000.0,-0.47650146484375,0.47650146484375,0.0,25.672807095036916,163.48350524902344,184.9250030517578,5.666564663853286,-94.3334353361467,-3.241876309306207,-2.040827367664599,-0.011259281054145642,2808952000.0,-1.0
AMZN,2021-08-16,164.94949340820312,165.0,160.55650329589844,164.14999389648438,66394000.0,0.2509918212890625,0.0,0.2509918212890625,27.62946893140753,160.55650329589844,182.92100524902344,19.64269144697342,-80.35730855302658,-3.283384803872508,-2.289338854906181,-0.019977797913874218,2875346000.0,1.0
AMZN,2021-08-17,162.09800720214844,164.02450561523438,161.28399658203125,163.875,67758000.0,-2.8514862060546875,2.8514862060546875,0.0,20.541038861634917,160.55650329589844,181.8975067138672,7.22320256484323,-92.77679743515677,-3.5059571986297158,-2.532662523650888,-0.03361225666453127,2807588000.0,-1.0
AMZN,2021-08-18,160.06100463867188,162.7050018310547,160.0,162.09950256347656,56086000.0,-2.0370025634765625,2.0370025634765625,0.0,16.955487076603305,160.0,169.5500030517578,0.6387918238481216,-99.36120817615188,-3.8028792827922473,-2.7867058754791603,-0.051768488048391514,2751502000.0,-1.0
AMZN,2021-08-19,159.3874969482422,161.64999389648438,159.1230010986328,159.7010040283203,75658000.0,-0.6735076904296875,0.6735076904296875,0.0,15.896858087032996,159.1230010986328,169.5500030517578,2.5366433304455738,-97.46335666955443,-4.04589999887645,-3.0385447001586186,-0.0469933532523793,2675844000.0,-1.0
AMZN,2021-08-20,159.99749755859375,160.3905029296875,158.78799438476562,160.19349670410156,67168000.0,0.6100006103515625,0.0,0.6100006103515625,21.04832013485064,158.78799438476562,169.5500030517578,11.238637797586556,-88.76136220241344,-4.141532704967091,-3.259142301120313,-0.04246728958307455,2743012000.0,1.0
AMZN,2021-08-23,163.2935028076172,164.0449981689453,160.50050354003906,160.59500122070312,65362000.0,3.2960052490234375,0.0,3.2960052490234375,42.86635923904804,158.78799438476562,169.4499969482422,42.25761901695182,-57.74238098304818,-3.9063324667403094,-3.3885803342443124,-0.016505618312091186,2808374000.0,1.0
AMZN,2021-08-24,165.28900146484375,165.77450561523438,163.72900390625,164.0,51036000.0,1.9954986572265625,0.0,1.9954986572265625,52.11120557405771,158.78799438476562,169.4499969482422,60.97360267336439,-39.02639732663561,-3.518357088444958,-3.414535685084442,0.004152365506054911,2859410000.0,1.0
AMZN,2021-08-25,164.95899963378906,166.0500030517578,164.3074951171875,165.49349975585938,33606000.0,-0.3300018310546875,0.3300018310546875,0.0,50.55041254109577,158.78799438476562,168.75,61.94541026544334,-38.05458973455665,-3.2006174698823884,-3.3717520420440312,-0.0013077246192092495,2825804000.0,-1.0
AMZN,2021-08-26,165.8000030517578,166.60000610351562,164.8000030517578,164.9499969482422,41976000.0,0.84100341796875,0.0,0.84100341796875,54.5530669604723,158.78799438476562,167.89999389648438,76.95356719427159,-23.046432805728408,-2.8481133083798795,-3.2670242953112005,0.006687987165824083,2867780000.0,1.0
AMZN,2021-08-27,167.48150634765625,167.61599731445312,165.6875,166.6614990234375,48048000.0,1.6815032958984375,0.0,1.6815032958984375,61.70433292973347,158.78799438476562,167.89999389648438,95.40729179923773,-4.59270820076227,-2.4053406874914174,-3.0946875737472443,0.015350231680840043,2915828000.0,1.0
AMZN,2021-08-30,171.07850646972656,172.25,167.76100158691406,167.8715057373047,63844000.0,3.5970001220703125,0.0,3.5970001220703125,72.41722879873828,158.78799438476562,172.25,91.29777862410258,-8.702221375897427,-1.7440875908752673,-2.824567577172849,0.055401663614400576,2979672000.0,1.0
AMZN,2021-08-31,173.5395050048828,173.62899780273438,169.7794952392578,171.24000549316406,87128000.0,2.46099853515625,0.0,2.46099853515625,77.40671131906291,158.78799438476562,173.62899780273438,99.39698957455121,-0.6030104254487878,-1.0098171894013888,-2.461617499618557,0.08420852034908721,3066800000.0,1.0
AMZN,2021-09-01,173.9499969482422,176.35000610351562,173.76199340820312,174.82000732421875,72598000.0,0.410491943359375,0.0,0.410491943359375,78.16682017010216,158.78799438476562,176.35000610351562,86.33408749687213,-13.665912503127867,-0.3902804270738329,-2.0473500851096125,0.09136538485656054,3139398000.0,1.0
AMZN,2021-09-02,173.156005859375,175.59800720214844,172.75,174.73800659179688,58474000.0,-0.7939910888671875,0.7939910888671875,0.0,72.70754814333095,158.78799438476562,176.35000610351562,81.81301609808992,-18.186983901910082,0.03622094289792699,-1.6306358795081044,0.08224196316547006,3080924000.0,-1.0
AMZN,2021-09-03,173.90249633789062,174.1334991455078,171.82200622558594,172.60000610351562,51514000.0,0.746490478515625,0.0,0.746490478515625,74.62972776390956,158.78799438476562,176.35000610351562,86.06361386826813,-13.936386131731865,0.4295107616132441,-1.2186065512838349,0.06496886494481258,3132438000.0,1.0
AMZN,2021-09-07,175.46449279785156,176.4044952392578,173.8470001220703,173.89999389648438,54758000.0,1.5619964599609375,0.0,1.5619964599609375,78.3167769571369,158.78799438476562,176.4044952392578,94.66407972178794,-5.335920278212063,0.8573528071379428,-0.8034146795994793,0.06156181743993461,3187196000.0,1.0
AMZN,2021-09-08,176.27499389648438,177.281494140625,174.7834930419922,175.58250427246094,61068000.0,0.8105010986328125,0.0,0.8105010986328125,80.05243866835926,158.78799438476562,177.281494140625,94.55754585433873,-5.442454145661268,1.247441644894252,-0.39324341470073304,0.06859882933223993,3248264000.0,1.0
AMZN,2021-09-09,174.20799255371094,177.49949645996094,174.01849365234375,176.30099487304688,54384000.0,-2.0670013427734375,2.0670013427734375,0.0,64.79112767954689,158.78799438476562,177.49949645996094,82.40919465993409,-17.590805340065906,1.3739619474747258,-0.0398023422656412,0.050711636593446796,3193880000.0,-1.0
AMZN,2021-09-10,173.45750427246094,175.42250061035156,173.14549255371094,175.0915069580078,47946000.0,-0.75048828125,0.75048828125,0.0,59.9991637909247,160.50050354003906,177.49949645996094,76.22216676869716,-23.777833231302836,1.3975618436135449,0.24767049491019613,0.0356815391449834,3145934000.0,-1.0
AMZN,2021-09-13,172.85850524902344,174.8979949951172,171.89999389648438,174.13999938964844,51380000.0,-0.5989990234375,0.5989990234375,0.0,56.17306462546026,163.72900390625,177.49949645996094,66.29756566197173,-33.70243433802826,1.3523417621533724,0.4686047483588314,0.010404572824651348,3094554000.0,-1.0
AMZN,2021-09-14,172.5,174.3404998779297,171.885498046875,173.77749633789062,38738000.0,-0.3585052490234375,0.3585052490234375,0.0,53.803655176230535,164.3074951171875,177.49949645996094,62.10206222651989,-37.89793777348011,1.2729029119458914,0.6294643810762435,-0.005990019418653736,3055816000.0,-1.0
AMZN,2021-09-15,173.7895050048828,174.27099609375,170.10049438476562,172.12600708007812,59150000.0,1.2895050048828125,0.0,1.2895050048828125,60.685976036509885,164.8000030517578,177.49949645996094,70.78630354907159,-29.213696450928424,1.299024976566642,0.7633765001743232,-0.0009226326310722843,3114966000.0,1.0
AMZN,2021-09-16,174.41200256347656,174.62750244140625,172.3070068359375,172.9980010986328,51672000.0,0.62249755859375,0.0,0.62249755859375,63.698396811032175,165.6875,177.49949645996094,73.86137130204841,-26.13862869795159,1.3543452030768037,0.8815702407548194,0.007253555531429923,3166638000.0,1.0
AMZN,2021-09-17,173.12600708007812,174.87049865722656,172.60650634765625,174.42050170898438,92332000.0,-1.2859954833984375,1.2859954833984375,0.0,53.86076908700663,167.76100158691406,177.49949645996094,55.09070511514802,-44.90929488485198,1.2796665932273186,0.9611895112493194,-0.004465084022162613,3074306000.0,-1.0
AMZN,2021-09-20,167.7864990234375,170.9499969482422,165.25050354003906,169.8000030517578,93382000.0,-5.339508056640625,5.339508056640625,0.0,30.95628760679513,165.25050354003906,177.49949645996094,20.7037060105886,-79.29629398941141,0.7806309531490854,0.9250777996292726,-0.04375810542626246,2980924000.0,-1.0
AMZN,2021-09-21,167.18150329589844,168.98500061035156,166.6195068359375,168.75,55618000.0,-0.6049957275390625,0.6049957275390625,0.0,29.325873802740603,165.25050354003906,177.49949645996094,15.764559327312364,-84.23544067268763,0.3324907673792836,0.8065603931792749,-0.05158695739865404,2925306000.0,-1.0
AMZN,2021-09-22,169.00250244140625,169.4499969482422,167.05250549316406,167.5500030517578,48228000.0,1.8209991455078125,0.0,1.8209991455078125,40.254371091855496,165.25050354003906,177.49949645996094,30.63108066023046,-69.36891933976955,0.12285960475253432,0.6698202354939268,-0.02988089143326622,2973534000.0,1.0
AMZN,2021-09-23,170.8000030517578,171.447998046875,169.00250244140625,169.00250244140625,47588000.0,1.7975006103515625,0.0,1.7975006103515625,49.201051700941036,165.25050354003906,177.49949645996094,45.3057614450327,-54.6942385549673,0.10060891799608385,0.5559779719943582,-0.015320762464844484,3021122000.0,1.0
AMZN,2021-09-24,171.2760009765625,171.46299743652344,169.6699981689453,170.10049438476562,42324000.0,0.4759979248046875,0.0,0.4759979248046875,51.4236677033539,165.25050354003906,177.49949645996094,49.19177826222361,-50.80822173777639,0.12000084780953557,0.46878254715739365,-0.009154911238999475,3063446000.0,1.0
AMZN,2021-09-27,170.2899932861328,170.77850341796875,166.98049926757812,168.5749969482422,72690000.0,-0.9860076904296875,0.9860076904296875,0.0,46.55511100644412,165.25050354003906,177.49949645996094,41.142074120211774,-58.85792587978823,0.055170540047242866,0.3860601457353635,-0.012811633123867794,2990756000.0,-1.0
AMZN,2021-09-28,165.79800415039062,168.45950317382812,164.5050048828125,167.885498046875,88616000.0,-4.4919891357421875,4.4919891357421875,0.0,31.084977960227704,164.5050048828125,177.49949645996094,9.950364428662517,-90.04963557133749,-0.3545864758946493,0.23793082140936095,-0.04598379432790067,2902140000.0,-1.0
AMZN,2021-09-29,165.05599975585938,167.56500244140625,164.89349365234375,166.10549926757812,51246000.0,-0.74200439453125,0.74200439453125,0.0,29.233481408213805,164.5050048828125,175.42250061035156,5.0468979956365505,-94.95310200436346,-0.7307715372260759,0.044190349682273526,-0.05364311326115356,2850894000.0,-1.0
AMZN,2021-09-30,164.2519989013672,166.3925018310547,163.69949340820312,165.8000030517578,56848000.0,-0.8040008544921875,0.8040008544921875,0.0,27.207398116826226,163.69949340820312,174.8979949951172,4.9337448307342235,-95.06625516926577,-1.081312362419851,-0.18091019273815148,-0.05125751080602425,2794046000.0,-1.0
AMZN,2021-10-01,164.16299438476562,165.45849609375,162.7969970703125,164.45050048828125,56712000.0,-0.0890045166015625,0.0890045166015625,0.0,26.968650299066127,162.7969970703125,174.87049865722656,11.314011139350571,-88.68598886064943,-1.350730037472431,-0.4148741616850075,-0.021595924938905386,2737334000.0,-1.0
AMZN,2021-10-04,159.48899841308594,163.99949645996094,158.8125,163.96949768066406,90462000.0,-4.6739959716796875,4.6739959716796875,0.0,17.60686568643324,158.8125,174.87049865722656,4.2128438762914815,-95.78715612370851,-1.919273706123704,-0.7157540705727469,-0.04601289455566959,2646872000.0,-1.0
AMZN,2021-10-05,161.0500030517578,163.0364990234375,160.1230010986328,160.22500610351562,65384000.0,1.561004638671875,0.0,1.561004638671875,27.328263938352038,158.8125,174.87049865722656,13.9338849100655,-86.0661150899345,-2.218317250772685,-1.0162667066127349,-0.04705551263896579,2712256000.0,1.0
AMZN,2021-10-06,163.10049438476562,163.2169952392578,159.93099975585938,160.67649841308594,50660000.0,2.0504913330078125,0.0,2.0504913330078125,38.35263624428011,158.8125,174.87049865722656,26.703168161219793,-73.29683183878021,-2.2637586993514844,-1.2657651051604848,-0.04507908975071262,2762916000.0,1.0
AMZN,2021-10-07,165.1215057373047,166.28750610351562,164.1529998779297,164.57699584960938,48182000.0,2.0210113525390625,0.0,2.0210113525390625,47.42332340304055,158.8125,171.46299743652344,49.87160203748087,-50.12839796251913,-2.112342875108368,-1.4350806591500616,-0.035933202574597645,2811098000.0,1.0
AMZN,2021-10-08,164.43099975585938,166.07150268554688,164.41000366210938,165.85000610351562,39964000.0,-0.6905059814453125,0.6905059814453125,0.0,44.823306518806454,158.8125,171.46299743652344,44.413271367797144,-55.58672863220286,-2.0247230583368037,-1.55300913898741,-0.03440597663556633,2771134000.0,-1.0
AMZN,2021-10-11,162.31500244140625,164.62950134277344,161.90499877929688,163.75,40684000.0,-2.115997314453125,2.115997314453125,0.0,37.544978613849665,158.8125,171.46299743652344,27.68667761074852,-72.31332238925148,-2.1017987932631854,-1.6627670698425652,-0.021007500825070524,2730450000.0,-1.0
AMZN,2021-10-12,162.3665008544922,163.37649536132812,161.81399536132812,162.85000610351562,36392000.0,0.0514984130859375,0.0,0.0514984130859375,37.82847393531392,158.8125,171.46299743652344,28.09376368261519,-71.90623631738481,-2.134125506554625,-1.7570387571849775,-0.01629446312369942,2766842000.0,1.0
AMZN,2021-10-13,164.21400451660156,164.41900634765625,163.05450439453125,163.48550415039062,48402000.0,1.847503662109375,0.0,1.847503662109375,47.66249088250723,158.8125,171.46299743652344,42.697961433570185,-57.302038566429815,-1.987752975471608,-1.8031816008423034,-0.0002313176400881023,2815244000.0,1.0
AMZN,2021-10-14,164.9929962158203,165.6300048828125,164.53900146484375,165.12249755859375,42190000.0,0.77899169921875,0.0,0.77899169921875,51.402309060334495,158.8125,170.77850341796875,51.65046339982964,-48.34953660017036,-1.7882793984692,-1.8002011603676826,0.005055961815056298,2857434000.0,1.0
AMZN,2021-10-15,170.4510040283203,170.52099609375,165.1999969482422,165.5709991455078,103598000.0,5.4580078125,0.0,5.4580078125,69.19672042052497,158.8125,170.52099609375,99.40221130989616,-0.5977886901038408,-1.1762207944249496,-1.6754050871791362,0.06873204875763372,2961032000.0,1.0
AMZN,2021-10-18,172.33700561523438,172.45849609375,169.2550048828125,169.41799926757812,63482000.0,1.8860015869140625,0.0,1.8860015869140625,73.12081838256483,158.8125,172.45849609375,99.10969871542564,-0.8903012845743729,-0.5328332054692169,-1.4468907108371523,0.07008383948834318,3024514000.0,1.0
AMZN,2021-10-19,172.20750427246094,172.7344970703125,171.10000610351562,171.71449279785156,47722000.0,-0.1295013427734375,0.1295013427734375,0.0,72.39017969891054,158.8125,172.7344970703125,96.21467527115539,-3.78532472884462,-0.03301302829811448,-1.1641151743293447,0.055836801243601464,2976792000.0,-1.0
AMZN,2021-10-20,170.7530059814453,173.14300537109375,170.01849365234375,172.63299560546875,42796000.0,-1.454498291015625,1.454498291015625,0.0,64.09082490980222,158.8125,173.14300537109375,83.32229514759936,-16.677704852400645,0.24293183975544252,-0.8827057715123873,0.034105189502692035,2933996000.0,-1.0
AMZN,2021-10-21,171.75050354003906,172.01400756835938,170.14999389648438,170.71249389648438,37628000.0,0.99749755859375,0.0,0.99749755859375,67.07760110558152,158.8125,173.14300537109375,90.28295377591135,-9.717046224088657,0.535931962252107,-0.5989782247594884,0.044514135382302644,2971624000.0,1.0
AMZN,2021-10-22,166.77749633789062,171.49200439453125,166.56500244140625,171.0500030517578,62782000.0,-4.9730072021484375,4.9730072021484375,0.0,45.36968378799118,159.93099975585938,173.14300537109375,51.82026697094918,-48.17973302905082,0.3626758487974655,-0.40664741004809757,0.027492799983755534,2908842000.0,-1.0
AMZN,2021-10-25,166.01849365234375,167.38999938964844,164.88499450683594,166.75,44520000.0,-0.759002685546875,0.759002685546875,0.0,42.92339975688422,159.93099975585938,173.14300537109375,46.075471610949556,-53.92452838905045,0.16225359868198552,-0.29286720830208096,0.022492279987756714,2864322000.0,-1.0
AMZN,2021-10-26,168.80349731445312,170.80599975585938,167.19900512695312,167.47549438476562,53966000.0,2.785003662109375,0.0,2.785003662109375,53.531351478366325,161.81399536132812,173.14300537109375,61.69561106486832,-38.30438893513168,0.2255441096864672,-0.1891849447043713,0.02794824236435689,2918288000.0,1.0
AMZN,2021-10-27,169.62449645996094,171.85000610351562,168.57249450683594,169.39999389648438,54044000.0,0.8209991455078125,0.0,0.8209991455078125,56.29432133944944,161.81399536132812,173.14300537109375,68.9424856355511,-31.057514364448895,0.338053198466298,-0.08373731607023743,0.02807088997936824,2972332000.0,1.0
AMZN,2021-10-28,172.32850646972656,173.9499969482422,169.3000030517578,170.10499572753906,114174000.0,2.704010009765625,0.0,2.704010009765625,64.3498033511346,161.81399536132812,173.9499969482422,86.63900571450125,-13.360994285498744,0.6380533890475419,0.06062082495331848,0.011014909839394793,3086506000.0,1.0
AMZN,2021-10-29,168.6215057373047,168.74099731445312,163.66600036621094,165.00100708007812,129722000.0,-3.707000732421875,3.707000732421875,0.0,49.823627653072286,161.81399536132812,173.9499969482422,56.09351916463925,-43.90648083536075,0.5701098515712886,0.16251863027691255,-0.021559501191665387,2956784000.0,-1.0
AMZN,2021-11-01,165.90550231933594,168.79299926757812,164.6009979248047,168.08999633789062,72178000.0,-2.71600341796875,2.71600341796875,0.0,41.83921238899441,163.05450439453125,173.9499969482422,26.166764932840554,-73.83323506715944,0.2937195156300163,0.1887588073475333,-0.03659539681356849,2884606000.0,-1.0
AMZN,2021-11-02,165.6374969482422,166.55599975585938,164.17750549316406,165.75050354003906,52552000.0,-0.26800537109375,0.26800537109375,0.0,41.089491468494145,163.66600036621094,173.9499969482422,19.170529339497783,-80.82947066050221,0.05244780384373371,0.1614966066467734,-0.029958529888246876,2832054000.0,-1.0
AMZN,2021-11-03,169.1999969482422,169.74600219726562,164.87600708007812,165.4499969482422,67944000.0,3.5625,0.0,3.5625,53.789776783285674,163.66600036621094,173.9499969482422,53.811731051141585,-46.18826894885841,0.14700759883916703,0.15859880508525215,-0.01485006762266805,2899998000.0,1.0
AMZN,2021-11-04,173.85000610351562,174.93150329589844,168.25,168.5,107060000.0,4.6500091552734375,0.0,4.6500091552734375,65.11617145809755,163.66600036621094,174.93150329589844,90.39992089893485,-9.600079101065155,0.5903585093122388,0.24495074593064953,0.04240685896433005,3007058000.0,1.0
AMZN,2021-11-05,175.94949340820312,178.3125,173.8489990234375,173.85000610351562,99940000.0,2.0994873046875,0.0,2.0994873046875,69.06615173416468,163.66600036621094,178.3125,83.8664073268026,-16.13359267319739,1.0984659476999639,0.4156537862845125,0.05981863548681332,3106998000.0,1.0
AMZN,2021-11-08,174.44900512695312,178.9499969482422,174.39300537109375,176.16200256347656,61480000.0,-1.50048828125,1.50048828125,0.0,63.16776111861983,163.66600036621094,178.9499969482422,70.55094983087939,-29.44905016912061,1.364340619753591,0.6053911529783284,0.03344425857471034,3045518000.0,-1.0
AMZN,2021-11-09,178.81149291992188,179.68850708007812,175.07150268554688,175.7624969482422,85898000.0,4.36248779296875,0.0,4.36248779296875,71.37009879384358,163.66600036621094,179.68850708007812,94.52636110055607,-5.473638899443932,1.905103669721882,0.8653336563270393,0.05416078839844629,3131416000.0,1.0
AMZN,2021-11-10,174.1024932861328,180.2725067138672,173.1544952392578,178.19349670410156,80548000.0,-4.7089996337890625,4.7089996337890625,0.0,55.872903527205644,163.66600036621094,180.2725067138672,62.84580694719587,-37.15419305280413,1.93142114640645,1.0785511543429216,0.010294215697377318,3050868000.0,-1.0
AMZN,2021-11-11,173.625,177.16200256347656,173.37350463867188,175.64999389648438,45288000.0,-0.4774932861328125,0.4774932861328125,0.0,54.488607302061574,163.66600036621094,180.2725067138672,59.97046835317423,-40.02953164682576,1.8919391221640467,1.2412287479071467,0.029672930749949922,3005580000.0,-1.0
AMZN,2021-11-12,176.25750732421875,177.0364990234375,172.3524932861328,174.25,53788000.0,2.63250732421875,0.0,2.63250732421875,60.684967532825105,163.66600036621094,180.2725067138672,75.8227329361477,-24.17726706385231,2.049445936758957,1.4028721856775088,0.06239699624282036,3059368000.0,1.0
AMZN,2021-11-15,177.28399658203125,179.69400024414062,176.29049682617188,176.85000610351562,58594000.0,1.0264892578125,0.0,1.0264892578125,62.95424553740407,163.66600036621094,180.2725067138672,82.00398043229772,-17.996019567702266,2.231378385435079,1.5685734256290231,0.07031318299520262,3117962000.0,1.0
AMZN,2021-11-16,177.03500366210938,178.8249969482422,176.25750732421875,176.9499969482422,44342000.0,-0.248992919921875,0.248992919921875,0.0,61.95338265171773,163.66600036621094,180.2725067138672,80.50461075929594,-19.495389240704057,2.328626556621316,1.7205840518274818,0.04630618708736667,3073620000.0,-1.0
AMZN,2021-11-17,177.4499969482422,179.3625030517578,177.2675018310547,178.23599243164062,51206000.0,0.4149932861328125,0.0,0.4149932861328125,63.082108396512815,163.66600036621094,180.2725067138672,83.00359084243296,-16.996409157567047,2.41138596648301,1.8587444347585875,0.020707453082187577,3124826000.0,1.0
AMZN,2021-11-18,184.8029937744141,185.2100067138672,178.0500030517578,178.3175048828125,114070000.0,7.352996826171903,0.0,7.352996826171903,77.01993081359481,164.17750549316406,185.2100067138672,98.06483815128722,-1.9351618487127797,3.0353096273913707,2.0940574732851447,0.05031841919357416,3238896000.0,1.0
AMZN,2021-11-19,183.82850646972656,188.1074981689453,183.78599548339844,185.63450622558597,98734000.0,-0.9744873046875284,0.9744873046875284,0.0,72.81610058761018,164.17750549316406,188.1074981689453,82.1187086966835,-17.88129130331651,3.4118114043400567,2.357608259496127,0.05376643642047507,3140162000.0,-1.0
AMZN,2021-11-22,178.6284942626953,185.67300415039065,178.375,183.81900024414065,96844000.0,-5.20001220703125,5.20001220703125,0.0,54.50058046032096,164.87600708007812,188.1074981689453,59.19760866838008,-40.80239133161992,3.2530945987749362,2.5367055273518893,-0.001023416639715169,3043318000.0,-1.0
AMZN,2021-11-23,179.0019989013672,181.0525054931641,176.385498046875,179.2519989013672,73804000.0,0.373504638671875,0.0,0.373504638671875,55.42971120250245,168.25,188.1074981689453,54.14578820499146,-45.85421179500853,3.1214667638954836,2.6536577746606085,0.028141501725550633,3117122000.0,1.0
AMZN,2021-11-24,179.02049255371094,180.6820068359375,176.84249877929688,178.1334991455078,46560000.0,0.01849365234375,0.0,0.01849365234375,55.48164913263219,172.3524932861328,188.1074981689453,42.32305427497772,-57.67694572502228,2.984242549132489,2.719774729554985,0.031075551065289808,3163682000.0,1.0
AMZN,2021-11-26,175.22799682617188,181.6750030517578,175.20750427246094,180.10499572753906,59826000.0,-3.7924957275390625,3.7924957275390625,0.0,43.48999995255008,172.3524932861328,188.1074981689453,18.25136559098129,-81.74863440901872,2.540186966148326,2.6838571768736537,-0.005840945521560892,3103856000.0,-1.0
AMZN,2021-11-29,178.07850646972656,179.8000030517578,176.5749969482422,177.3820037841797,65312000.0,2.8505096435546875,0.0,2.8505096435546875,52.41044492813838,172.3524932861328,188.1074981689453,36.34409018711502,-63.65590981288498,2.3907232534255343,2.62523039218403,0.004481565753328809,3169168000.0,1.0
AMZN,2021-11-30,175.35350036621094,179.2884979248047,174.60049438476562,178.1750030517578,80022000.0,-2.725006103515625,2.725006103515625,0.0,44.63798236646421,172.3524932861328,188.1074981689453,19.047960330066246,-80.95203966993375,2.0289979402890026,2.5059839018050245,-0.009498140261051224,3089146000.0,-1.0
AMZN,2021-12-01,172.18600463867188,177.99400329589844,172.0800018310547,177.25,74916000.0,-3.1674957275390625,3.1674957275390625,0.0,37.2324131916423,172.0800018310547,188.1074981689453,0.661380950476876,-99.33861904952312,1.4697947116713692,2.2987460637782937,-0.029664651451674517,3014230000.0,-1.0
AMZN,2021-12-02,171.8679962158203,174.63499450683594,171.1875,173.0,64726000.0,-0.3180084228515625,0.3180084228515625,0.0,36.53034681541486,171.1875,188.1074981689453,4.02184568240252,-95.97815431759747,0.9895545334480573,2.0369077577122465,-0.06999344163430232,2949504000.0,-1.0
AMZN,2021-12-03,169.489501953125,173.49349975585938,166.92999267578125,172.75,80712000.0,-2.3784942626953125,2.3784942626953125,0.0,31.417730613497326,166.92999267578125,188.1074981689453,12.085980939397892,-87.91401906060212,0.41228357475671373,1.71198292112114,-0.07800207264896075,2868792000.0,-1.0
AMZN,2021-12-06,171.36849975585938,173.69549560546875,166.9344940185547,169.64999389648438,68860000.0,1.878997802734375,0.0,1.878997802734375,39.17713428239206,166.92999267578125,188.1074981689453,20.95859250991974,-79.04140749008026,0.10519893241314549,1.390626123379541,-0.04064298104735309,2937652000.0,1.0
AMZN,2021-12-07,176.1645050048828,177.49949645996094,173.33450317382812,174.60000610351562,66410000.0,4.7960052490234375,0.0,4.7960052490234375,54.37862421569516,166.92999267578125,188.1074981689453,43.60528831916673,-56.39471168083327,0.245994016739445,1.1616997020515218,-0.015851744192241557,3004062000.0,1.0
AMZN,2021-12-08,176.1580047607422,177.17999267578125,174.75050354003906,176.15049743652344,45254000.0,-0.006500244140625,0.006500244140625,0.0,54.35737828769366,166.92999267578125,188.1074981689453,43.57459422187221,-56.42540577812779,0.3529816671292565,0.9999560950670687,-0.015989721356117537,2958808000.0,-1.0
AMZN,2021-12-09,174.17100524902344,176.96949768066406,174.13949584960938,175.75,46062000.0,-1.98699951171875,1.98699951171875,0.0,47.77391629517483,166.92999267578125,188.1074981689453,34.191999504283125,-65.80800049571688,0.2742742336835704,0.8548197227903692,-0.006032093023336849,2912746000.0,-1.0
AMZN,2021-12-10,172.21200561523438,175.927001953125,170.5,175.41700744628906,60690000.0,-1.9589996337890625,1.9589996337890625,0.0,41.98878008469827,166.92999267578125,185.67300415039065,28.181239426804545,-71.81876057319545,0.05320975824656671,0.6944977298816087,-0.032943340388411735,2852056000.0,-1.0
AMZN,2021-12-13,169.5675048828125,172.10000610351562,169.1300048828125,172.0,62170000.0,-2.644500732421875,2.644500732421875,0.0,35.32575509793337,166.92999267578125,181.6750030517578,17.88748966449315,-82.11251033550685,-0.33155260724055324,0.48928766245717636,-0.03299617898311058,2789886000.0,-1.0
AMZN,2021-12-14,169.0915069580078,169.49899291992188,166.44000244140625,167.5500030517578,55976000.0,-0.4759979248046875,0.4759979248046875,0.0,34.19867008021457,166.44000244140625,181.6750030517578,17.404032887271256,-82.59596711272874,-0.6671975701309236,0.2579906159395563,-0.01797183044671835,2733910000.0,-1.0
AMZN,2021-12-15,173.31500244140625,173.60000610351562,165.19500732421875,168.59800720214844,75794000.0,4.2234954833984375,0.0,4.2234954833984375,50.40031255423173,165.19500732421875,181.6750030517578,49.2718278052615,-50.7281721947385,-0.5856468606698968,0.08926312061766563,0.008419288392522484,2809704000.0,1.0
AMZN,2021-12-16,168.87100219726562,174.16600036621094,168.16050720214844,173.36849975585938,60876000.0,-4.444000244140625,4.444000244140625,0.0,38.801308682762304,165.19500732421875,179.8000030517578,25.169434771661376,-74.83056522833863,-0.8695869583663693,-0.10250689517914141,-0.003649192125364964,2748828000.0,-1.0
AMZN,2021-12-17,170.0175018310547,170.89849853515625,165.61349487304688,167.7104949951172,85542000.0,1.1464996337890625,0.0,1.1464996337890625,42.72504634483308,165.19500732421875,179.2884979248047,34.21788571410011,-65.78211428589988,-0.9906786657366808,-0.2801412492906494,-0.007883583778403813,2834370000.0,1.0
AMZN,2021-12-20,167.07899475097656,167.87449645996094,165.60000610351562,166.85000610351562,57372000.0,-2.938507080078125,2.938507080078125,0.0,35.915206165992046,165.19500732421875,177.99400329589844,14.719806388926973,-85.28019361107303,-1.3086721218793684,-0.48584742380839324,-0.05157401176618648,2776998000.0,-1.0
AMZN,2021-12-21,170.41700744628906,170.7165069580078,165.6475067138672,167.85049438476562,55956000.0,3.3380126953125,0.0,3.3380126953125,46.989697948912784,165.19500732421875,177.49949645996094,42.43979627647767,-57.56020372352233,-1.2766184366456343,-0.6440016263758416,-0.032590045069201046,2832954000.0,1.0
AMZN,2021-12-22,171.03700256347656,172.0500030517578,168.50050354003906,169.27000427246094,55036000.0,0.6199951171875,0.0,0.6199951171875,48.882842187214045,165.19500732421875,177.49949645996094,47.478567982866785,-52.52143201713321,-1.1874984922949068,-0.7527009995596547,-0.017993825557049425,2887990000.0,1.0
AMZN,2021-12-23,171.06849670410156,171.97500610351562,170.14999389648438,170.42799377441406,36788000.0,0.031494140625,0.0,0.031494140625,48.98961763564308,165.19500732421875,177.49949645996094,47.734524490102146,-52.265475509897854,-1.1016300746221646,-0.8224868145721568,-0.0066401230683516,2924778000.0,1.0
AMZN,2021-12-27,169.66949462890625,172.9429931640625,169.2154998779297,171.03700256347656,58688000.0,-1.3990020751953125,1.3990020751953125,0.0,44.25186100279419,165.19500732421875,177.49949645996094,36.36467353764384,-63.63532646235617,-1.1334013650694317,-0.8846697246716118,0.0006014698757537129,2866090000.0,-1.0
AMZN,2021-12-28,170.66099548339844,172.17599487304688,169.135498046875,170.1824951171875,54638000.0,0.9915008544921875,0.0,0.9915008544921875,48.33755899979962,165.19500732421875,177.17999267578125,45.6069657061957,-54.3930342938043,-1.0662830616134045,-0.9209923920599703,0.009281888568066332,2920728000.0,1.0
AMZN,2021-12-29,169.2010040283203,171.21200561523438,168.60049438476562,170.83999633789062,35754000.0,-1.459991455078125,1.459991455078125,0.0,42.9850385420028,165.19500732421875,176.96949768066406,34.02267599555759,-65.97732400444241,-1.1180126771271262,-0.9603964490734015,-0.023737116551562187,2884974000.0,-1.0
AMZN,2021-12-30,168.64450073242188,170.88800048828125,168.5240020751953,169.6999969482422,37584000.0,-0.5565032958984375,0.5565032958984375,0.0,40.98883628323358,165.19500732421875,175.927001953125,32.14214624103553,-67.85785375896447,-1.190194118275059,-1.0063559829137332,-0.0013412691456592407,2847390000.0,-1.0
AMZN,2021-12-31,166.7169952392578,169.35000610351562,166.55850219726562,168.95599365234375,47830000.0,-1.9275054931640625,1.9275054931640625,0.0,34.57241675213572,165.19500732421875,174.16600036621094,16.96565706733705,-83.03434293266295,-1.3869441856573417,-1.082473623462455,-0.019412746077616005,2799560000.0,-1.0
AMZN,2022-01-03,170.4044952392578,170.70350646972656,166.16050720214844,167.5500030517578,63520000.0,3.6875,0.0,3.6875,51.37485719854781,165.19500732421875,174.16600036621094,58.070359553887165,-41.92964044611284,-1.2311279229436138,-1.1122044833586868,0.019903761650216678,2863080000.0,1.0
AMZN,2022-01-04,167.52200317382812,171.39999389648438,166.34950256347656,170.43800354003906,70726000.0,-2.8824920654296875,2.8824920654296875,0.0,41.71288628343365,165.19500732421875,174.16600036621094,25.93911107406922,-74.06088892593078,-1.324962093581803,-1.1547560054033101,-0.016987766161621898,2792354000.0,-1.0
AMZN,2022-01-05,164.35699462890625,167.12649536132812,164.35699462890625,166.88299560546875,64302000.0,-3.165008544921875,3.165008544921875,0.0,33.68641634902899,164.35699462890625,174.16600036621094,0.0,-100.0,-1.6358589249464046,-1.2509765893119291,-0.03905592260418134,2728052000.0,-1.0
AMZN,2022-01-06,163.25399780273438,164.8000030517578,161.93699645996094,163.45050048828125,51958000.0,-1.102996826171875,1.102996826171875,0.0,31.267117751792284,161.93699645996094,172.9429931640625,11.966216038231554,-88.03378396176844,-1.9487851473346893,-1.3905383009164813,-0.04568052594092753,2676094000.0,-1.0
AMZN,2022-01-07,162.5540008544922,165.24349975585938,162.031005859375,163.83900451660156,46606000.0,-0.6999969482421875,0.6999969482421875,0.0,29.704930830201235,161.93699645996094,172.9429931640625,5.606074680190603,-94.3939253198094,-2.2275870992384625,-1.5579480605808778,-0.04193737825397992,2629488000.0,-1.0
AMZN,2022-01-10,161.48599243164062,161.6614990234375,156.30450439453125,160.5854949951172,87798000.0,-1.0680084228515625,1.0680084228515625,0.0,27.30339922953253,156.30450439453125,172.9429931640625,31.141578474349334,-68.85842152565067,-2.5058333220772795,-1.7475251128801583,-0.05376156998129278,2541690000.0,-1.0
AMZN,2022-01-11,165.36199951171875,166.35000610351562,160.70150756835938,161.5,62806000.0,3.876007080078125,0.0,3.876007080078125,45.68987055649853,156.30450439453125,172.9429931640625,54.43700592432273,-45.56299407567726,-2.386078848431083,-1.8752358599903434,-0.022689017353342722,2604496000.0,1.0
AMZN,2022-01-12,165.20700073242188,166.8780059814453,164.41700744628906,166.5749969482422,50030000.0,-0.154998779296875,0.154998779296875,0.0,45.16281438210331,156.30450439453125,172.9429931640625,53.50543827149173,-46.49456172850828,-2.2774269116044934,-1.9556740703131736,-0.020383113502491668,2554466000.0,-1.0
AMZN,2022-01-13,161.21400451660156,166.22149658203125,161.09100341796875,165.25050354003906,52188000.0,-3.9929962158203125,3.9929962158203125,0.0,33.63104660575024,156.30450439453125,172.9429931640625,29.506887254452412,-70.49311274554759,-2.484876779892943,-2.0615146122291277,-0.03300797686977763,2502278000.0,-1.0
AMZN,2022-01-14,162.13800048828125,162.25,159.80050659179688,160.14999389648438,45974000.0,0.9239959716796875,0.0,0.9239959716796875,37.86704681137488,156.30450439453125,172.17599487304688,36.75455749821661,-63.24544250178339,-2.545381963518963,-2.1582880824870947,-0.048511013394159086,2548252000.0,1.0
AMZN,2022-01-18,158.91749572753906,159.7344970703125,157.6645050048828,159.10499572753906,67292000.0,-3.2205047607421875,3.2205047607421875,0.0,30.132598198534012,156.30450439453125,171.39999389648438,17.309748933081842,-82.69025106691817,-2.8206854704815214,-2.29076756008598,-0.0513634464922238,2480960000.0,-1.0
AMZN,2022-01-19,156.2989959716797,159.25,156.25,158.76199340820312,53242000.0,-2.618499755859375,2.618499755859375,0.0,25.287053087065757,156.25,171.39999389648438,0.3234058839525819,-99.67659411604743,-3.2131177089340213,-2.4752375898555883,-0.049027415446603495,2427718000.0,-1.0
AMZN,2022-01-20,151.66749572753906,158.0,151.3509979248047,156.76600646972656,71974000.0,-4.631500244140625,4.631500244140625,0.0,19.038755803070075,151.3509979248047,171.39999389648438,1.5786217084458771,-98.42137829155412,-3.8534265453290004,-2.750875380950271,-0.07097224099342236,2355744000.0,-1.0
AMZN,2022-01-21,142.64300537109375,150.89999389648438,142.07049560546875,149.9499969482422,163972000.0,-9.024490356445312,9.024490356445312,0.0,12.239352442203085,142.07049560546875,171.39999389648438,1.9519930410823778,-98.04800695891763,-5.031081684382457,-3.2069166416367088,-0.12248849846040688,2191772000.0,-1.0
AMZN,2022-01-24,144.54400634765625,144.94500732421875,135.3520050048828,139.0,155624000.0,1.9010009765625,0.0,1.9010009765625,19.24887421870899,135.3520050048828,171.39999389648438,25.499345803768218,-74.50065419623178,-5.744764901358053,-3.714486293580978,-0.10491303814574604,2347396000.0,1.0
AMZN,2022-01-25,139.98599243164062,143.60000610351562,138.14500427246094,142.24249267578125,90824000.0,-4.558013916015625,4.558013916015625,0.0,15.765254305522788,135.3520050048828,167.12649536132812,14.583986634479029,-85.41601336552097,-6.602053262358879,-4.291999687336559,-0.15345730672711055,2256572000.0,-1.0
AMZN,2022-01-26,138.87249755859375,145.18499755859375,137.31849670410156,144.75,95602000.0,-1.113494873046875,1.113494873046875,0.0,15.000047966168864,135.3520050048828,166.8780059814453,11.16694932645657,-88.83305067354344,-7.287306660282297,-4.891061081925707,-0.15940307043332202,2160970000.0,-1.0
AMZN,2022-01-27,139.6374969482422,144.24349975585938,139.35000610351562,140.8000030517578,77516000.0,0.7649993896484375,0.0,0.7649993896484375,18.149393093624923,135.3520050048828,166.8780059814453,13.593515861860675,-86.40648413813933,-7.680114281016358,-5.448871721743838,-0.13383767516386869,2238486000.0,1.0
AMZN,2022-01-28,143.97799682617188,143.9980010986328,137.92950439453125,140.86050415039062,74392000.0,4.3404998779296875,0.0,4.3404998779296875,34.12770624611247,135.3520050048828,166.8780059814453,27.361516063207375,-72.63848393679262,-7.55409616704415,-5.869916610803901,-0.11200337741565969,2312878000.0,1.0
AMZN,2022-01-31,149.57350158691406,150.36050415039062,144.30050659179688,144.75,78308000.0,5.5955047607421875,0.0,5.5955047607421875,48.950972926154805,135.3520050048828,166.8780059814453,45.110372839879034,-54.889627160120966,-6.922912408322475,-6.080515770307616,-0.058797768602175116,2391186000.0,1.0
AMZN,2022-02-01,151.19349670410156,151.70799255371094,147.62750244140625,150.0,59220000.0,1.6199951171875,0.0,1.6199951171875,52.52018609245991,135.3520050048828,166.8780059814453,50.24897293822915,-49.75102706177084,-6.22027125002333,-6.10846686625076,-0.032664952425562666,2450406000.0,1.0
AMZN,2022-02-02,150.6125030517578,155.0749969482422,148.86349487304688,155.05050659179688,87330000.0,-0.58099365234375,0.58099365234375,0.0,51.043358335903164,135.3520050048828,166.22149658203125,49.43553413808666,-50.56446586191334,-5.645229707952865,-6.015819434591181,-0.006955957640894073,2363076000.0,-1.0
AMZN,2022-02-03,138.8455047607422,144.24749755859375,138.33299255371094,141.7375030517578,225532000.0,-11.766998291015625,11.766998291015625,0.0,30.802420110619053,135.3520050048828,162.25,12.987956003759955,-87.01204399624004,-6.069043409512005,-6.026464229575347,-0.02662241026450718,2137544000.0,-1.0
AMZN,2022-02-04,157.63949584960938,161.1999969482422,150.60800170898438,155.60650634765625,253456000.0,18.793991088867188,0.0,18.793991088867188,60.019657225330675,135.3520050048828,161.1999969482422,86.22523131996122,-13.774768680038774,-4.832692537154202,-5.787709891091119,0.09059863381990363,2391000000.0,1.0
AMZN,2022-02-07,157.9355010986328,162.6909942626953,157.25,158.52000427246094,102624000.0,0.2960052490234375,0.0,0.2960052490234375,60.32409837041121,135.3520050048828,162.6909942626953,82.60545362808703,-17.394546371912966,-3.785355195217875,-5.38723895191647,0.12822360548508072,2493624000.0,1.0
AMZN,2022-02-08,161.4134979248047,161.79249572753906,155.55050659179688,156.75050354003906,76040000.0,3.477996826171875,0.0,3.477996826171875,64.0368216098825,135.3520050048828,162.6909942626953,95.32719982496953,-4.672800175030474,-2.6442067594737466,-4.8386325134279256,0.16231435858421372,2569664000.0,1.0
AMZN,2022-02-09,161.1894989013672,163.83450317382812,160.25,162.87350463867188,68786000.0,-0.2239990234375,0.2239990234375,0.0,63.59458897679739,135.3520050048828,163.83450317382812,90.71358047046306,-9.286419529536936,-1.737880052319099,-4.21848202120616,0.15434251131781185,2500878000.0,-1.0
AMZN,2022-02-10,159.0034942626953,160.7165069580078,157.75,158.35000610351562,68268000.0,-2.186004638671875,2.186004638671875,0.0,59.00608923761215,135.3520050048828,163.83450317382812,83.03867560184696,-16.961324398153035,-1.182372260883227,-3.6112600691415735,0.10435967833796211,2432610000.0,-1.0
AMZN,2022-02-11,153.2935028076172,159.0,152.73399353027344,158.13450622558594,77100000.0,-5.709991455078125,5.709991455078125,0.0,48.466483942799336,137.31849670410156,163.83450317382812,60.24665185443501,-39.75334814556499,-1.1891689248541581,-3.1268418402840905,0.024870723632431035,2355510000.0,-1.0
AMZN,2022-02-14,155.16700744628906,158.44850158691406,151.64999389648438,151.75100708007812,83230000.0,1.873504638671875,0.0,1.873504638671875,51.73060735620052,137.31849670410156,163.83450317382812,67.31221295546605,-32.68778704453395,-1.031488802374895,-2.707771232702252,0.02628096332717278,2438740000.0,1.0
AMZN,2022-02-15,156.510498046875,158.0070037841797,154.6374969482422,157.60549926757812,56440000.0,1.3434906005859375,0.0,1.3434906005859375,54.13437180857766,137.92950439453125,163.83450317382812,71.72744461657173,-28.272555383428266,-0.7890223473672222,-2.324021455635246,0.03916006224988067,2495180000.0,1.0
AMZN,2022-02-16,158.10049438476562,158.83399963378906,154.7344970703125,155.79049682617188,52704000.0,1.589996337890625,0.0,1.589996337890625,57.05478470048585,137.92950439453125,163.83450317382812,77.86524200246214,-22.13475799753786,-0.4632267291976291,-1.9518625103477227,0.13867924393521802,2547884000.0,1.0
AMZN,2022-02-17,154.65249633789062,160.3489990234375,154.5,158.14599609375,64032000.0,-3.447998046875,3.447998046875,0.0,49.213924613942794,138.33299255371094,163.83450317382812,63.99426303517032,-36.00573696482968,-0.4777487901636448,-1.657039766310907,-0.018948293989524023,2483852000.0,-1.0
AMZN,2022-02-18,152.60150146484375,155.49949645996094,150.89300537109375,155.49949645996094,63604000.0,-2.050994873046875,2.050994873046875,0.0,44.97203249171196,138.33299255371094,163.83450317382812,55.95162233203911,-44.04837766796089,-0.6472941692244092,-1.4550906468936078,-0.03377327831098542,2420248000.0,-1.0
AMZN,2022-02-22,150.19749450683594,152.9824981689453,148.48550415039062,150.47850036621094,66128000.0,-2.4040069580078125,2.4040069580078125,0.0,40.2769110683097,138.33299255371094,163.83450317382812,46.52470251611502,-53.47529748388497,-0.9645249310164843,-1.3569775037181833,-0.06948615550846793,2354120000.0,-1.0
AMZN,2022-02-23,144.82699584960938,151.76300048828125,144.6510009765625,151.65049743652344,64244000.0,-5.3704986572265625,5.3704986572265625,0.0,31.73632387569704,138.33299255371094,163.83450317382812,25.465171034909446,-74.53482896509055,-1.6304916608486906,-1.4116803351442848,-0.10151097412226662,2289876000.0,-1.0
AMZN,2022-02-24,151.35800170898438,151.74899291992188,139.5,139.83749389648438,100786000.0,6.531005859375,0.0,6.531005859375,47.38991389681467,139.5,163.83450317382812,48.72917118660435,-51.27082881339565,-1.6126874443186523,-1.4518817569791584,-0.04808380211493679,2390662000.0,1.0
AMZN,2022-02-25,153.7884979248047,153.99000549316406,149.2135009765625,150.5500030517578,62396000.0,2.4304962158203125,0.0,2.4304962158203125,52.10586604896327,139.5,163.83450317382812,58.71703162681388,-41.282968373186115,-1.3864743293158028,-1.4388002714464876,0.0032290678216722046,2453058000.0,1.0
AMZN,2022-02-28,153.56300354003906,154.4499969482422,150.85000610351562,152.4250030517578,57684000.0,-0.225494384765625,0.225494384765625,0.0,51.61061195389905,139.5,163.83450317382812,57.790386923386585,-42.20961307661341,-1.2114297105989635,-1.393326159276983,-0.010337274222455006,2395374000.0,-1.0
AMZN,2022-03-01,151.14199829101562,154.0989990234375,149.9770050048828,152.7324981689453,44874000.0,-2.4210052490234375,2.4210052490234375,0.0,46.17379251659213,139.5,163.83450317382812,47.84152858126419,-52.15847141873581,-1.253609647872878,-1.3653828569961621,-0.034301211885809146,2350500000.0,-1.0
AMZN,2022-03-02,152.05250549316406,152.99949645996094,148.75,150.8489990234375,47334000.0,0.9105072021484375,0.0,0.9105072021484375,48.52679648942927,139.5,160.7165069580078,59.163864805871505,-40.836135194128495,-1.1997374042793467,-1.3322537664527991,-0.03825407956589122,2397834000.0,1.0
AMZN,2022-03-03,147.89849853515625,153.9290008544922,146.8560028076172,153.531494140625,65198000.0,-4.1540069580078125,4.1540069580078125,0.0,39.44872511911931,139.5,160.3489990234375,40.28250241517608,-59.71749758482391,-1.475231359318883,-1.360849285026016,-0.04367209041345177,2332636000.0,-1.0
AMZN,2022-03-04,145.64100646972656,147.85000610351562,143.8070068359375,147.15899658203125,60934000.0,-2.2574920654296875,2.2574920654296875,0.0,35.307013350722116,139.5,160.3489990234375,29.454682514125118,-70.54531748587488,-1.854347285332068,-1.4595488850872267,-0.04561223138896009,2271702000.0,-1.0
AMZN,2022-03-07,137.4530029296875,146.09449768066406,137.41650390625,145.44349670410156,86934000.0,-8.188003540039062,8.188003540039062,0.0,24.52921169800055,137.41650390625,160.3489990234375,0.15915853574147118,-99.84084146425853,-2.7834173412676364,-1.724322576323309,-0.08485155906890574,2184768000.0,-1.0
AMZN,2022-03-08,136.01449584960938,140.69949340820312,133.57249450683594,136.68350219726562,91662000.0,-1.438507080078125,1.438507080078125,0.0,23.099793857843522,133.57249450683594,160.3489990234375,9.119940734831108,-90.88005926516888,-3.5943540770494167,-2.0983288764685306,-0.06084846232087171,2093106000.0,-1.0
AMZN,2022-03-09,139.2790069580078,140.25,136.8280029296875,139.5,82656000.0,3.2645111083984375,0.0,3.2645111083984375,33.280592365716416,133.57249450683594,160.3489990234375,21.311640761899334,-78.68835923810067,-3.9283252308859744,-2.4643281473520195,-0.07980413730752611,2175762000.0,1.0
AMZN,2022-03-10,146.8175048828125,148.67449951171875,143.97799682617188,145.68499755859375,135062000.0,7.5384979248046875,0.0,7.5384979248046875,50.678741924137555,133.57249450683594,155.49949645996094,60.40502210147751,-39.59497789852249,-3.5438546453787865,-2.680233446957373,-0.0453284422180954,2310824000.0,1.0
AMZN,2022-03-11,145.52450561523438,149.6750030517578,145.36900329589844,149.57449340820312,68900000.0,-1.292999267578125,1.292999267578125,0.0,48.19169246085203,133.57249450683594,154.4499969482422,57.248280257383996,-42.751719742616,-3.3053906849690975,-2.8052648945597185,-0.052346579185713726,2241924000.0,-1.0
AMZN,2022-03-14,141.85299682617188,147.4499969482422,140.88400268554688,145.9810028076172,74086000.0,-3.6715087890625,3.6715087890625,0.0,41.516371037275015,133.57249450683594,154.4499969482422,39.66232236147776,-60.33767763852224,-3.3737755688471793,-2.918967029417211,-0.06145877102245456,2167838000.0,-1.0
AMZN,2022-03-15,147.3665008544922,147.98500061035156,142.0,142.85000610351562,75584000.0,5.5135040283203125,0.0,5.5135040283203125,52.8361991272269,133.57249450683594,154.4499969482422,66.07115188404272,-33.92884811595728,-2.949082201320465,-2.9249900637978623,-0.030818332282479544,2243422000.0,1.0
AMZN,2022-03-16,153.10400390625,153.14999389648438,147.35350036621094,148.5,84958000.0,5.7375030517578125,0.0,5.7375030517578125,61.73032767478251,133.57249450683594,154.4499969482422,93.55290200171316,-6.447097998286836,-2.1250449069490855,-2.765001032428107,0.03519647205787124,2328380000.0,1.0
AMZN,2022-03-17,157.23899841308594,157.49850463867188,152.13999938964844,152.6405029296875,72934000.0,4.1349945068359375,0.0,4.1349945068359375,66.91814187835192,133.57249450683594,157.49850463867188,98.91538027378564,-1.0846197262143538,-1.125357494495148,-2.4370723248415156,0.0796341100936444,2401314000.0,1.0
AMZN,2022-03-18,161.25050354003906,161.593994140625,156.01100158691406,156.81300354003906,102962000.0,4.011505126953125,0.0,4.011505126953125,71.27671293188779,133.57249450683594,161.593994140625,98.77418908668348,-1.225810913316529,-0.009295921966668175,-1.9515170442665462,0.17313190765664754,2504276000.0,1.0
AMZN,2022-03-21,161.4915008544922,163.08399963378906,159.55299377441406,161.12100219726562,66538000.0,0.240997314453125,0.0,0.240997314453125,71.53666470405736,133.57249450683594,163.08399963378906,94.60380359305215,-5.39619640694785,0.8844420864033964,-1.3843252181325576,0.1873109542166198,2570814000.0,1.0
AMZN,2022-03-22,164.88900756835938,166.16700744628906,161.69900512695312,161.8054962158203,64086000.0,3.3975067138671875,0.0,3.3975067138671875,75.18920746022229,133.57249450683594,166.16700744628906,96.07909502957239,-3.9209049704276087,1.845611237242224,-0.7383379270576012,0.1838755256064748,2634900000.0,1.0
AMZN,2022-03-23,163.4080047607422,166.3699951171875,162.68699645996094,163.7050018310547,55812000.0,-1.4810028076171875,1.4810028076171875,0.0,70.63046507849683,133.57249450683594,166.3699951171875,90.96885341467012,-9.031146585329882,2.45948870994431,-0.0987725996572188,0.11300082977960946,2579088000.0,-1.0
AMZN,2022-03-24,163.64950561523438,164.11849975585938,160.0500030517578,163.74949645996094,56798000.0,0.2415008544921875,0.0,0.2415008544921875,70.9617266284281,133.57249450683594,166.3699951171875,91.70519261734694,-8.294807382653063,2.9316835078903978,0.5073186218523047,0.12454946968122571,2635886000.0,1.0
AMZN,2022-03-25,164.77349853515625,165.36849975585938,162.25,164.0,49032000.0,1.123992919921875,0.0,1.123992919921875,72.62015873446273,133.57249450683594,166.3699951171875,95.13226144577808,-4.867738554221912,3.3578904513702525,1.0774329877558946,0.16157925614410096,2684918000.0,1.0
AMZN,2022-03-28,168.99049377441406,169.03750610351562,164.89999389648438,164.97500610351562,59854000.0,4.2169952392578125,0.0,4.2169952392578125,78.0476122679888,136.8280029296875,169.03750610351562,99.85404205445874,-0.1459579455412477,3.989945193110117,1.6599354288267392,0.14673614963059434,2744772000.0,1.0
AMZN,2022-03-29,169.31500244140625,170.8314971923828,167.86849975585938,170.38400268554688,66154000.0,0.3245086669921875,0.0,0.3245086669921875,78.42731222019485,140.88400268554688,170.8314971923828,94.93615484049792,-5.063845159502078,4.465562047474236,2.2210607525562387,0.10588226383081856,2810926000.0,1.0
AMZN,2022-03-30,166.30099487304688,168.95050048828125,165.5,168.50950622558594,56168000.0,-3.014007568359375,3.014007568359375,0.0,66.16307829737701,140.88400268554688,170.8314971923828,84.87184856715882,-15.12815143284119,4.546873086922034,2.686223219429398,0.0576319904821192,2754758000.0,-1.0
AMZN,2022-03-31,162.99749755859375,166.4949951171875,162.95350646972656,166.44500732421875,59966000.0,-3.303497314453125,3.303497314453125,0.0,55.23875589058533,140.88400268554688,170.8314971923828,73.84088464562255,-26.159115354377448,4.295235248448421,3.008025625233203,0.01083403760113466,2694792000.0,-1.0
AMZN,2022-04-01,163.55999755859375,165.82699584960938,162.3195037841797,164.14950561523438,57090000.0,0.5625,0.0,0.5625,56.645168602078435,142.0,170.8314971923828,74.7793200426991,-25.220679957300895,4.094006340830077,3.2252217683525783,0.012808703202067173,2751882000.0,1.0
AMZN,2022-04-04,168.34649658203125,168.39450073242188,163.20550537109375,164.125,49882000.0,4.7864990234375,0.0,4.7864990234375,66.86674882406619,147.35350036621094,170.8314971923828,89.41561910604983,-10.584380893950167,4.271522003787084,3.43448181543948,0.02096858404729307,2801764000.0,1.0
AMZN,2022-04-05,164.05499267578125,168.11050415039062,163.26600646972656,167.7415008544922,53728000.0,-4.29150390625,4.29150390625,0.0,53.75552838697552,152.13999938964844,170.8314971923828,63.74552436557423,-36.25447563442577,4.019580721516462,3.5515015966548766,0.00395934040065149,2748036000.0,-1.0
AMZN,2022-04-06,158.75599670410156,162.1999969482422,157.25450134277344,161.65049743652344,79056000.0,-5.2989959716796875,5.2989959716796875,0.0,42.01750108101163,156.01100158691406,170.8314971923828,18.521614865393566,-81.47838513460644,3.353671710925198,3.511935619508941,-0.029902375156807492,2668980000.0,-1.0
AMZN,2022-04-07,157.7845001220703,160.07899475097656,154.51150512695312,158.39999389648438,68136000.0,-0.97149658203125,0.97149658203125,0.0,40.16231975446574,154.51150512695312,170.8314971923828,20.05512614218917,-79.94487385781083,2.7162313432523604,3.352794764257625,-0.042415791830715754,2600844000.0,-1.0
AMZN,2022-04-08,154.4604949951172,157.36849975585938,154.2310028076172,156.75,46002000.0,-3.324005126953125,3.324005126953125,0.0,34.20075632233555,154.2310028076172,170.8314971923828,1.3824418850477513,-98.61755811495226,1.9206952462788252,3.066374860661865,-0.08598116056571214,2554842000.0,-1.0
AMZN,2022-04-11,151.1219940185547,154.13650512695312,150.5345001220703,152.71299743652344,52112000.0,-3.3385009765625,3.3385009765625,0.0,29.181033092643787,150.5345001220703,170.8314971923828,2.8944867777690906,-97.10551322223091,1.0092045482828382,2.6549407981860598,-0.10745065800738773,2502730000.0,-1.0
AMZN,2022-04-12,150.78750610351562,155.0989990234375,150.38299560546875,153.6925048828125,55178000.0,-0.3344879150390625,0.3344879150390625,0.0,28.69416150513645,150.38299560546875,170.8314971923828,1.9781913913229705,-98.02180860867703,0.25688995636508594,2.175330629821865,-0.09328560410221332,2447552000.0,-1.0
AMZN,2022-04-13,155.54100036621094,156.02499389648438,149.60000610351562,150.01849365234375,53390000.0,4.7534942626953125,0.0,4.7534942626953125,44.0117697288122,149.60000610351562,170.8314971923828,27.98199258746596,-72.01800741253403,0.043738294691650026,1.749012162795822,-0.04574608386059653,2500942000.0,1.0
AMZN,2022-04-14,151.7064971923828,155.89700317382812,151.4720001220703,155.38999938964844,51598000.0,-3.834503173828125,3.834503173828125,0.0,36.678164971448226,149.60000610351562,170.8314971923828,9.921540979153058,-90.07845902084695,-0.4296456056107445,1.3132806091145086,-0.07247187908500996,2449344000.0,-1.0
AMZN,2022-04-18,152.78500366210938,154.0395050048828,150.25050354003906,151.52349853515625,46514000.0,1.0785064697265625,0.0,1.0785064697265625,39.92672954529712,149.60000610351562,170.8314971923828,15.00129004252469,-84.99870995747531,-0.7095994774294638,0.9087045918057141,-0.09243728402948459,2495858000.0,1.0
AMZN,2022-04-19,158.11549377441406,158.6490020751953,151.55050659179688,152.0294952392578,54926000.0,5.3304901123046875,0.0,5.3304901123046875,53.52417714472352,149.60000610351562,168.95050048828125,44.00656387158027,-55.99343612841974,-0.4956256702952828,0.6278385393855146,-0.03620431664097723,2550784000.0,1.0
AMZN,2022-04-20,153.9980010986328,157.6024932861328,153.60350036621094,157.6024932861328,59630000.0,-4.11749267578125,4.11749267578125,0.0,44.53893912500499,149.60000610351562,168.39450073242188,23.400442959253596,-76.5995570407464,-0.6507951725140515,0.3721117970056013,-0.029970493740384296,2491154000.0,-1.0
AMZN,2022-04-21,148.29600524902344,156.73800659179688,147.58949279785156,154.71400451660156,63970000.0,-5.701995849609375,5.701995849609375,0.0,35.11873319753113,147.58949279785156,168.39450073242188,3.3958768648096007,-96.6041231351904,-1.2198103184091451,0.053727373922651964,-0.06013578561713018,2427184000.0,-1.0
AMZN,2022-04-22,144.35000610351562,149.61500549316406,143.69749450683594,148.25,73078000.0,-3.9459991455078125,3.9459991455078125,0.0,30.04456913306977,143.69749450683594,168.39450073242188,2.6420675879479263,-97.35793241205208,-1.966499491975327,-0.35031799925694396,-0.06545679457987741,2354106000.0,-1.0
AMZN,2022-04-25,146.07400512695312,146.22149658203125,142.30650329589844,144.0229949951172,61874000.0,1.7239990234375,0.0,1.7239990234375,34.79399580235027,142.30650329589844,168.11050415039062,14.6004561552276,-85.3995438447724,-2.391575139002498,-0.7585694272060549,-0.03340340315375778,2415980000.0,1.0
AMZN,2022-04-26,139.39100646972656,144.8560028076172,138.92950439453125,144.8000030517578,77530000.0,-6.6829986572265625,6.6829986572265625,0.0,26.6892644938321,138.92950439453125,162.1999969482422,1.98320716302035,-98.01679283697965,-3.2304738990561077,-1.2529503215760656,-0.0755798668489508,2338450000.0,-1.0
AMZN,2022-04-27,138.16700744628906,141.94850158691406,135.7834930419922,140.19149780273438,71336000.0,-1.2239990234375,1.2239990234375,0.0,25.437105134691635,135.7834930419922,160.07899475097656,9.810517324758358,-90.18948267524163,-3.9485571927164074,-1.7920716958041343,-0.1117004061888246,2267114000.0,-1.0
AMZN,2022-04-28,144.59649658203125,145.9375,140.3000030517578,142.17799377441406,117316000.0,6.4294891357421875,0.0,6.4294891357421875,41.945421314473606,135.7834930419922,158.6490020751953,38.5427830504086,-61.4572169495914,-3.9532665408216303,-2.2243106648076334,-0.0468668167938463,2384430000.0,1.0
AMZN,2022-04-29,124.28150177001952,130.76100158691406,121.625,129.8489990234375,272662000.0,-20.314994812011733,20.314994812011733,0.0,23.210481006363523,121.625,158.6490020751953,7.17508000519283,-92.82491999480717,-5.532474117180556,-2.885943355282218,-0.18655955237024824,2111768000.0,-1.0
AMZN,2022-05-02,124.5,124.66799926757812,118.375,122.4010009765625,148788000.0,0.21849822998048296,0.0,0.21849822998048296,23.63378089683907,118.375,158.6490020751953,15.208322203897328,-84.79167779610268,-6.689266814019675,-3.64660804702971,-0.21260088415101075,2260556000.0,1.0
AMZN,2022-05-03,124.25350189208984,126.22049713134766,122.8249969482422,124.05349731445312,79134000.0,-0.24649810791015625,0.24649810791015625,0.0,23.46540195324748,118.375,158.6490020751953,14.596269526713868,-85.40373047328613,-7.539018584379107,-4.42509015449959,-0.19314860578931914,2181422000.0,-1.0
AMZN,2022-05-04,125.92849731445312,126.0,119.18299865722656,123.5999984741211,110746000.0,1.6749954223632812,0.0,1.6749954223632812,27.51445905078394,118.375,158.6490020751953,18.75526872236348,-81.24473127763652,-7.985245908268439,-5.13712130525336,-0.15083014472986023,2292168000.0,1.0
AMZN,2022-05-05,116.40699768066406,123.4990005493164,115.07250213623048,123.0,144392000.0,-9.521499633789062,9.521499633789062,0.0,20.42639711808016,115.07250213623048,158.6490020751953,3.062420218013684,-96.93757978198632,-9.003404085426808,-5.91037786128805,-0.19357815892860575,2147776000.0,-1.0
AMZN,2022-05-06,114.77249908447266,119.05049896240234,113.0814971923828,114.8499984741211,124260000.0,-1.6344985961914062,1.6344985961914062,0.0,19.434716471672417,113.0814971923828,158.6490020751953,3.7109819737522707,-96.28901802624773,-9.828890817820536,-6.694080452594547,-0.21428525914159935,2023516000.0,-1.0
AMZN,2022-05-09,108.78900146484376,114.0,107.95700073242188,111.3125,128124000.0,-5.983497619628892,5.983497619628892,0.0,16.12748121667434,107.95700073242188,157.6024932861328,1.6758837300722849,-98.32411626992771,-10.84094557989063,-7.5234534780537645,-0.21954074211759889,1895392000.0,-1.0
AMZN,2022-05-10,108.85900115966795,112.64250183105467,107.1709976196289,111.25,105434000.0,0.06999969482419033,0.0,0.06999969482419033,16.31970141968965,107.1709976196289,156.73800659179688,3.4054980823774694,-96.59450191762254,-11.504738416912375,-8.319710465825487,-0.21212014958067527,2000826000.0,1.0
AMZN,2022-05-11,105.37200164794922,110.15599822998048,104.42849731445312,108.10350036621094,109704000.0,-3.486999511718736,3.486999511718736,0.0,14.420143365811214,104.42849731445312,149.61500549316406,2.088022225051269,-97.91197777494874,-12.17186110307037,-9.090140593274464,-0.2712686397061461,1891122000.0,-1.0
AMZN,2022-05-12,106.93049621582033,110.78050231933594,102.40550231933594,102.75,132026000.0,1.558494567871108,0.0,1.558494567871108,19.266290365087855,102.40550231933594,146.22149658203125,10.327265129156144,-89.67273487084387,-12.43150055144865,-9.758412584909301,-0.13961052374718552,2023148000.0,1.0
AMZN,2022-05-13,113.05500030517578,113.18399810791016,107.8000030517578,109.06900024414062,93684000.0,6.1245040893554545,0.0,6.1245040893554545,35.76077844296927,102.40550231933594,145.9375,24.463609650907685,-75.53639034909231,-12.00468782095372,-10.207667632118186,-0.09192770839216236,2116832000.0,1.0
AMZN,2022-05-16,110.8105010986328,113.99250030517578,110.35399627685548,113.0999984741211,74566000.0,-2.244499206542983,2.244499206542983,0.0,32.91697072685152,102.40550231933594,145.9375,19.30763398673563,-80.69236601326438,-11.712533193071323,-10.508640744308815,-0.10819011608326223,2042266000.0,-1.0
AMZN,2022-05-17,115.36849975585938,115.8000030517578,111.27649688720705,113.2750015258789,76448000.0,4.557998657226577,0.0,4.557998657226577,43.453583002470545,102.40550231933594,145.9375,29.778089973300975,-70.22191002669904,-10.986559922865396,-10.604224580020132,-0.08385709179253231,2118714000.0,1.0
AMZN,2022-05-18,107.1125030517578,112.85299682617188,106.2490005493164,111.4394989013672,108380000.0,-8.255996704101577,8.255996704101577,0.0,32.71441350486589,102.40550231933594,130.76100158691406,16.599957165289197,-83.4000428347108,-10.951172511802,-10.673614166376506,-0.07984481014108435,2010334000.0,-1.0
AMZN,2022-05-19,107.31900024414062,110.03399658203124,106.19300079345705,106.28050231933594,88142000.0,0.2064971923828267,0.0,0.2064971923828267,33.1909247043227,102.40550231933594,126.22049713134766,20.63195043118983,-79.36804956881018,-10.782174934946255,-10.695326320090457,-0.06494150514964603,2098476000.0,1.0
AMZN,2022-05-20,107.59100341796876,109.89800262451172,105.0094985961914,109.56849670410156,99500000.0,0.2720031738281392,0.0,0.2720031738281392,33.902375142275815,102.40550231933594,126.22049713134766,21.774101315434187,-78.2258986845658,-10.505197378700387,-10.657300531812444,-0.011012124670177648,2197976000.0,1.0
AMZN,2022-05-23,107.55699920654295,108.81900024414062,103.9499969482422,108.46099853515624,107798000.0,-0.03400421142580967,0.03400421142580967,0.0,33.85037801431652,102.40550231933594,126.0,21.833467094443478,-78.16653290555652,-10.171187408436865,-10.560077907137329,-0.011960443686372835,2090178000.0,-1.0
AMZN,2022-05-24,104.0999984741211,105.4000015258789,101.26000213623048,104.0250015258789,102934000.0,-3.457000732421861,3.457000732421861,0.0,28.68886256577082,101.26000213623048,123.4990005493164,12.77034282362057,-87.22965717637943,-10.069359855877323,-10.461934296885328,-0.012071547981767683,1987244000.0,-1.0
AMZN,2022-05-25,106.7750015258789,108.1750030517578,103.6500015258789,103.65550231933594,93120000.0,2.6750030517578125,0.0,2.6750030517578125,37.23385844419094,101.26000213623048,119.05049896240234,30.999692945816033,-69.00030705418398,-9.661439337852826,-10.301835305078828,-0.001454165981120914,2080364000.0,1.0
AMZN,2022-05-26,111.07749938964844,112.66549682617188,107.45349884033205,107.97000122070312,93002000.0,4.302497863769531,0.0,4.302497863769531,48.65257841527312,101.26000213623048,115.8000030517578,67.52060959593075,-32.47939040406926,-8.888522414793854,-10.019172727021834,-0.017491494495505355,2173366000.0,1.0
AMZN,2022-05-27,115.14649963378906,115.18699645996094,112.62799835205078,113.5500030517578,93660000.0,4.069000244140625,0.0,4.069000244140625,57.15768695262246,101.26000213623048,115.8000030517578,95.50547883892595,-4.49452116107405,-7.857074408137649,-9.586753063244998,0.03912985224475052,2267026000.0,1.0
AMZN,2022-05-31,120.20950317382812,121.99449920654295,115.6750030517578,116.27999877929688,144634000.0,5.0630035400390625,0.0,5.0630035400390625,65.38861216402226,101.26000213623048,121.99449920654295,91.39117757878692,-8.608822421213082,-6.555534241231371,-8.980509298842273,0.04196122362874788,2411660000.0,1.0
AMZN,2022-06-01,121.68399810791016,125.1790008544922,120.62249755859376,122.25599670410156,127528000.0,1.4744949340820312,0.0,1.4744949340820312,67.48759007314541,101.26000213623048,125.1790008544922,85.38817285895135,-14.611827141048654,-5.343478568814135,-8.253103152836646,0.13603916107824743,2539188000.0,1.0
AMZN,2022-06-02,125.51100158691406,125.61000061035156,120.04499816894533,121.68399810791016,100560000.0,3.8270034790039062,0.0,3.8270034790039062,72.4847748068957,101.26000213623048,125.61000061035156,99.59343314315721,-0.40656685684278426,-4.027679931771118,-7.40801850862354,0.16951333222810816,2639748000.0,1.0
AMZN,2022-06-03,122.3499984741211,124.4000015258789,121.04650115966795,124.1999969482422,97604000.0,-3.1610031127929688,3.1610031127929688,0.0,63.223537590509004,101.26000213623048,125.61000061035156,86.61190003894595,-13.388099961054062,-3.2030438697890133,-6.5670235808566355,0.13717685110544697,2542144000.0,-1.0
AMZN,2022-06-06,124.79000091552734,128.99000549316406,123.80999755859376,125.25,135269000.0,2.44000244140625,0.0,2.44000244140625,66.98103674397707,101.26000213623048,128.99000549316406,84.85393411758619,-15.1460658824138,-2.3258154912032296,-5.718781962925955,0.1602220388827662,2677413000.0,1.0
AMZN,2022-06-07,123.0,124.0999984741211,120.62999725341795,122.01000213623048,85156700.0,-1.7900009155273438,1.7900009155273438,0.0,61.64930801263328,101.26000213623048,128.99000549316406,78.39882882067403,-21.601171179325977,-1.7548153759863112,-4.925988645538027,0.18155621328445437,2592256300.0,-1.0
AMZN,2022-06-08,121.18000030517578,123.75,120.75,122.61000061035156,64926600.0,-1.8199996948242188,1.8199996948242188,0.0,56.383841997548785,101.26000213623048,128.99000549316406,71.83554185890326,-28.16445814109675,-1.4326378781700413,-4.2273184920644296,0.134909843815882,2527329700.0,-1.0
AMZN,2022-06-09,116.1500015258789,121.3000030517578,116.0999984741211,119.98999786376952,67029800.0,-5.029998779296875,5.029998779296875,0.0,44.31416496427076,101.26000213623048,128.99000549316406,53.69634903388983,-46.30365096611017,-1.565146716939708,-3.694884137039485,0.04566633354282357,2460299900.0,-1.0
AMZN,2022-06-10,109.6500015258789,114.5,109.0500030517578,113.41999816894533,87266000.0,-6.5,6.5,0.0,33.59222936212463,101.26000213623048,128.99000549316406,30.25603452568857,-69.74396547431144,-2.169646271908107,-3.3898365640132098,-0.04773482585568101,2373033900.0,-1.0
AMZN,2022-06-13,103.66999816894533,106.54000091552734,101.86000061035156,104.19000244140624,99277700.0,-5.9800033569335795,5.9800033569335795,0.0,26.727480879034843,101.26000213623048,128.99000549316406,8.690933072362037,-91.30906692763796,-3.0955690255343598,-3.33098305631744,-0.13758899727724494,2273756200.0,-1.0
AMZN,2022-06-14,102.30999755859376,104.87999725341795,101.43000030517578,104.19000244140624,69728800.0,-1.3600006103515625,1.3600006103515625,0.0,25.367154442747335,101.43000030517578,128.99000549316406,3.1930228148197877,-96.80697718518022,-3.89422001765665,-3.443630448585283,-0.15921568037348188,2204027400.0,-1.0
AMZN,2022-06-15,107.66999816894533,109.05999755859376,103.52999877929688,103.86000061035156,85011100.0,5.3600006103515625,0.0,5.3600006103515625,39.3943766215616,101.43000030517578,128.99000549316406,22.641497420650627,-77.35850257934938,-4.047986757466205,-3.5645017103614673,-0.14214692889383218,2289038500.0,1.0
AMZN,2022-06-16,103.66000366210938,104.58000183105467,102.01000213623048,104.47000122070312,82186300.0,-4.009994506835952,4.009994506835952,0.0,33.89510136854177,101.43000030517578,128.99000549316406,8.091447522315837,-91.90855247768417,-4.442213972876942,-3.7400441628645624,-0.15275843927341726,2206852200.0,-1.0
AMZN,2022-06-17,106.22000122070312,106.9800033569336,102.51000213623048,102.8000030517578,99772100.0,2.55999755859375,0.0,2.55999755859375,40.05878638953811,101.43000030517578,128.99000549316406,17.38026129840865,-82.61973870159134,-4.496241598819466,-3.8912836500555437,-0.1488099972640804,2306624300.0,1.0
AMZN,2022-06-21,108.68000030517578,111.62999725341795,103.55999755859376,108.1999969482422,70901200.0,2.4599990844726562,0.0,2.4599990844726562,45.67507280554649,101.43000030517578,128.99000549316406,26.306235976906965,-73.69376402309304,-4.291092471678951,-3.9712454143802254,-0.11642276174653832,2377525500.0,1.0
AMZN,2022-06-22,108.9499969482422,112.12999725341795,107.0199966430664,107.43000030517578,60040100.0,0.26999664306642046,0.0,0.26999664306642046,46.312119549609754,101.43000030517578,128.99000549316406,27.285904308697035,-72.71409569130297,-4.059923566105681,-3.9889810447253167,-0.10092427237278379,2437565600.0,1.0
AMZN,2022-06-23,112.44000244140624,113.0,107.93000030517578,110.38999938964844,64345300.0,3.490005493164034,0.0,3.490005493164034,54.30426638304835,101.43000030517578,128.99000549316406,39.949201972679745,-60.050798027320255,-3.5541363948644715,-3.9020121147531484,-0.031941446713163124,2501910900.0,1.0
AMZN,2022-06-24,116.45999908447266,116.70999908447266,111.43000030517578,112.37999725341795,69867600.0,4.0199966430664205,0.0,4.0199966430664205,61.85185334653018,101.43000030517578,128.99000549316406,54.53554408562859,-45.46445591437141,-2.7966779228512166,-3.680945276372762,0.06210668001665742,2571778500.0,1.0
AMZN,2022-06-27,113.22000122070312,117.9800033569336,112.6999969482422,117.08999633789062,62133200.0,-3.2399978637695312,3.2399978637695312,0.0,53.616242998794355,101.43000030517578,124.0999984741211,52.00706602472502,-47.99293397527497,-2.4298179476104877,-3.430719810620307,0.09211925552650913,2509645300.0,-1.0
AMZN,2022-06-28,107.4000015258789,114.8499984741211,107.04000091552734,113.5,74942900.0,-5.819999694824219,5.819999694824219,0.0,42.01983345579998,101.43000030517578,123.75,26.747317662766402,-73.2526823372336,-2.5789752879906302,-3.260370906094372,0.04975079746600586,2434702400.0,-1.0
AMZN,2022-06-29,108.91999816894533,110.98999786376952,106.91000366210938,107.37999725341795,66375300.0,1.5199966430664205,0.0,1.5199966430664205,45.56757844163758,101.43000030517578,121.3000030517578,37.69500165297136,-62.304998347028636,-2.545193126870174,-3.1173353502495327,0.011609547889456007,2501077700.0,1.0
AMZN,2022-06-30,106.20999908447266,108.18000030517578,102.5199966430664,108.11000061035156,97679400.0,-2.7099990844726705,2.7099990844726705,0.0,40.47295309235661,101.43000030517578,117.9800033569336,28.882162524974163,-71.11783747502584,-2.705902834988777,-3.0350488471973818,0.02459960768162084,2403398300.0,-1.0
AMZN,2022-07-01,109.55999755859376,109.75,105.8499984741211,106.29000091552734,73021200.0,3.349998474121108,0.0,3.349998474121108,48.66013429397508,101.43000030517578,117.9800033569336,49.1238414155729,-50.8761585844271,-2.5337421544112004,-2.934787508640146,0.031444137634218494,2476419500.0,1.0
AMZN,2022-07-05,113.5,114.08000183105467,106.31999969482422,107.5999984741211,76583700.0,3.940002441406236,0.0,3.940002441406236,56.735333006895324,101.43000030517578,117.9800033569336,72.9304983030939,-27.069501696906105,-2.055681686787679,-2.758966344269653,0.044350383523091175,2553003200.0,1.0
AMZN,2022-07-06,114.33000183105467,115.4800033569336,112.01000213623048,113.20999908447266,66958900.0,0.8300018310546733,0.0,0.8300018310546733,58.32852398946592,102.01000213623048,117.9800033569336,77.14463840398992,-22.855361596010084,-1.5914953431604744,-2.5254721440478174,0.04938049594777216,2619962100.0,1.0
AMZN,2022-07-07,116.33000183105467,116.98999786376952,113.48999786376952,113.8499984741211,57872300.0,2.0,0.0,2.0,62.19877554598219,102.01000213623048,117.9800033569336,89.66811897459407,-10.331881025405933,-1.0501357252968546,-2.2304048602976247,0.034596222920535435,2677834400.0,1.0
AMZN,2022-07-08,115.54000091552734,116.58000183105467,113.69000244140624,114.5999984741211,45719700.0,-0.7900009155273295,0.7900009155273295,0.0,59.67283855329403,102.51000213623048,117.9800033569336,84.22752263173156,-15.772477368268442,-0.6770462319096424,-1.9197331346200281,-0.007899692393763535,2632114700.0,-1.0
AMZN,2022-07-11,111.75,114.3000030517578,110.87000274658205,114.08000183105467,53487600.0,-3.7900009155273438,3.7900009155273438,0.0,48.720393307792826,102.5199966430664,117.9800033569336,59.70245374249769,-40.29754625750231,-0.6793602775667438,-1.6716585632093712,-0.012983582448807818,2578627100.0,-1.0
AMZN,2022-07-12,109.22000122070312,113.2300033569336,108.33999633789062,112.16000366210938,54280300.0,-2.529998779296875,2.529998779296875,0.0,42.68581563786895,102.5199966430664,117.9800033569336,43.337656326028664,-56.662343673971336,-0.8752545432811161,-1.5123777592237202,0.016945993193358433,2524346800.0,-1.0
AMZN,2022-07-13,110.4000015258789,111.77999877929688,106.01000213623048,107.02999877929688,61353800.0,1.1800003051757812,0.0,1.1800003051757812,46.267465571690245,102.5199966430664,117.9800033569336,50.97025524409611,-49.0297447559039,-0.924627467364914,-1.3948277008519592,0.013587985510594258,2585700600.0,1.0
AMZN,2022-07-14,110.62999725341795,111.18000030517578,107.58000183105467,110.23999786376952,51163100.0,0.2299957275390483,0.0,0.2299957275390483,47.0121679258997,102.5199966430664,117.9800033569336,52.457937182375915,-47.542062817624085,-0.9344256550643166,-1.3027472916944307,0.04161565019344282,2636863700.0,1.0
AMZN,2022-07-15,113.5500030517578,115.58999633789062,111.58999633789062,112.5,84317800.0,2.9200057983398438,0.0,2.9200057983398438,55.95463699807342,102.5199966430664,117.9800033569336,71.34541797318748,-28.654582026812513,-0.6985186369547876,-1.1819015607465022,0.036418451826179865,2721181500.0,1.0
AMZN,2022-07-18,113.76000213623048,117.23999786376952,113.1500015258789,115.0,59115400.0,0.20999908447268467,0.0,0.20999908447268467,56.56294463134343,102.5199966430664,117.23999786376952,76.35872663757286,-23.641273362427135,-0.4889788110483124,-1.0433170108068643,0.0022907677200922905,2780296900.0,1.0
AMZN,2022-07-19,118.20999908447266,118.9499969482422,114.02999877929688,115.6999969482422,60990000.0,4.449996948242173,0.0,4.449996948242173,67.52821706606852,102.5199966430664,118.9499969482422,95.49605690794522,-4.503943092054786,0.03574848786695384,-0.8275039110721006,0.03393682490403038,2841286900.0,1.0
AMZN,2022-07-20,122.7699966430664,123.4800033569336,118.31999969482422,118.62000274658205,71268300.0,4.55999755859375,0.0,4.55999755859375,74.99242108651202,102.5199966430664,123.4800033569336,96.6125644730951,-3.387435526904891,0.8102127183252179,-0.4999605851926369,0.055359706959899224,2912555200.0,1.0
AMZN,2022-07-21,124.62999725341795,124.8499984741211,121.26000213623048,123.1999969482422,60239900.0,1.8600006103515483,0.0,1.8600006103515483,77.43378474861333,105.8499984741211,124.8499984741211,98.84209883840454,-1.1579011615954695,1.5561296117513308,-0.08874254580384328,0.07867401995726486,2972795100.0,1.0
AMZN,2022-07-22,122.41999816894533,125.5,121.3499984741211,125.01000213623048,51463800.0,-2.209999084472628,2.209999084472628,0.0,68.2933628813544,106.01000213623048,125.5,84.19701298797897,-15.802987012021031,1.9465075401842,0.31830747139376553,0.09548096795476813,2921331300.0,-1.0
AMZN,2022-07-25,121.13999938964844,123.63999938964844,120.02999877929688,122.6999969482422,50221300.0,-1.2799987792968892,1.2799987792968892,0.0,63.29987527316186,106.01000213623048,125.5,77.62954803367893,-22.37045196632107,2.128068606674205,0.6802596984498536,0.10913750261601196,2871110000.0,-1.0
AMZN,2022-07-26,114.80999755859376,118.1500015258789,114.52999877929688,115.79000091552734,67075100.0,-6.330001831054673,6.330001831054673,0.0,44.66474226087046,106.01000213623048,125.5,45.151341133401715,-54.848658866598285,1.7411084003736903,0.8924294388346211,0.03994561568625632,2804034900.0,-1.0
AMZN,2022-07-27,120.97000122070312,121.9000015258789,117.16000366210938,117.30999755859376,61582000.0,6.160003662109361,0.0,6.160003662109361,58.41215807157263,106.01000213623048,125.5,76.75731515744386,-23.242684842556148,1.9094890619262088,1.0958413634529387,0.09346474034162289,2865616900.0,1.0
AMZN,2022-07-28,122.27999877929688,122.83999633789062,118.08000183105467,121.56999969482422,82245500.0,1.30999755859375,0.0,1.30999755859375,60.801747355518536,106.01000213623048,125.5,83.47869895517603,-16.521301044823982,2.124151903293324,1.3015034714210159,0.07688239095475691,2947862400.0,1.0
AMZN,2022-07-29,134.9499969482422,137.64999389648438,132.41000366210938,134.89999389648438,148892900.0,12.669998168945312,0.0,12.669998168945312,76.11647494682111,106.01000213623048,137.64999389648438,91.4665055266104,-8.53349447338959,3.278840286464984,1.6969708344298098,0.18626928985669444,3096755300.0,1.0
AMZN,2022-08-01,135.38999938964844,138.8300018310547,133.50999450683594,134.9600067138672,76846900.0,0.44000244140625,0.0,0.44000244140625,76.48462170377908,106.01000213623048,138.8300018310547,89.51857869167273,-10.481421308327272,4.1812448807262825,2.1938256436891046,0.14533457777035408,3173602200.0,1.0
AMZN,2022-08-02,134.16000366210938,137.44000244140625,134.08999633789062,134.72000122070312,61922400.0,-1.2299957275390625,1.2299957275390625,0.0,72.86202320613954,107.58000183105467,138.8300018310547,85.056005859375,-14.943994140624994,4.742488195620481,2.70355815407538,0.09277516763446325,3111679800.0,-1.0
AMZN,2022-08-03,139.52000427246094,140.49000549316406,136.0500030517578,136.2100067138672,71827800.0,5.3600006103515625,0.0,5.3600006103515625,78.08187936577603,111.58999633789062,140.49000549316406,96.64359545531104,-3.3564045446889663,5.555741688222383,3.2739948609047813,0.11947370093225795,3183507600.0,1.0
AMZN,2022-08-04,142.57000732421875,143.55999755859375,139.5500030517578,140.5800018310547,70585000.0,3.0500030517578125,0.0,3.0500030517578125,80.53951788700778,113.1500015258789,143.55999755859375,96.74452363193348,-3.255476368066527,6.3728978966607315,3.893775468055972,0.16459736527250612,3254092600.0,1.0
AMZN,2022-08-05,140.8000030517578,142.86000061035156,139.60000610351562,140.10000610351562,50686900.0,-1.7700042724609375,1.7700042724609375,0.0,74.91475759793417,114.02999877929688,143.55999755859375,90.65359085361379,-9.346409146386204,6.7992974582134025,4.474879866087458,0.16229159452834985,3203405700.0,-1.0
AMZN,2022-08-08,139.41000366210938,144.22999572753906,138.2899932861328,142.0500030517578,52229000.0,-1.3899993896484375,1.3899993896484375,0.0,70.45612247223656,114.52999877929688,144.22999572753906,83.7710688192008,-16.2289311807992,6.945003175261789,4.968904527922325,0.21426710762676304,3151176700.0,-1.0
AMZN,2022-08-09,137.8300018310547,138.9499969482422,136.2100067138672,138.0500030517578,40434700.0,-1.5800018310546875,1.5800018310546875,0.0,65.35458039965945,114.52999877929688,144.22999572753906,78.45119678753649,-21.548803212463504,6.853974708645609,5.345918564066982,0.1393734020022983,3110742000.0,-1.0
AMZN,2022-08-10,142.69000244140625,144.60000610351562,141.00999450683594,142.89999389648438,54773800.0,4.8600006103515625,0.0,4.8600006103515625,72.43770330994984,114.52999877929688,144.60000610351562,93.6481436751396,-6.351856324860402,7.092240491938526,5.695182949641291,0.16691203684870315,3165515800.0,1.0
AMZN,2022-08-11,140.63999938964844,144.49000549316406,139.75999450683594,143.86000061035156,44867300.0,-2.0500030517578125,2.0500030517578125,0.0,65.88210259463364,114.52999877929688,144.60000610351562,86.83070918084628,-13.169290819153709,7.034559702732224,5.963058300259478,0.042163783401851784,3120648500.0,-1.0
AMZN,2022-08-12,143.5500030517578,143.57000732421875,140.1199951171875,142.0500030517578,47643500.0,2.910003662109375,0.0,2.910003662109375,70.2865182770652,114.52999877929688,144.60000610351562,96.5081383571459,-3.491861642854098,7.141339322949847,6.198714504797552,0.06027035747762377,3168292000.0,1.0
AMZN,2022-08-15,143.17999267578125,143.75999450683594,141.49000549316406,142.8000030517578,39014600.0,-0.3700103759765625,0.3700103759765625,0.0,68.98005309563945,117.16000366210938,144.60000610351562,94.82502441183601,-5.174975588163985,7.114099288023084,6.381791461442659,0.0672330707174793,3129277400.0,-1.0
AMZN,2022-08-16,144.77999877929688,146.57000732421875,142.0,143.91000366210938,59102900.0,1.600006103515625,0.0,1.600006103515625,71.61277170317413,118.08000183105467,146.57000732421875,93.71706493580223,-6.282935064197765,7.139320838283737,6.533297336810874,0.03770064754702829,3188380300.0,1.0
AMZN,2022-08-17,142.10000610351562,143.3800048828125,140.77999877929688,142.69000244140625,48149800.0,-2.67999267578125,2.67999267578125,0.0,61.5214144913244,132.41000366210938,146.57000732421875,68.43220293322126,-31.567797066778734,6.863932940980817,6.599424457644863,-0.003296634611474003,3140230500.0,-1.0
AMZN,2022-08-18,142.3000030517578,142.77000427246094,140.3800048828125,141.32000732421875,37458700.0,0.1999969482421875,0.0,0.1999969482421875,61.982708629857974,133.50999450683594,146.57000732421875,67.30474669383491,-32.695253306165085,6.585905906874103,6.596720747490712,0.010653408860002767,3177689200.0,1.0
AMZN,2022-08-19,138.22999572753906,141.11000061035156,137.91000366210938,140.47000122070312,47792800.0,-4.07000732421875,4.07000732421875,0.0,48.367306589749,134.08999633789062,146.57000732421875,33.17304282972038,-66.82695717027963,5.968352450791599,6.471047088150891,-0.008464298856417196,3129896400.0,-1.0
AMZN,2022-08-22,133.22000122070312,136.32000732421875,132.85000610351562,135.72000122070312,50461500.0,-5.0099945068359375,5.0099945068359375,0.0,36.86542020869285,132.85000610351562,146.57000732421875,2.69675717396575,-97.30324282603425,5.016841178947516,6.180205906310216,-0.0334470039114001,3079434900.0,-1.0
AMZN,2022-08-23,133.6199951171875,134.99000549316406,132.9499969482422,133.41000366210938,36252100.0,0.399993896484375,0.0,0.399993896484375,38.21885441354997,132.85000610351562,146.57000732421875,5.61216432335284,-94.38783567664716,4.246091505524902,5.793383026153154,-0.06356442055527489,3115687000.0,1.0
AMZN,2022-08-24,133.8000030517578,135.47000122070312,132.10000610351562,132.75,38627000.0,0.1800079345703125,0.0,0.1800079345703125,38.89900383926677,132.10000610351562,146.57000732421875,11.748422977393373,-88.25157702260663,3.6081989014070643,5.3563462012039365,-0.04863478645886621,3154314000.0,1.0
AMZN,2022-08-25,137.27999877929688,137.4199981689453,134.27999877929688,135.25999450683594,37496300.0,3.4799957275390625,0.0,3.4799957275390625,50.94553238552883,132.10000610351562,146.57000732421875,35.79814954244727,-64.20185045755274,3.344912914606681,4.954059543884486,-0.043678189753853625,3191810300.0,1.0
AMZN,2022-08-26,130.75,137.8300018310547,130.5,136.5500030517578,53322700.0,-6.529998779296875,6.529998779296875,0.0,35.70438959013529,130.5,146.57000732421875,1.5556931304146362,-98.44430686958536,2.5796044705928693,4.479168529226163,-0.08681375409710979,3138487600.0,-1.0
AMZN,2022-08-29,129.7899932861328,131.9499969482422,128.77000427246094,129.89999389648438,48101600.0,-0.9600067138671875,0.9600067138671875,0.0,33.97996793249975,128.77000427246094,146.57000732421875,5.730274375268421,-94.26972562473158,1.8740249037141155,3.9581398041237534,-0.10353643886967345,3090386000.0,-1.0
AMZN,2022-08-30,128.72999572753906,132.07000732421875,126.8499984741211,131.25,49203000.0,-1.05999755859375,1.05999755859375,0.0,32.01031244378552,126.8499984741211,146.57000732421875,9.533450353439669,-90.46654964656034,1.2153057807877872,3.40957299945656,-0.09408873892825109,3041183000.0,-1.0
AMZN,2022-08-31,126.7699966430664,130.58999633789062,126.73999786376952,129.4499969482422,53648700.0,-1.9599990844726562,1.9599990844726562,0.0,28.48727597309896,126.73999786376952,146.57000732421875,0.15127970239611582,-99.84872029760389,0.5290124580153304,2.833460891168314,-0.10913567164888105,2987534300.0,-1.0
AMZN,2022-09-01,127.81999969482422,128.02000427246094,123.66000366210938,126.0,56636100.0,1.0500030517578125,0.0,1.0500030517578125,33.04249327165377,123.66000366210938,146.57000732421875,18.15798938345444,-81.84201061654555,0.06905055446756592,2.2805788238281646,-0.07530924079049872,3044170400.0,1.0
AMZN,2022-09-02,127.51000213623048,131.3800048828125,126.38999938964844,129.5,57429800.0,-0.3099975585937358,0.3099975585937358,0.0,32.34072908163836,123.66000366210938,146.57000732421875,16.804879348354632,-83.19512065164537,-0.31683450916241895,1.7610961572300479,-0.04286142495234624,2986740600.0,-1.0
AMZN,2022-09-06,126.11000061035156,128.6199951171875,124.73999786376952,127.91999816894533,43888600.0,-1.4000015258789205,1.4000015258789205,0.0,29.118171844371872,123.66000366210938,143.3800048828125,12.423918846769888,-87.5760811532301,-0.7272364954479258,1.2634296266944531,-0.056204121997231904,2942852000.0,-1.0
AMZN,2022-09-07,129.47999572753906,129.82000732421875,125.4000015258789,126.12000274658205,47900300.0,3.3699951171875,0.0,3.3699951171875,44.482938632827434,123.66000366210938,142.77000427246094,30.455216533468327,-69.54478346653167,-0.7716573984834554,0.8564122216588714,-0.032287049519331035,2990752300.0,1.0
AMZN,2022-09-08,129.82000732421875,130.27999877929688,127.0999984741211,127.72000122070312,43988500.0,0.3400115966796875,0.0,0.3400115966796875,45.849428672559426,123.66000366210938,141.11000061035156,35.30088675877906,-64.69911324122096,-0.7705428515712072,0.5310212070128556,-0.054341430080221964,3034740800.0,1.0
AMZN,2022-09-09,133.27000427246094,133.69000244140625,130.75999450683594,130.91000366210938,49387600.0,3.4499969482421875,0.0,3.4499969482421875,57.963268550409,123.66000366210938,137.8300018310547,67.8193496976778,-32.1806503023222,-0.4856750841696851,0.3276819487763474,0.01927345523870705,3084128400.0,1.0
AMZN,2022-09-12,136.4499969482422,136.49000549316406,134.0,134.10000610351562,53826900.0,3.17999267578125,0.0,3.17999267578125,66.04249640640612,123.66000366210938,137.8300018310547,90.26107931448509,-9.738920685514916,-0.003278698716769668,0.26148981927772397,0.05131369139858766,3137955300.0,1.0
AMZN,2022-09-13,126.81999969482422,131.39999389648438,126.2699966430664,131.00999450683594,72694000.0,-9.629997253417969,9.629997253417969,0.0,39.50935007247647,123.66000366210938,137.8300018310547,22.300610028590043,-77.69938997140996,-0.39350035769479064,0.130491783883221,-0.01483722594660386,3065261300.0,-1.0
AMZN,2022-09-14,128.5500030517578,128.83999633789062,126.33000183105467,127.36000061035156,45316800.0,1.7300033569335938,0.0,1.7300033569335938,44.15966114811224,123.66000366210938,137.8300018310547,34.50952732206602,-65.49047267793398,-0.5567392773359359,-0.006954428360610423,0.014041227860115857,3110578100.0,1.0
AMZN,2022-09-15,126.27999877929688,130.3699951171875,125.5,127.37999725341795,52887200.0,-2.2700042724609375,2.2700042724609375,0.0,39.55571125699443,123.66000366210938,137.8300018310547,18.489735044069587,-81.51026495593041,-0.8593713725521184,-0.17743781719891208,-0.012048199962479744,3057690900.0,-1.0
AMZN,2022-09-16,123.52999877929688,123.87000274658205,120.6999969482422,122.77999877929688,115667800.0,-2.75,2.75,0.0,34.52436222077223,120.6999969482422,136.49000549316406,17.922737806021104,-82.0772621939789,-1.306056103874738,-0.4031614745340774,-0.031213263981294648,2942023100.0,-1.0
AMZN,2022-09-19,124.66000366210938,124.70999908447266,121.8000030517578,122.16000366210938,47279700.0,1.1300048828125,0.0,1.1300048828125,38.24843977308116,120.6999969482422,136.49000549316406,25.07919297574243,-74.92080702425756,-1.55099610381626,-0.632728400390514,-0.011497874405078434,2989302800.0,1.0
AMZN,2022-09-20,122.19000244140624,124.4000015258789,121.13999938964844,123.3499984741211,47698400.0,-2.470001220703139,2.470001220703139,0.0,33.450001861011486,120.6999969482422,136.49000549316406,9.43638180387956,-90.56361819612044,-1.9222626273157744,-0.8906352457755662,-0.056302081608598065,2941604400.0,-1.0
AMZN,2022-09-21,118.54000091552734,123.76000213623048,118.4499969482422,122.48999786376952,58498900.0,-3.650001525878892,3.650001525878892,0.0,27.555599205761908,118.4499969482422,136.49000549316406,0.4989131078348493,-99.50108689216515,-2.4824030437765288,-1.2089888053757587,-0.08688958382601364,2883105500.0,-1.0
AMZN,2022-09-22,117.30999755859376,118.79000091552734,116.26000213623048,117.08000183105467,55229200.0,-1.2300033569335795,1.2300033569335795,0.0,25.788614383000976,116.26000213623048,136.49000549316406,5.1902879294550806,-94.80971207054492,-2.991089927952416,-1.5654090298910903,-0.11975693105883067,2827876300.0,-1.0
AMZN,2022-09-23,113.77999877929688,116.0500030517578,112.05999755859376,116.0,65126700.0,-3.529998779296889,3.529998779296889,0.0,21.271704582684862,112.05999755859376,136.49000549316406,7.040526656027728,-92.95947334397228,-3.637142632387949,-1.9797557503904624,-0.16614143404887305,2762749600.0,-1.0
AMZN,2022-09-26,115.1500015258789,117.33999633789062,113.12999725341795,113.3000030517578,62723300.0,1.3700027465820312,0.0,1.3700027465820312,26.99762354471264,112.05999755859376,136.49000549316406,12.648395266841295,-87.35160473315871,-3.99257239388632,-2.3823190790896343,-0.09202017187373945,2825472900.0,1.0
AMZN,2022-09-27,114.41000366210938,118.31999969482422,113.0500030517578,117.1999969482422,60094700.0,-0.7399978637695312,0.7399978637695312,0.0,25.826927819566336,112.05999755859376,136.49000549316406,9.61934236701649,-90.38065763298351,-4.284574772866534,-2.7627702178450146,-0.10999610310359376,2765378200.0,-1.0
AMZN,2022-09-28,118.01000213623048,118.6999969482422,113.8000030517578,114.37999725341795,55763800.0,3.599998474121108,0.0,3.599998474121108,40.347047512776626,112.05999755859376,136.49000549316406,24.355311687054407,-75.64468831294559,-4.177345137119232,-3.0456852016998583,-0.065489362709926,2821142000.0,1.0
AMZN,2022-09-29,114.8000030517578,116.06999969482422,113.05999755859376,115.5999984741211,58969700.0,-3.2099990844726847,3.2099990844726847,0.0,33.5831650601414,112.05999755859376,136.49000549316406,11.215737221627014,-88.78426277837298,-4.301796544487473,-3.296907470257382,-0.07067105815435493,2762172300.0,-1.0
AMZN,2022-09-30,113.0,116.91999816894533,112.83999633789062,114.08000183105467,59479600.0,-1.8000030517577983,1.8000030517577983,0.0,30.296926380751145,112.05999755859376,131.39999389648438,4.860406511890584,-95.13959348810943,-4.493867872970469,-3.5362995507999995,-0.09353444023404478,2702692700.0,-1.0
AMZN,2022-10-03,115.87999725341795,116.91000366210938,112.4499969482422,113.58000183105467,50941900.0,2.8799972534179545,0.0,2.8799972534179545,40.96224953728993,112.05999755859376,130.3699951171875,20.862917554193153,-79.13708244580685,-4.363395567401355,-3.7017187541202707,-0.051640928569537614,2753634600.0,1.0
AMZN,2022-10-04,121.08999633789062,123.0,119.79000091552734,119.88999938964844,62812600.0,5.2099990844726705,0.0,5.2099990844726705,55.253610005825166,112.05999755859376,130.3699951171875,49.31731285271888,-50.68268714728112,-3.795835907383264,-3.72054218477287,0.021511687216709596,2816447200.0,1.0
AMZN,2022-10-05,120.9499969482422,121.75,117.69000244140624,118.58000183105467,48217500.0,-0.1399993896484233,0.1399993896484233,0.0,54.84199291127474,112.05999755859376,124.70999908447266,70.27666654001278,-29.723333459987217,-3.3190773113025074,-3.640249210078798,0.03102889323504021,2768229700.0,-1.0
AMZN,2022-10-06,120.3000030517578,121.52999877929688,119.5,120.7699966430664,42253800.0,-0.6499938964844034,0.6499938964844034,0.0,52.73733289693849,112.05999755859376,124.70999908447266,65.13837548799457,-34.86162451200544,-2.959575618807179,-3.5041144918244744,0.05730360645466348,2725975900.0,-1.0
AMZN,2022-10-07,114.55999755859376,118.16999816894533,113.87999725341795,118.0,54678000.0,-5.740005493164034,5.740005493164034,0.0,37.91219878354544,112.05999755859376,124.4000015258789,20.259312773543712,-79.74068722645629,-3.10207956723211,-3.423707506906002,-0.00512378601360719,2671297900.0,-1.0
AMZN,2022-10-10,113.66999816894533,116.25,112.43000030517578,115.0999984741211,42339700.0,-0.8899993896484375,0.8899993896484375,0.0,36.09679029220325,112.05999755859376,123.76000213623048,13.760683593482542,-86.23931640651745,-3.2493737280813377,-3.388840751141069,-0.00646801389281948,2628958200.0,-1.0
AMZN,2022-10-11,112.20999908447266,115.4800033569336,110.38999938964844,112.70999908447266,56432200.0,-1.4599990844726705,1.4599990844726705,0.0,33.09697526444158,110.38999938964844,123.0,14.432986572024264,-85.56701342797574,-3.444212399552697,-3.3999150808233947,-0.04914840222663763,2572526000.0,-1.0
AMZN,2022-10-12,112.9000015258789,113.83000183105467,111.4000015258789,112.48999786376952,45728700.0,0.69000244140625,0.0,0.69000244140625,35.99745020037227,110.38999938964844,123.0,19.90485340793723,-80.09514659206278,-3.502570566780747,-3.420446178014865,-0.0165505354997445,2618254700.0,1.0
AMZN,2022-10-13,112.52999877929688,113.44000244140624,105.3499984741211,107.87999725341795,86868100.0,-0.37000274658203125,0.37000274658203125,0.0,35.05707478577982,105.3499984741211,123.0,40.6798848977337,-59.3201151022663,-3.5378933320938017,-3.4439356088306523,-0.004159302838080747,2531386600.0,-1.0
AMZN,2022-10-14,106.9000015258789,114.95999908447266,106.5999984741211,114.0999984741211,67737300.0,-5.629997253417969,5.629997253417969,0.0,24.033930892577956,105.3499984741211,123.0,8.781886219585628,-91.21811378041438,-3.974366580607807,-3.550021803186084,-0.07749392423526469,2463649300.0,-1.0
AMZN,2022-10-17,113.79000091552734,114.19000244140624,110.08999633789062,110.11000061035156,62782000.0,6.8899993896484375,0.0,6.8899993896484375,47.39213264355444,105.3499984741211,123.0,47.8187065821569,-52.1812934178431,-3.721411293168387,-3.5842997011825446,-0.060285701900537725,2526431300.0,1.0
AMZN,2022-10-18,116.36000061035156,119.5199966430664,114.79000091552734,119.05999755859376,65607400.0,2.5699996948242188,0.0,2.5699996948242188,53.54045335982057,105.3499984741211,123.0,62.37961010987624,-37.62038989012376,-3.275803484981523,-3.5226004579423402,-0.037949536615985435,2592038700.0,1.0
AMZN,2022-10-19,115.06999969482422,116.58999633789062,113.22000122070312,114.70999908447266,47198100.0,-1.2900009155273438,1.2900009155273438,0.0,50.14616748031806,105.3499984741211,123.0,55.07082368492375,-44.92917631507625,-2.9922555204329626,-3.416531470440465,-0.04347467351836576,2544840600.0,-1.0
AMZN,2022-10-20,115.25,118.23999786376952,113.51000213623048,113.83000183105467,48795100.0,0.18000030517578125,0.0,0.18000030517578125,50.64988341051899,105.3499984741211,123.0,56.09065535412707,-43.90934464587293,-2.721643780041205,-3.277553932360613,0.006023066132253785,2593635700.0,1.0
AMZN,2022-10-21,119.31999969482422,119.58999633789062,114.5,114.79000091552734,55660500.0,4.069999694824219,0.0,4.069999694824219,60.94502908396848,105.3499984741211,123.0,79.1501417165315,-20.84985828346851,-2.1539378108589347,-3.0528307080602777,0.04970530145941776,2649296200.0,1.0
AMZN,2022-10-24,119.81999969482422,120.38999938964844,116.56999969482422,119.9800033569336,49531500.0,0.5,0.0,0.5,62.06675773386064,105.3499984741211,121.75,88.23170655118369,-11.768293448816305,-1.6447215921450749,-2.7712088848772374,0.06781927343767902,2698827700.0,1.0
AMZN,2022-10-25,120.5999984741211,121.31999969482422,118.9499969482422,119.6500015258789,50934600.0,0.779998779296875,0.0,0.779998779296875,63.93146973059565,105.3499984741211,121.52999877929688,94.2521613866825,-5.74783861331749,-1.1647976253781138,-2.4499266329774128,0.06820192067470598,2749762300.0,1.0
AMZN,2022-10-26,115.66000366210938,119.3499984741211,114.76000213623048,116.0,68802300.0,-4.939994812011719,4.939994812011719,0.0,47.035072975926674,105.3499984741211,121.31999969482422,64.55857482729957,-35.44142517270043,-1.1695884327111656,-2.1938589929241634,0.027814848633841427,2680960000.0,-1.0
AMZN,2022-10-27,110.95999908447266,114.12000274658205,109.7699966430664,113.91999816894533,129605400.0,-4.700004577636719,4.700004577636719,0.0,36.45750076751163,105.3499984741211,121.31999969482422,35.12836682240758,-64.87163317759241,-1.5349424112284709,-2.062075676585025,0.037979396638370355,2551354600.0,-1.0
AMZN,2022-10-28,103.41000366210938,103.95999908447266,97.66000366210938,97.91000366210938,223133400.0,-7.549995422363281,7.549995422363281,0.0,25.731713169692057,97.66000366210938,121.31999969482422,24.302624531506407,-75.6973754684936,-2.4059750216943456,-2.1308555456068894,-0.09122064478339897,2328221200.0,-1.0
AMZN,2022-10-31,102.44000244140624,104.87000274658205,100.73999786376952,103.55999755859376,99251400.0,-0.9700012207031392,0.9700012207031392,0.0,24.656375087596174,97.66000366210938,121.31999969482422,20.202872277271403,-79.7971277227286,-3.1383684746032543,-2.3323581314061625,-0.11962872203445984,2228969800.0,-1.0
AMZN,2022-11-01,96.79000091552734,104.58000183105467,96.05999755859376,103.98999786376952,153370000.0,-5.650001525878892,5.650001525878892,0.0,19.24975627954609,96.05999755859376,121.31999969482422,2.8899576215258302,-97.11004237847418,-4.1271284984669165,-2.691312204818314,-0.1588598142676375,2075599800.0,-1.0
AMZN,2022-11-02,92.12000274658205,97.73999786376952,92.01000213623048,97.31999969482422,135761800.0,-4.669998168945298,4.669998168945298,0.0,15.920360198207192,92.01000213623048,121.31999969482422,0.3753006465853838,-99.62469935341461,-5.227300695900254,-3.198509903034702,-0.20069411933551373,1939838000.0,-1.0
AMZN,2022-11-03,89.30000305175781,93.5,89.0199966430664,92.47000122070312,136683300.0,-2.819999694824233,2.819999694824233,0.0,14.208146690764565,89.0199966430664,121.31999969482422,0.8668928242598661,-99.13310717574014,-6.254645832554516,-3.809737088938665,-0.25159232919750496,1803154700.0,-1.0
AMZN,2022-11-04,90.9800033569336,92.44000244140624,88.04000091552734,91.48999786376952,129101300.0,1.6800003051757812,0.0,1.6800003051757812,20.114015901245992,88.04000091552734,121.31999969482422,8.834142275375303,-91.1658577246247,-6.854250734847355,-4.418639818120403,-0.24069434494529052,1932256000.0,1.0
AMZN,2022-11-07,90.52999877929688,92.0999984741211,89.04000091552734,91.9499969482422,77495700.0,-0.45000457763671875,0.45000457763671875,0.0,19.69498230139922,88.04000091552734,121.31999969482422,7.481965009321249,-92.51803499067876,-7.281813337026733,-4.991274521901669,-0.2493366507071456,1854760300.0,-1.0
AMZN,2022-11-08,89.9800033569336,91.72000122070312,88.2300033569336,90.79000091552734,88703400.0,-0.5499954223632812,0.5499954223632812,0.0,19.132873596310915,88.04000091552734,121.31999969482422,5.829334472851917,-94.17066552714807,-7.577688932688844,-5.508557404059105,-0.2220300837980056,1766056900.0,-1.0
AMZN,2022-11-09,86.13999938964844,89.4800033569336,85.87000274658203,89.47000122070312,90796200.0,-3.8400039672851562,3.8400039672851562,0.0,15.556136852460668,85.87000274658203,121.31999969482422,0.7616267032705463,-99.23837329672945,-8.029469970182603,-6.012739917283805,-0.2236842096216044,1675260700.0,-1.0
AMZN,2022-11-10,96.62999725341795,98.69000244140624,91.6500015258789,92.94000244140624,173414900.0,10.489997863769517,0.0,10.489997863769517,46.86553500618088,85.87000274658203,121.31999969482422,30.352596426300867,-69.64740357369914,-7.455116594810818,-6.301215252789208,-0.06556431842749944,1848675600.0,1.0
AMZN,2022-11-11,100.79000091552734,101.19000244140624,96.66000366210938,97.87999725341795,111590500.0,4.160003662109389,0.0,4.160003662109389,54.5726258801909,85.87000274658203,121.31999969482422,42.0874455665789,-57.91255443342109,-6.588313896390474,-6.3586349815094625,-0.016107003968714895,1960266100.0,1.0
AMZN,2022-11-14,98.48999786376952,100.12000274658205,97.29000091552734,98.7699966430664,99533100.0,-2.3000030517578267,2.3000030517578267,0.0,49.95055022062047,85.87000274658203,119.3499984741211,37.694135984631785,-62.305864015368215,-6.017590499803745,-6.29042608516832,0.017563766217192578,1860733000.0,-1.0
AMZN,2022-11-15,98.94000244140624,103.79000091552734,97.33999633789062,103.20999908447266,111336300.0,0.45000457763671875,0.0,0.45000457763671875,50.88956495378117,85.87000274658203,114.12000274658205,46.265485645395394,-53.73451435460461,-5.465968208537674,-6.125534509842192,0.07403386334654916,1972069300.0,1.0
AMZN,2022-11-16,97.12000274658205,98.48999786376952,95.54000091552734,96.8499984741211,87958800.0,-1.8199996948241903,1.8199996948241903,0.0,46.79268398651003,85.87000274658203,104.87000274658205,59.2105263157895,-40.7894736842105,-5.116680426551227,-5.923763693183999,0.08756998239173419,1884110500.0,-1.0
AMZN,2022-11-17,94.8499984741211,96.97000122070312,94.02999877929688,95.37000274658205,82617900.0,-2.2700042724609517,2.2700042724609517,0.0,41.93424551089233,85.87000274658203,104.87000274658205,47.26313540810029,-52.7368645918997,-4.965795121355853,-5.73216997881837,0.04253676604082646,1801492600.0,-1.0
AMZN,2022-11-18,94.13999938964844,95.98999786376952,92.4800033569336,95.9499969482422,72428200.0,-0.7099990844726562,0.7099990844726562,0.0,40.41967132888688,85.87000274658203,104.58000183105467,44.20094627331995,-55.79905372668006,-4.847627984464353,-5.555261579947567,0.03987629138438842,1729064400.0,-1.0
AMZN,2022-11-21,92.45999908447266,95.0199966430664,90.58999633789062,93.97000122070312,84330300.0,-1.6800003051757812,1.6800003051757812,0.0,36.791645223931425,85.87000274658203,103.79000091552734,36.77453689315015,-63.22546310684986,-4.833820388914219,-5.410973341740898,0.027561631862819347,1644734100.0,-1.0
AMZN,2022-11-22,93.1999969482422,93.3499984741211,90.87000274658205,92.62000274658205,62192000.0,0.7399978637695455,0.0,0.7399978637695455,39.54934903706688,85.87000274658203,103.79000091552734,40.90398967988053,-59.096010320119476,-4.708885031314537,-5.270555679655627,0.0819595728885294,1706926100.0,1.0
AMZN,2022-11-23,94.12999725341795,94.58000183105467,92.83000183105467,93.23999786376952,59414700.0,0.9300003051757528,0.0,0.9300003051757528,43.14628349738772,85.87000274658203,103.79000091552734,46.09372405601127,-53.90627594398873,-4.483150638123391,-5.11307467134918,-0.025871883173540833,1766340800.0,1.0
AMZN,2022-11-25,93.41000366210938,94.43000030517578,93.06999969482422,93.79000091552734,35088600.0,-0.7199935913085795,0.7199935913085795,0.0,40.968688783592,85.87000274658203,103.79000091552734,42.07590226540248,-57.924097734597524,-4.312638557999676,-4.95298744867928,-0.07322152184127062,1731252200.0,-1.0
AMZN,2022-11-28,93.9499969482422,96.4000015258789,93.43000030517578,93.93000030517578,74943100.0,0.5399932861328267,0.0,0.5399932861328267,43.439036547965344,85.87000274658203,103.79000091552734,45.08925796467155,-54.910742035328454,-4.086823206781062,-4.779754600299636,-0.04609606065589522,1806195300.0,1.0
AMZN,2022-11-29,92.41999816894533,94.41000366210938,91.44000244140624,94.04000091552734,65567300.0,-1.529998779296875,1.529998779296875,0.0,38.21125323441183,85.87000274658203,103.79000091552734,36.55131747565797,-63.44868252434204,-3.9853800483994775,-4.6208796899196045,-0.06589856591445054,1740628000.0,-1.0
AMZN,2022-11-30,96.54000091552734,96.54000091552734,91.52999877929688,92.47000122070312,102805800.0,4.120002746582017,0.0,4.120002746582017,55.02777282920984,90.58999633789062,103.79000091552734,45.07577662296528,-54.92422337703472,-3.5318231661976824,-4.40306838517522,-0.005972012094852541,1843433800.0,1.0
AMZN,2022-12-01,95.5,97.2300033569336,94.91999816894533,96.98999786376952,68488000.0,-1.0400009155273438,1.0400009155273438,0.0,50.986087130791134,90.58999633789062,103.79000091552734,37.1969845406557,-62.8030154593443,-3.219186671509604,-4.166292042442096,0.006852941869643248,1774945800.0,-1.0
AMZN,2022-12-02,94.12999725341795,95.36000061035156,93.77999877929688,94.4800033569336,72496400.0,-1.3700027465820455,1.3700027465820455,0.0,45.865684583687234,90.58999633789062,103.79000091552734,26.81817945370075,-73.18182054629925,-3.046845629284647,-3.9424027598106064,-0.00010624746436516119,1702449400.0,-1.0
AMZN,2022-12-05,91.01000213623048,94.05999755859376,90.81999969482422,93.0500030517578,71535500.0,-3.1199951171874716,3.1199951171874716,0.0,36.28912873464059,90.58999633789062,103.79000091552734,3.1818610051956084,-96.81813899480439,-3.125987208065979,-3.779119649461681,-0.015682424427859165,1630913900.0,-1.0
AMZN,2022-12-06,88.25,91.04000091552734,87.9000015258789,90.5,75503600.0,-2.760002136230483,2.760002136230483,0.0,29.913874074614895,87.9000015258789,98.48999786376952,3.3049914556515216,-96.69500854434848,-3.372540043242779,-3.697803728217901,-0.05311155697774472,1555410300.0,-1.0
AMZN,2022-12-07,88.45999908447266,89.88999938964844,87.4800033569336,88.33999633789062,68086900.0,0.20999908447265625,0.0,0.20999908447265625,30.978413676843587,87.4800033569336,97.2300033569336,10.051238231169872,-89.94876176883014,-3.5105226504661715,-3.6603475126675553,-0.06023582635066327,1623497200.0,1.0
AMZN,2022-12-08,90.3499984741211,90.86000061035156,87.87999725341797,89.23999786376953,73305900.0,1.8899993896484375,0.0,1.8899993896484375,40.3821089266722,87.4800033569336,97.2300033569336,29.43584735576923,-70.56415264423077,-3.4278535435556847,-3.6138487188451816,-0.032758859522767914,1696803100.0,1.0
AMZN,2022-12-09,89.08999633789062,90.3000030517578,88.62999725341797,88.9000015258789,67398500.0,-1.2600021362304688,1.2600021362304688,0.0,36.55143196369824,87.4800033569336,97.2300033569336,16.512748522636215,-83.48725147736377,-3.424533433127877,-3.5759856617017203,-0.051729651604235705,1629404600.0,-1.0
AMZN,2022-12-12,90.5500030517578,90.58000183105467,87.87000274658203,89.20999908447266,61999800.0,1.4600067138671733,0.0,1.4600067138671733,43.69280771191927,87.4800033569336,97.2300033569336,31.487176357171325,-68.51282364282866,-3.2664384129329136,-3.514076211947959,-0.020233663213984787,1691404400.0,1.0
AMZN,2022-12-13,92.48999786376952,96.25,90.5199966430664,95.2300033569336,100212000.0,1.9399948120117188,0.0,1.9399948120117188,51.97948612087416,87.4800033569336,97.2300033569336,51.38455904447101,-48.615440955528996,-2.950593002842652,-3.401379570126897,-0.04195155389838445,1791616400.0,1.0
AMZN,2022-12-14,91.58000183105467,93.45999908447266,89.87000274658203,92.5,70298000.0,-0.9099960327148438,0.9099960327148438,0.0,48.14461176947811,87.4800033569336,97.2300033569336,42.05126640124185,-57.94873359875816,-2.74210305734357,-3.2695242675702314,-0.04104710124550082,1721318400.0,-1.0
AMZN,2022-12-15,88.44999694824219,89.97000122070312,87.47000122070312,89.88999938964844,84802900.0,-3.130004882812486,3.130004882812486,0.0,37.24054294010115,87.47000122070312,97.2300033569336,10.040937633621859,-89.95906236637813,-2.7971941954550488,-3.175058253147195,-0.060342085104751475,1636515500.0,-1.0
AMZN,2022-12-16,87.86000061035156,89.3499984741211,86.7300033569336,88.2699966430664,146144100.0,-0.589996337890625,0.589996337890625,0.0,35.49220230633031,86.7300033569336,97.2300033569336,10.761878603980653,-89.23812139601934,-2.855545146052691,-3.1111556317282947,-0.03461159709856687,1490371400.0,-1.0
AMZN,2022-12-19,84.91999816894531,87.62999725341797,84.51000213623047,87.51000213623047,83531500.0,-2.94000244140625,2.94000244140625,0.0,27.948085661046633,84.51000213623047,97.2300033569336,3.2232389415775575,-96.77676105842245,-3.1032499870484713,-3.1095745027923303,-0.037733731796653736,1406839900.0,-1.0
AMZN,2022-12-20,85.19000244140625,86.61000061035156,84.33000183105469,85.33000183105469,74348300.0,0.2700042724609375,0.0,0.2700042724609375,29.53523683625029,84.33000183105469,97.2300033569336,6.666670609505751,-93.33332939049424,-3.2404172568397343,-3.1357430536018116,-0.03696582270980808,1481188200.0,1.0
AMZN,2022-12-21,86.7699966430664,87.2300033569336,85.20999908447266,86.18000030517578,59267200.0,1.5799942016601562,0.0,1.5799942016601562,38.6586778234706,84.33000183105469,96.25,20.469758278726403,-79.5302417212736,-3.184917235525674,-3.1455778899865847,-0.03962370660227632,1540455400.0,1.0
AMZN,2022-12-22,83.79000091552734,85.68000030517578,82.25,85.5199966430664,81431300.0,-2.9799957275390625,2.9799957275390625,0.0,30.16038629222099,82.25,96.25,11.000006539481026,-88.99999346051898,-3.342859416630006,-3.185034195315269,-0.05949035402652891,1459024100.0,-1.0
AMZN,2022-12-23,85.25,85.77999877929688,82.93000030517578,83.25,57433700.0,1.4599990844726562,0.0,1.4599990844726562,37.88008468105222,82.25,96.25,21.428571428571427,-78.57142857142857,-3.312040863273694,-3.210435528906954,-0.05853122996283444,1516457800.0,1.0
AMZN,2022-12-27,83.04000091552734,85.3499984741211,83.0,84.97000122070312,57284000.0,-2.2099990844726562,2.2099990844726562,0.0,31.750435635491854,82.25,96.25,5.642863682338169,-94.35713631766183,-3.426447440878121,-3.253637911301188,-0.10217317727870723,1459173800.0,-1.0
AMZN,2022-12-28,81.81999969482422,83.4800033569336,81.69000244140625,82.80000305175781,58228600.0,-1.220001220703125,1.220001220703125,0.0,28.78364724932578,81.69000244140625,96.25,0.8928384286798211,-99.10716157132018,-3.5743564245174184,-3.3177816139444345,-0.1065735088566121,1400945200.0,-1.0
AMZN,2022-12-29,84.18000030517578,84.55000305175781,82.55000305175781,82.87000274658203,54995900.0,2.3600006103515625,0.0,2.3600006103515625,41.07351418083186,81.69000244140625,96.25,17.101636547321117,-82.89836345267888,-3.461243967858991,-3.3464740847273458,-0.04827582578171319,1455941100.0,1.0
AMZN,2022-12-30,84.0,84.05000305175781,82.47000122070312,83.12000274658203,62401200.0,-0.18000030517578125,0.18000030517578125,0.0,40.4590561392202,81.69000244140625,96.25,15.865370507774019,-84.13462949222598,-3.347537720259041,-3.3466868118336843,-0.0439335372585552,1393539900.0,-1.0
AMZN,2023-01-03,85.81999969482422,86.95999908447266,84.20999908447266,85.45999908447266,76706000.0,1.8199996948242188,0.0,1.8199996948242188,49.30668753864344,81.69000244140625,96.25,28.365370507774017,-71.63462949222598,-3.0751178899852647,-3.2923730274640004,0.010598228277023614,1470245900.0,1.0
AMZN,2023-01-04,85.13999938964844,86.9800033569336,83.36000061035156,86.55000305175781,68885100.0,-0.6800003051757812,0.6800003051757812,0.0,46.33819399369577,81.69000244140625,93.45999908447266,29.311792117413628,-70.68820788258637,-2.8808845100983405,-3.210075323990869,-0.0005869591539476859,1401360800.0,-1.0
AMZN,2023-01-05,83.12000274658203,85.41999816894531,83.06999969482422,85.33000183105469,67930800.0,-2.0199966430664062,2.0199966430664062,0.0,38.41166789692522,81.69000244140625,89.97000122070312,17.270537632823356,-82.72946236717664,-2.8570161012566473,-3.139463479444025,-0.04206516120426795,1333430000.0,-1.0
AMZN,2023-01-06,86.08000183105469,86.4000015258789,81.43000030517578,83.02999877929688,83303400.0,2.9599990844726562,0.0,2.9599990844726562,52.228327854533504,81.43000030517578,89.3499984741211,58.71215405215347,-41.28784594784653,-2.56963190979873,-3.0254971655149663,0.02733024096557779,1416733400.0,1.0
AMZN,2023-01-09,87.36000061035156,89.4800033569336,87.08000183105469,87.45999908447266,65266100.0,1.279998779296875,0.0,1.279998779296875,57.037397763718495,81.43000030517578,89.4800033569336,73.66457213803038,-26.335427861969613,-2.213081635979833,-2.86301405960794,0.024750740297379004,1481999500.0,1.0
AMZN,2023-01-10,89.87000274658203,90.19000244140624,87.29000091552734,87.56999969482422,67756600.0,2.5100021362304688,0.0,2.5100021362304688,65.00771178590885,81.43000030517578,90.19000244140624,96.34703633803102,-3.6529636619689763,-1.7082847366676646,-2.6320681950198854,0.08224953944789237,1549756100.0,1.0
AMZN,2023-01-11,95.08999633789062,95.26000213623048,90.93000030517578,90.93000030517578,103126200.0,5.219993591308594,0.0,5.219993591308594,75.78677943383428,81.43000030517578,95.26000213623048,98.77074637865833,-1.2292536213416612,-0.8769112129806018,-2.281036798612029,0.16218524434809845,1652882300.0,1.0
AMZN,2023-01-12,95.2699966430664,97.19000244140624,93.5,96.93000030517578,85254800.0,0.18000030517578125,0.0,0.18000030517578125,76.07995116735972,81.43000030517578,97.19000244140624,87.81722374309865,-12.18277625690135,-0.2011979012689551,-1.865069019143414,0.1317414623151143,1738137100.0,1.0
AMZN,2023-01-13,98.12000274658205,98.37000274658205,94.12000274658205,94.18000030517578,85549400.0,2.850006103515639,0.0,2.850006103515639,80.41270860550314,81.43000030517578,98.37000274658205,98.52420328235061,-1.475796717649389,0.5578508828456137,-1.3804850387456085,0.1680952707926433,1823686500.0,1.0
AMZN,2023-01-17,96.0500030517578,98.88999938964844,95.7300033569336,98.68000030517578,72755000.0,-2.069999694824247,2.069999694824247,0.0,69.81475675891937,81.43000030517578,98.88999938964844,83.7342698350066,-16.265730164993393,0.9810617678742375,-0.9081756774216393,0.11920302252751647,1750931500.0,-1.0
AMZN,2023-01-18,95.45999908447266,99.31999969482422,95.37999725341795,97.25,79570400.0,-0.590003967285142,0.590003967285142,0.0,66.9144129645263,81.43000030517578,99.31999969482422,78.42369624347194,-21.57630375652806,1.2543912129665102,-0.4756622993440093,0.12121211849666702,1671361100.0,-1.0
AMZN,2023-01-19,93.68000030517578,95.44000244140624,92.86000061035156,94.73999786376952,69002700.0,-1.779998779296875,1.779998779296875,0.0,58.460165244659954,81.43000030517578,99.31999969482422,68.4740101617227,-31.5259898382773,1.312248952932876,-0.11808004888863212,0.1270452022335622,1602358400.0,-1.0
AMZN,2023-01-20,97.25,97.3499984741211,93.1999969482422,93.86000061035156,67481500.0,3.5699996948242188,0.0,3.5699996948242188,67.85794592369868,81.43000030517578,99.31999969482422,88.42929141729336,-11.570708582706649,1.6274109875029552,0.23101815838968545,0.12976298712061096,1669839900.0,1.0
AMZN,2023-01-23,97.5199966430664,97.77999877929688,95.86000061035156,97.55999755859376,76501100.0,0.26999664306640625,0.0,0.26999664306640625,68.48022014313435,81.43000030517578,99.31999969482422,89.93849573410643,-10.061504265893577,1.8773250090488887,0.5602795285215262,0.11630032007475699,1746341000.0,1.0
AMZN,2023-01-24,96.31999969482422,98.08999633789062,96.0,96.93000030517578,66929500.0,-1.1999969482421875,1.1999969482421875,0.0,62.29531230520386,81.43000030517578,99.31999969482422,83.230854654272,-16.76914534572801,1.9560063234025904,0.8394248874977392,0.07177029877733587,1679411500.0,-1.0
AMZN,2023-01-25,97.18000030517578,97.23999786376952,91.5199966430664,92.55999755859376,94261600.0,0.8600006103515625,0.0,0.8600006103515625,64.91559823613854,81.43000030517578,99.31999969482422,88.03801306507204,-11.961986934927959,2.063964594751596,1.0843328289485108,0.021979220189036308,1773673100.0,1.0
AMZN,2023-01-26,99.22000122070312,99.48999786376952,96.91999816894533,98.23999786376952,68523600.0,2.0400009155273438,0.0,2.0400009155273438,70.52250594066058,81.43000030517578,99.48999786376952,98.50500177427811,-1.4949982257218848,2.287761437705271,1.3250185506998629,0.04146116003798772,1842196700.0,1.0
AMZN,2023-01-27,102.23999786376952,103.48999786376952,99.52999877929688,99.52999877929688,87775600.0,3.019996643066392,0.0,3.019996643066392,76.8437386505663,87.08000183105469,103.48999786376952,92.3826916380235,-7.617308361976509,2.677940902284476,1.5956030210167857,0.04198934979474389,1929972300.0,1.0
AMZN,2023-01-30,100.5500030517578,101.73999786376952,99.01000213623048,101.08999633789062,70691900.0,-1.6899948120117188,1.6899948120117188,0.0,67.49771062608215,87.29000091552734,103.48999786376952,81.85188045772607,-18.148119542273932,2.8183048179933365,1.8401433804120961,0.04685059715797313,1859280400.0,-1.0
AMZN,2023-01-31,103.12999725341795,103.3499984741211,101.13999938964844,101.16000366210938,66527300.0,2.5799942016601562,0.0,2.5799942016601562,73.23239339824175,90.93000030517578,103.48999786376952,97.1337525451568,-2.866247454843212,3.101970616268119,2.092508827583301,0.08034777123932413,1925807700.0,1.0
AMZN,2023-02-01,105.1500015258789,106.23999786376952,101.23999786376952,102.52999877929688,80450100.0,2.0200042724609517,0.0,2.0200042724609517,76.91245191210541,91.5199966430664,106.23999786376952,92.59513418818489,-7.404865811815105,3.450005749286362,2.364008211923913,0.1224380997367418,2006257800.0,1.0
AMZN,2023-02-02,112.91000366210938,114.0,108.87999725341795,110.25,158154200.0,7.760002136230469,0.0,7.760002136230469,85.65456430611064,91.5199966430664,114.0,95.15126256618449,-4.848737433815521,4.302398052412613,2.7516861800216534,0.1610283152916132,2164412000.0,1.0
AMZN,2023-02-03,103.38999938964844,108.77999877929688,102.5199966430664,105.26000213623048,144374800.0,-9.520004272460938,9.520004272460938,0.0,55.76482507189969,91.5199966430664,114.0,52.80249543610908,-47.19750456389091,4.161766062444443,3.0337021565062114,0.060192811204320185,2020037200.0,-1.0
AMZN,2023-02-06,102.18000030517578,103.9499969482422,100.6500015258789,102.93000030517578,81945200.0,-1.2099990844726562,1.2099990844726562,0.0,53.049934834837046,91.5199966430664,114.0,47.4199380349357,-52.5800619650643,3.907632626956513,3.208488250596272,0.060838876961359256,1938092000.0,-1.0
AMZN,2023-02-07,102.11000061035156,102.41000366210938,98.08000183105467,101.16999816894533,119501300.0,-0.06999969482421875,0.06999969482421875,0.0,52.878093857284135,91.5199966430664,114.0,47.10855153862262,-52.89144846137739,3.65840978729247,3.2984725579355128,0.0507306059857382,1818590700.0,-1.0
AMZN,2023-02-08,100.0500030517578,102.66999816894533,98.77999877929688,102.04000091552734,75878300.0,-2.059997558593764,2.059997558593764,0.0,47.63827392128702,91.5199966430664,114.0,37.94486269976668,-62.05513730023332,3.257128158524907,3.2902036780533916,0.008365267293319656,1742712400.0,-1.0
AMZN,2023-02-09,98.23999786376952,101.77999877929688,97.56999969482422,101.31999969482422,64622500.0,-1.8100051879882812,1.8100051879882812,0.0,43.28934229432713,91.5199966430664,114.0,29.893239400386634,-70.10676059961337,2.7612275721749313,3.1844084568777,-0.039123631490386335,1678089900.0,-1.0
AMZN,2023-02-10,97.61000061035156,98.81999969482422,96.2300033569336,97.55999755859376,52740100.0,-0.6299972534179545,0.6299972534179545,0.0,41.758337652972955,91.5199966430664,114.0,27.09076093356896,-72.90923906643104,2.290978299722937,3.0057224254467476,-0.02923920787842127,1625349800.0,-1.0
AMZN,2023-02-13,99.54000091552734,99.68000030517578,96.91000366210938,97.8499984741211,52841500.0,1.9300003051757812,0.0,1.9300003051757812,48.23032403512599,91.5199966430664,114.0,35.67617026172417,-64.32382973827583,2.050401506052637,2.8146582415679258,-0.03481039885096704,1678191300.0,1.0
AMZN,2023-02-14,99.6999969482422,100.91999816894533,97.5199966430664,98.41000366210938,56202900.0,0.15999603271485796,0.0,0.15999603271485796,48.77481057565466,96.2300033569336,114.0,19.52726081500161,-80.47273918499839,1.8513122315012964,2.6219890395546,-0.05183076080408222,1734394200.0,1.0
AMZN,2023-02-15,101.16000366210938,101.16999816894533,98.4499969482422,99.08999633789062,47957600.0,1.4600067138671733,0.0,1.4600067138671733,53.88193379412551,96.2300033569336,114.0,27.743394690507134,-72.25660530949287,1.790700802899181,2.4557313922235164,-0.10406518128511133,1782351800.0,1.0
AMZN,2023-02-16,98.1500015258789,100.62999725341795,98.0999984741211,99.20999908447266,56339200.0,-3.0100021362304688,3.0100021362304688,0.0,43.552707746450096,96.2300033569336,114.0,10.804718805022778,-89.19528119497721,1.4826922391053614,2.2611235615998857,-0.050681863765386304,1726012600.0,-1.0
AMZN,2023-02-17,97.1999969482422,97.94000244140624,95.6500015258789,97.8000030517578,60029400.0,-0.9500045776367045,0.9500045776367045,0.0,40.71060994944322,95.6500015258789,114.0,8.446842241154656,-91.55315775884534,1.1486943696650371,2.038637723212916,-0.048737554727540155,1665983200.0,-1.0
AMZN,2023-02-21,94.58000183105467,95.61000061035156,94.2699966430664,95.33999633789062,56580400.0,-2.6199951171875284,2.6199951171875284,0.0,33.71040816870865,94.2699966430664,114.0,1.5712373808559128,-98.42876261914408,0.6649221336080728,1.763894605291947,-0.07374398917135572,1609402800.0,-1.0
AMZN,2023-02-22,95.79000091552734,97.01000213623048,94.8000030517578,95.0999984741211,59534100.0,1.2099990844726705,0.0,1.2099990844726705,39.27464349422389,94.2699966430664,114.0,7.7040243985907475,-92.29597560140925,0.3748449852181466,1.486084681277187,-0.04257873069755602,1668936900.0,1.0
AMZN,2023-02-23,95.81999969482422,96.43000030517578,93.66999816894533,96.12000274658205,48467000.0,0.029998779296875,0.0,0.029998779296875,39.420107348791575,93.66999816894533,108.77999877929688,14.228996949252076,-85.77100305074792,0.14569789140678324,1.2180073233031063,-0.024633532385669787,1717403900.0,1.0
AMZN,2023-02-24,93.5,94.13999938964844,92.31999969482422,93.52999877929688,57053800.0,-2.3199996948242188,2.3199996948242188,0.0,32.47779952168234,92.31999969482422,103.9499969482422,10.146178708932942,-89.85382129106706,-0.22056488300586352,0.9302928820413123,-0.04210634755303644,1660350100.0,-1.0
AMZN,2023-02-27,93.76000213623048,94.77999877929688,93.13999938964844,94.27999877929688,47470300.0,0.26000213623048296,0.0,0.26000213623048296,33.98125382091274,92.31999969482422,102.66999816894533,13.913069117901925,-86.08693088209807,-0.48426842607422316,0.6473806204182052,-0.05806709590249992,1707820400.0,1.0
AMZN,2023-02-28,94.2300033569336,94.69000244140624,92.91999816894533,93.13999938964844,43959300.0,0.4700012207031108,0.0,0.4700012207031108,36.91124026046342,92.31999969482422,102.66999816894533,18.454144383548492,-81.54585561645152,-0.6478620627118801,0.3883320837921881,-0.05486453118096157,1751779700.0,1.0
AMZN,2023-03-01,92.16999816894533,94.68000030517578,91.58999633789062,93.87000274658205,52299500.0,-2.060005187988267,2.060005187988267,0.0,30.14521062135327,91.58999633789062,101.77999877929688,5.6918713649950785,-94.30812863500492,-0.9329815700856159,0.12406935301662725,-0.08886916931312205,1699480200.0,-1.0
AMZN,2023-03-02,92.12999725341795,92.2300033569336,90.38999938964844,91.41000366210938,55509400.0,-0.04000091552737217,0.04000091552737217,0.0,30.021910612073,90.38999938964844,101.16999816894533,16.140983866447208,-83.85901613355279,-1.1489244871289088,-0.13052941501248005,-0.06133473437464676,1643970800.0,-1.0
AMZN,2023-03-03,94.9000015258789,94.94000244140624,92.66000366210938,92.73999786376952,55759600.0,2.7700042724609517,0.0,2.7700042724609517,47.25862988900867,90.38999938964844,101.16999816894533,41.83675924798786,-58.16324075201214,-1.0840483749052225,-0.32123320699102864,-0.02366250508822565,1699730400.0,1.0
AMZN,2023-03-06,93.75,96.5500030517578,93.73999786376952,95.19000244140624,52112400.0,-1.1500015258789062,1.1500015258789062,0.0,42.27093101598324,90.38999938964844,101.16999816894533,31.168840360209337,-68.83115963979066,-1.112603697878086,-0.4795073051684402,-0.008775658860075697,1647618000.0,-1.0
AMZN,2023-03-07,93.5500030517578,95.08999633789062,92.77999877929688,94.05999755859376,49100700.0,-0.1999969482422017,0.1999969482422017,0.0,41.394269028224095,90.38999938964844,101.16999816894533,29.313580889992156,-70.68641911000785,-1.1382510300057334,-0.6112560501358989,-0.023384464373738645,1598517300.0,-1.0
AMZN,2023-03-08,93.91999816894533,94.16999816894533,92.18000030517578,93.5999984741211,44899100.0,0.3699951171875284,0.0,0.3699951171875284,43.8787639912514,90.38999938964844,100.62999725341795,34.472651520626755,-65.52734847937325,-1.1158582919254911,-0.7121764984938174,-0.019828861740035286,1643416400.0,1.0
AMZN,2023-03-09,92.25,96.20999908447266,92.18000030517578,93.68000030517578,56218700.0,-1.6699981689453267,1.6699981689453267,0.0,35.94312690001762,90.38999938964844,97.94000244140624,24.635759715600585,-75.36424028439941,-1.2188170172551196,-0.813504602246078,-0.013368983957219305,1587197700.0,-1.0
AMZN,2023-03-10,90.7300033569336,93.56999969482422,90.25,92.66999816894533,69827500.0,-1.5199966430664062,1.5199966430664062,0.0,30.20599205620634,90.25,97.01000213623048,7.100639130881305,-92.8993608691187,-1.4068463260940973,-0.9321729470156821,-0.032316539145278544,1517370200.0,-1.0
AMZN,2023-03-13,92.43000030517578,94.0199966430664,88.12000274658203,89.97000122070312,72397100.0,1.6999969482421875,0.0,1.6999969482421875,42.12690074975981,88.12000274658203,97.01000213623048,48.48141568617347,-51.51858431382653,-1.4025180072210475,-1.0262419590567553,-0.01910222845837739,1589767300.0,1.0
AMZN,2023-03-14,94.87999725341795,95.06999969482422,92.70999908447266,93.83000183105467,60912700.0,2.4499969482421733,0.0,2.4499969482421733,54.92836950727238,88.12000274658203,96.5500030517578,80.1897302742147,-19.810269725785304,-1.187702411010946,-1.0585340494475934,0.02940218225354929,1650680000.0,1.0
AMZN,2023-03-15,96.1999969482422,96.66999816894533,93.06999969482422,93.22000122070312,70731800.0,1.3199996948242472,0.0,1.3199996948242472,60.37699175154678,88.12000274658203,96.66999816894533,94.50290675625635,-5.49709324374366,-0.9005654023018366,-1.0269403200184422,0.044176704831859315,1721411800.0,1.0
AMZN,2023-03-16,100.04000091552734,100.98999786376952,95.61000061035156,95.75,84446900.0,3.840003967285142,0.0,3.840003967285142,71.81419093354535,88.12000274658203,100.98999786376952,92.61851353017624,-7.3814864698237646,-0.3590125530476911,-0.8933547666242919,0.05416226877769614,1805858700.0,1.0
AMZN,2023-03-17,98.9499969482422,100.66000366210938,97.45999908447266,99.79000091552734,87300200.0,-1.090003967285142,1.090003967285142,0.0,65.6112863003433,88.12000274658203,100.98999786376952,84.14917102180594,-15.850828978194064,-0.01757958246908231,-0.71819972979325,0.055466634114583524,1718558500.0,-1.0
AMZN,2023-03-20,97.70999908447266,98.4800033569336,95.6999969482422,98.41000366210938,62388900.0,-1.2399978637695455,1.2399978637695455,0.0,58.929972970704675,88.12000274658203,100.98999786376952,74.51437433013068,-25.48562566986931,0.15120801027578068,-0.5443181817794439,0.04446815496535339,1656169600.0,-1.0
AMZN,2023-03-21,100.61000061035156,100.8499984741211,98.0,98.13999938964844,58597300.0,2.9000015258789062,0.0,2.9000015258789062,67.78302862452949,88.12000274658203,100.98999786376952,97.04741726816601,-2.9525827318339837,0.5130649865958503,-0.332841548104385,0.07123086213622054,1714766900.0,1.0
AMZN,2023-03-22,98.6999969482422,102.0999984741211,98.61000061035156,100.4499969482422,57475400.0,-1.9100036621093608,1.9100036621093608,0.0,58.24212898034373,88.12000274658203,102.0999984741211,75.67952385578158,-24.32047614421842,0.6383593056915089,-0.13860137734520617,0.0699186661056066,1657291500.0,-1.0
AMZN,2023-03-23,98.70999908447266,101.05999755859376,97.62000274658205,100.43000030517578,57559300.0,0.01000213623045454,0.0,0.01000213623045454,58.277613911570675,88.12000274658203,102.0999984741211,75.7510699164914,-24.248930083508604,0.730047511796883,0.03512840048321172,0.08795321759380537,1714850800.0,1.0
AMZN,2023-03-24,98.12999725341795,98.3000030517578,96.4000015258789,98.06999969482422,56095400.0,-0.5800018310547017,0.5800018310547017,0.0,55.14234117284847,88.12000274658203,102.0999984741211,71.60227157378402,-28.397728426215973,0.7472954188118877,0.17756180414894696,0.061668256295818624,1658755400.0,-1.0
AMZN,2023-03-27,98.04000091552734,99.33999633789062,97.08000183105467,99.06999969482422,46721300.0,-0.08999633789061079,0.08999633789061079,0.0,54.61627662689103,88.12000274658203,102.0999984741211,70.9585207483576,-29.041479251642393,0.745113354119411,0.29107211414303985,0.03330526721738014,1612034100.0,-1.0
AMZN,2023-03-28,97.23999786376952,98.44000244140624,96.29000091552734,98.11000061035156,38720100.0,-0.8000030517578267,0.8000030517578267,0.0,49.74831729821552,88.12000274658203,102.0999984741211,65.23603651195754,-34.76396348804247,0.6710945317372818,0.36707659766188827,0.010810820670678956,1573314000.0,-1.0
AMZN,2023-03-29,100.25,100.41999816894533,98.55999755859376,98.69000244140624,49783300.0,3.010002136230483,0.0,3.010002136230483,63.768047516121435,88.12000274658203,102.0999984741211,86.76681659868608,-13.233183401313916,0.8455689064735026,0.4627750594242112,0.0020991511650423345,1623097300.0,1.0
AMZN,2023-03-30,102.0,103.04000091552734,101.01000213623048,101.5500030517578,53633400.0,1.75,0.0,1.75,69.48009021048978,88.12000274658203,103.04000091552734,93.0294836249242,-6.970516375075809,1.1122303806232736,0.5926661236640237,0.03082368009928449,1676730700.0,1.0
AMZN,2023-03-31,103.29000091552734,103.48999786376952,101.9499969482422,102.16000366210938,56750300.0,1.2900009155273438,0.0,1.2900009155273438,73.08865851707819,92.70999908447266,103.48999786376952,98.14474052978308,-1.8552594702169194,1.4113842538525176,0.7564097497017226,0.05710778715933307,1733481000.0,1.0
AMZN,2023-04-03,102.41000366210938,103.29000091552734,101.43000030517578,102.3000030517578,41135700.0,-0.8799972534179688,0.8799972534179688,0.0,66.865734354301,93.06999969482422,103.48999786376952,89.63537052358755,-10.364629476412452,1.5594807069206666,0.9170239411455116,0.01789089594312765,1692345300.0,-1.0
AMZN,2023-04-04,103.9499969482422,104.1999969482422,102.11000061035156,102.75,48662500.0,1.5399932861328267,0.0,1.5399932861328267,71.72654608894838,95.61000061035156,104.1999969482422,97.08963787449775,-2.9103621255022567,1.7805872988801639,1.0897366126924422,0.05319149100635823,1741007800.0,1.0
AMZN,2023-04-05,101.0999984741211,103.91000366210938,100.75,103.91000366210938,45175400.0,-2.849998474121108,2.849998474121108,0.0,54.617164656327205,95.6999969482422,104.1999969482422,63.52942971622226,-36.47057028377774,1.70617706046977,1.2130247022479077,0.02421233321664973,1695832400.0,-1.0
AMZN,2023-04-06,102.05999755859376,102.37999725341795,99.8000030517578,100.75,43808000.0,0.9599990844726705,0.0,0.9599990844726705,58.46764609562328,95.6999969482422,104.1999969482422,74.82353659237133,-25.176463407628674,1.7050159509554987,1.311422951989426,0.04004891893583462,1739640400.0,1.0
AMZN,2023-04-10,102.16999816894533,102.1999969482422,99.56999969482422,100.95999908447266,37261200.0,0.1100006103515625,0.0,0.1100006103515625,58.92836662680329,96.29000091552734,104.1999969482422,74.33628574652847,-25.663714253471525,1.6934508460255842,1.3878285307966578,0.04212563458640162,1776901600.0,1.0
AMZN,2023-04-11,99.91999816894533,101.0,99.01000213623048,100.8000030517578,60417800.0,-2.25,2.25,0.0,46.70145526172128,96.29000091552734,104.1999969482422,45.891265158727265,-54.108734841272735,1.485604101752557,1.4073836449878379,0.02756067836334597,1716483800.0,-1.0
AMZN,2023-04-12,97.83000183105467,100.51000213623048,97.70999908447266,100.4000015258789,56735000.0,-2.0899963378906534,2.0899963378906534,0.0,38.205228810359685,96.29000091552734,104.1999969482422,19.46904788773671,-80.5309521122633,1.1391078950772595,1.3537284950057222,-0.024139632607933392,1659748800.0,-1.0
AMZN,2023-04-13,102.4000015258789,102.56999969482422,98.70999908447266,98.9499969482422,67925100.0,4.569999694824233,0.0,4.569999694824233,57.645851551041666,96.29000091552734,104.1999969482422,77.24404140130139,-22.75595859869861,1.2192136017412594,1.3268255163528297,0.003921583587048083,1727673900.0,1.0
AMZN,2023-04-14,102.51000213623048,103.1999969482422,101.11000061035156,102.06999969482422,51450500.0,0.11000061035157671,0.0,0.11000061035157671,58.01271384688583,96.29000091552734,104.1999969482422,78.63469456846641,-21.36530543153359,1.2768552883950548,1.316831470761275,-0.007551541992285915,1779124400.0,1.0
AMZN,2023-04-17,102.73999786376952,103.7300033569336,101.58999633789062,103.16000366210938,39919500.0,0.22999572753903408,0.0,0.22999572753903408,58.8721540582883,96.29000091552734,104.1999969482422,81.54235377066826,-18.457646229331743,1.3258123341138628,1.3186276434317927,0.003222284834096145,1819043900.0,1.0
AMZN,2023-04-18,102.3000030517578,104.1999969482422,101.5199966430664,103.9499969482422,39790500.0,-0.43999481201171875,0.43999481201171875,0.0,56.32713398114102,97.70999908447266,104.1999969482422,70.72427547178202,-29.27572452821797,1.3139607201534318,1.3176942587761207,-0.015872957623134454,1779253400.0,-1.0
AMZN,2023-04-19,104.3000030517578,105.12000274658205,101.38999938964844,101.58000183105467,58398900.0,2.0,0.0,2.0,64.39899826481775,97.70999908447266,105.12000274658205,88.93388273183633,-11.066117268163666,1.4492455158237192,1.3440045101856406,0.031651875627434656,1837652300.0,1.0
AMZN,2023-04-20,103.80999755859376,105.25,103.20999908447266,103.52999877929688,57696900.0,-0.4900054931640341,0.4900054931640341,0.0,61.201270724787406,97.70999908447266,105.25,80.90182670348491,-19.098173296515082,1.4996335014004671,1.375130308428606,0.017146776816208575,1779955400.0,-1.0
AMZN,2023-04-21,106.95999908447266,108.1500015258789,105.08000183105467,106.0999984741211,86774200.0,3.150001525878892,0.0,3.150001525878892,71.64489655309065,97.70999908447266,108.1500015258789,88.6015118474823,-11.3984881525177,1.773303600410756,1.4547649668250362,0.046882656370480946,1866729600.0,1.0
AMZN,2023-04-24,106.20999908447266,109.2300033569336,105.06999969482422,107.66000366210938,69575600.0,-0.75,0.75,0.0,66.71163869435294,97.70999908447266,109.2300033569336,73.78469485744561,-26.215305142554392,1.907679847778823,1.5453479430157937,0.06295037060441255,1797154000.0,-1.0
AMZN,2023-04-25,102.56999969482422,105.4499969482422,102.4499969482422,104.91000366210938,65026800.0,-3.6399993896484375,3.6399993896484375,0.0,48.14640638875827,97.70999908447266,109.2300033569336,42.18748965197523,-57.81251034802477,1.7008501204994673,1.5764483785125287,0.048451372534523474,1732127200.0,-1.0
AMZN,2023-04-26,104.9800033569336,106.62000274658205,104.0999984741211,105.04000091552734,73803800.0,2.410003662109375,0.0,2.410003662109375,57.23767323645546,97.70999908447266,109.2300033569336,63.10765257127719,-36.89234742872281,1.7116721349018604,1.6034931297903952,0.025195330005953753,1805931000.0,1.0
AMZN,2023-04-27,109.81999969482422,110.86000061035156,106.8000030517578,108.16000366210938,149961200.0,4.839996337890625,0.0,4.839996337890625,69.59178872858173,97.70999908447266,110.86000061035156,92.09124870836976,-7.908751291630237,2.086741259921766,1.7001427558166695,0.07131009078391326,1955892200.0,1.0
AMZN,2023-04-28,105.4499969482422,109.4800033569336,104.33000183105467,107.7300033569336,130565000.0,-4.370002746582017,4.370002746582017,0.0,53.491898222170754,97.70999908447266,110.86000061035156,58.859292514433584,-41.140707485566416,2.008214101621178,1.7617570249775714,0.02637725463130791,1825327200.0,-1.0
AMZN,2023-05-01,102.0500030517578,105.2300033569336,101.81999969482422,104.9499969482422,74728100.0,-3.3999938964844034,3.3999938964844034,0.0,44.29285021968354,97.70999908447266,110.86000061035156,33.0038286211915,-66.9961713788085,1.6525797596248424,1.7399215719070256,-0.0024437926934715026,1750599100.0,-1.0
AMZN,2023-05-02,103.62999725341795,103.9000015258789,101.1500015258789,101.47000122070312,73469400.0,1.5799942016601562,0.0,1.5799942016601562,48.995956028586576,98.70999908447266,110.86000061035156,40.493807004599496,-59.50619299540051,1.4811554706191288,1.6881683516494461,-0.00642383296966309,1824068500.0,1.0
AMZN,2023-05-03,103.6500015258789,105.95999908447266,103.27999877929688,103.73999786376952,65051900.0,0.02000427246095171,0.0,0.02000427246095171,49.058784759388125,101.11000061035156,110.86000061035156,26.05129144130609,-73.94870855869391,1.3315652092796881,1.6168477231754947,-0.0015412391530454927,1889120400.0,1.0
AMZN,2023-05-04,104.0,105.38999938964844,103.30999755859376,104.04000091552734,45345500.0,0.34999847412109375,0.0,0.34999847412109375,50.294863793208265,101.1500015258789,110.86000061035156,29.3511713989608,-70.6488286010392,1.2271104359746232,1.5389002657353206,-0.02767388846118979,1934465900.0,1.0
AMZN,2023-05-05,105.66000366210938,105.76000213623048,103.5500030517578,104.2699966430664,56912900.0,1.660003662109375,0.0,1.660003662109375,56.12151907098504,101.1500015258789,110.86000061035156,46.446988274617375,-53.553011725382625,1.263710430664858,1.4838622987212282,-0.005178377055872541,1991378800.0,1.0
AMZN,2023-05-08,105.83000183105467,106.0999984741211,104.6999969482422,105.04000091552734,49430900.0,0.1699981689452983,0.0,0.1699981689452983,56.721004093329235,101.1500015258789,110.86000061035156,48.19774198186688,-51.80225801813312,1.291545489205106,1.445398936818004,0.03178319338919677,2040809700.0,1.0
AMZN,2023-05-09,106.62000274658205,106.79000091552734,105.16000366210938,105.4800033569336,44089400.0,0.7900009155273722,0.0,0.7900009155273722,59.675142584437204,101.1500015258789,110.86000061035156,56.33369450518554,-43.66630549481446,1.3616551324430333,1.42865017594301,0.01562201692899956,2084899100.0,1.0
AMZN,2023-05-10,110.19000244140624,110.66999816894533,108.0500030517578,108.0999984741211,78627600.0,3.5699996948241903,0.0,3.5699996948241903,70.25996617302846,101.1500015258789,110.86000061035156,93.09991522021123,-6.90008477978877,1.6858532031431395,1.480090781383036,0.0033691745366073445,2163526700.0,1.0
AMZN,2023-05-11,112.18000030517578,113.27999877929688,110.48999786376952,111.02999877929688,74924800.0,1.9899978637695455,0.0,1.9899978637695455,74.55566839716907,101.1500015258789,113.27999877929688,90.93158513443902,-9.068414865560982,2.079388806606133,1.5999503864276556,0.06382175013468094,2238451500.0,1.0
AMZN,2023-05-12,110.26000213623048,112.63999938964844,109.31999969482422,112.16000366210938,49810100.0,-1.9199981689452983,1.9199981689452983,0.0,64.22777597692513,101.1500015258789,113.27999877929688,75.10307232579609,-24.896927674203905,2.2108554362227295,1.7221313963866705,0.08045074805444874,2188641400.0,-1.0
AMZN,2023-05-15,111.1999969482422,112.29000091552734,109.25,111.1500015258789,53011100.0,0.9399948120117188,0.0,0.9399948120117188,66.82391930319105,101.1500015258789,113.27999877929688,82.85241300884405,-17.147586991155947,2.363646764245516,1.8504344699584396,0.07304834406501515,2241652500.0,1.0
AMZN,2023-05-16,113.4000015258789,114.79000091552734,111.0500030517578,111.0500030517578,71472900.0,2.2000045776367045,0.0,2.2000045776367045,72.2605161995393,101.1500015258789,114.79000091552734,89.80938818293991,-10.190611817060088,2.6319178648811743,2.006731148942987,0.09406656880333619,2313125400.0,1.0
AMZN,2023-05-17,115.5,115.83000183105467,114.22000122070312,114.88999938964844,65655200.0,2.0999984741210938,0.0,2.0999984741210938,76.50165620306629,101.1500015258789,115.83000183105467,97.75203117033776,-2.247968829662242,2.9796296554528823,2.2013108502449663,0.11057692307692313,2378780600.0,1.0
AMZN,2023-05-18,118.1500015258789,118.5999984741211,116.33999633789062,116.69000244140624,73174100.0,2.6500015258789062,0.0,2.6500015258789062,80.78029804771163,101.1500015258789,118.5999984741211,97.42122047598686,-2.578779524013141,3.429493662603946,2.4469474127167623,0.11820932643265247,2451954700.0,1.0
AMZN,2023-05-19,116.25,118.30999755859376,115.6999969482422,118.16000366210938,54990200.0,-1.9000015258789062,1.9000015258789062,0.0,70.2050033708903,101.1500015258789,118.5999984741211,86.53295767849507,-13.467042321504927,3.5913015959130945,2.675818249356029,0.09845977500387515,2396964500.0,-1.0
AMZN,2023-05-22,115.01000213623048,116.7699966430664,114.25,116.7699966430664,70741100.0,-1.239997863769517,1.239997863769517,0.0,63.90505311098588,103.27999877929688,118.5999984741211,76.56660307177766,-23.433396928222344,3.5782304708157255,2.856300693647969,0.07869066941960279,2326223400.0,-1.0
AMZN,2023-05-23,114.98999786376952,117.13999938964844,113.77999877929688,114.2699966430664,67576300.0,-0.02000427246096592,0.02000427246096592,0.0,63.79848453820148,103.30999755859376,118.5999984741211,76.38979467499219,-23.61020532500781,3.5256162231976163,2.990163799557899,0.043561079190607144,2258647100.0,-1.0
AMZN,2023-05-24,116.75,117.33999633789062,115.0199966430664,115.3499984741211,63487900.0,1.760002136230483,0.0,1.760002136230483,69.03975611385391,103.5500030517578,118.5999984741211,87.70764759587821,-12.29235240412179,3.584615302475939,3.109054100141507,0.040738096651737665,2322135000.0,1.0
AMZN,2023-05-25,115.0,116.87000274658205,114.30999755859376,116.62999725341795,66496700.0,-1.75,1.75,0.0,59.2054376443924,104.6999969482422,118.5999984741211,74.10073324511043,-25.89926675488956,3.450388195899393,3.1773209192930847,0.042989277815477234,2255638300.0,-1.0
AMZN,2023-05-26,120.11000061035156,121.5,116.0199966430664,116.04000091552734,96779900.0,5.1100006103515625,0.0,5.1100006103515625,72.43476018139187,105.16000366210938,121.5,91.49326988265484,-8.506730117345157,3.71353922153385,3.2845645797412386,0.08012593441217897,2352418200.0,1.0
AMZN,2023-05-30,121.66000366210938,122.91999816894533,119.86000061035156,122.37000274658205,64314800.0,1.5500030517578125,0.0,1.5500030517578125,75.24450250272743,108.0500030517578,122.91999816894533,91.52659770964159,-8.47340229035841,4.00103910931891,3.4278594856567732,0.07283952403074223,2416733000.0,1.0
AMZN,2023-05-31,120.58000183105467,122.04000091552734,119.16999816894533,121.4499969482422,72800800.0,-1.0800018310547017,1.0800018310547017,0.0,69.54532111024282,109.25,122.91999816894533,82.88224834435958,-17.11775165564042,4.094538429643947,3.561195274454208,0.04398269983597114,2343932200.0,-1.0
AMZN,2023-06-01,122.7699966430664,123.48999786376952,119.93000030517578,120.69000244140624,54375100.0,2.189994812011733,0.0,2.189994812011733,74.12992567213092,109.25,123.48999786376952,94.9438108938556,-5.056189106144409,4.295831917128652,3.708122602989097,0.03910279354652024,2398307300.0,1.0
AMZN,2023-06-02,124.25,126.38999938964844,124.0199966430664,124.91999816894533,61215000.0,1.4800033569335938,0.0,1.4800033569335938,76.84767831482509,109.25,126.38999938964844,87.51458888066897,-12.485411119331035,4.522648086313623,3.8710276996540025,0.0688172043010753,2459522300.0,1.0
AMZN,2023-06-05,125.3000030517578,125.8000030517578,123.02999877929688,123.36000061035156,47950100.0,1.0500030517577983,0.0,1.0500030517577983,78.6810628631292,111.0500030517578,126.38999938964844,92.89441591848176,-7.105584081518246,4.732573840244768,4.043336927772156,0.08947048712631722,2507472400.0,1.0
AMZN,2023-06-06,126.61000061035156,127.4000015258789,125.0,125.06999969482422,45695200.0,1.3099975585937642,0.0,1.3099975585937642,80.86263235052974,113.77999877929688,127.4000015258789,94.19970076198703,-5.8002992380129745,4.947614349107198,4.224192412039164,0.10105229117708525,2553167600.0,1.0
AMZN,2023-06-07,121.2300033569336,127.37000274658205,120.62999725341795,127.01000213623048,95663300.0,-5.379997253417969,5.379997253417969,0.0,54.456176288069344,113.77999877929688,127.4000015258789,54.69899467903054,-45.30100532096946,4.630536740688484,4.305461277769028,0.0383726197596026,2457504300.0,-1.0
AMZN,2023-06-08,124.25,125.62999725341795,122.26000213623048,123.01000213623048,62159300.0,3.0199966430664062,0.0,3.0199966430664062,62.40744455965188,113.77999877929688,127.4000015258789,76.87224015671065,-23.127759843289354,4.570255876665598,4.358420197548343,0.08043478260869574,2519663600.0,1.0
AMZN,2023-06-09,123.43000030517578,125.8000030517578,123.19000244140624,124.08000183105467,51330000.0,-0.8199996948242188,0.8199996948242188,0.0,59.1709802785282,113.77999877929688,127.4000015258789,70.8516856085113,-29.14831439148869,4.405531510374871,4.367842460113649,0.02764132610068515,2468333600.0,-1.0
AMZN,2023-06-12,126.56999969482422,126.77999877929688,123.52999877929688,124.0199966430664,51338000.0,3.1399993896484375,0.0,3.1399993896484375,66.7824110977486,113.77999877929688,127.4000015258789,93.90600834303812,-6.093991656961877,4.4767527529352975,4.389624518677979,0.04035834197697019,2519671600.0,1.0
AMZN,2023-06-13,126.66000366210938,128.41000366210938,125.18000030517578,128.1199951171875,50564800.0,0.09000396728515625,0.0,0.09000396728515625,66.98596338013405,114.30999755859376,128.41000366210938,87.58865785480997,-12.411342145190032,4.488715550018952,4.409442724946174,0.0504229701337493,2570236400.0,1.0
AMZN,2023-06-14,126.41999816894533,126.9499969482422,124.12000274658205,126.6999969482422,52422500.0,-0.2400054931640483,0.2400054931640483,0.0,65.74634804483168,114.30999755859376,128.41000366210938,85.88649197344765,-14.11350802655236,4.427788920928734,4.4131119641426855,0.02973040340214972,2517813900.0,-1.0
AMZN,2023-06-15,127.11000061035156,127.69000244140624,124.31999969482422,125.20999908447266,60458500.0,0.6900024414062358,0.0,0.6900024414062358,67.72747982985288,116.0199966430664,128.41000366210938,89.5076487869639,-10.492351213036097,4.384638179264485,4.407417207167046,0.023018113564197584,2578272400.0,1.0
AMZN,2023-06-16,125.48999786376952,127.9000015258789,125.3000030517578,127.70999908447266,84188100.0,-1.6200027465820455,1.6200027465820455,0.0,58.553233467352484,119.16999816894533,128.41000366210938,68.39822443287356,-31.60177556712645,4.171632243141914,4.36026021436202,0.0015163192927716285,2494084300.0,-1.0
AMZN,2023-06-20,125.77999877929688,127.25,124.5,124.97000122070312,56930100.0,0.29000091552735796,0.0,0.29000091552735796,59.6813222698202,119.16999816894533,128.41000366210938,71.5367606138521,-28.463239386147908,3.9803412580379103,4.284276423097198,-0.006555578761973657,2551014400.0,1.0
AMZN,2023-06-21,124.83000183105467,126.7300033569336,123.8499984741211,125.63999938964844,52137700.0,-0.9499969482422017,0.9499969482422017,0.0,54.114155085360366,119.93000030517578,128.41000366210938,57.78301398751749,-42.2169860124825,3.709326156936669,4.169286369865093,0.029695606487130988,2498876700.0,-1.0
AMZN,2023-06-22,130.14999389648438,130.3300018310547,125.13999938964844,125.30999755859376,90354600.0,5.319992065429702,0.0,5.319992065429702,71.37043699871217,120.62999725341795,130.3300018310547,98.14424897298173,-1.855751027018266,3.879107696541908,4.111250635200456,0.04748486033387822,2589231300.0,1.0
AMZN,2023-06-23,129.3300018310547,130.83999633789062,128.27999877929688,129.11000061035156,71855200.0,-0.8199920654296875,0.8199920654296875,0.0,66.89622384927615,120.62999725341795,130.83999633789062,85.21063034048326,-14.789369659516735,3.9025085933317882,4.069502226826723,0.04780038492498906,2517376100.0,-1.0
AMZN,2023-06-26,127.33000183105467,131.49000549316406,127.0999984741211,129.3300018310547,59989300.0,-2.000000000000014,2.000000000000014,0.0,56.8638672921181,120.62999725341795,131.49000549316406,61.69428631845454,-38.30571368154546,3.7168254373314653,3.9989668689276714,0.006004599336832728,2457386800.0,-1.0
AMZN,2023-06-27,129.17999267578125,130.08999633789062,127.5500030517578,128.6300048828125,46801000.0,1.8499908447265767,0.0,1.8499908447265767,62.815673303878526,120.62999725341795,131.49000549316406,78.72917988286152,-21.270820117138488,3.676567813408184,3.9344870578237745,0.019895696674653962,2504187800.0,1.0
AMZN,2023-06-28,129.0399932861328,131.47999572753906,128.44000244140625,128.94000244140625,52149500.0,-0.1399993896484375,0.1399993896484375,0.0,62.06788447309256,122.26000213623048,131.49000549316406,73.45599874358875,-26.544001256411253,3.5919606887851216,3.865981784016044,0.020724530573764,2452038300.0,-1.0
AMZN,2023-06-29,127.9000015258789,129.25999450683594,127.26000213623048,128.77000427246094,40761000.0,-1.1399917602539062,1.1399917602539062,0.0,55.82399321417231,123.19000244140624,131.49000549316406,56.74695605654214,-43.25304394345786,3.393799516951546,3.771545330603145,0.006215096465533421,2411277300.0,-1.0
AMZN,2023-06-30,130.36000061035156,131.25,128.9499969482422,129.47000122070312,54310500.0,2.4599990844726562,0.0,2.4599990844726562,64.67270276591472,123.52999877929688,131.49000549316406,85.80397073228707,-14.196029267712929,3.396108502829591,3.6964579650484346,0.038807895684792815,2465587800.0,1.0
AMZN,2023-07-03,130.22000122070312,131.85000610351562,130.07000732421875,130.82000732421875,28264800.0,-0.1399993896484375,0.1399993896484375,0.0,63.83309110186965,123.8499984741211,131.85000610351562,79.62495839599762,-20.375041604002377,3.348047403670023,3.6267758527727523,0.035299749439471784,2437323000.0,-1.0
AMZN,2023-07-05,130.3800048828125,131.39999389648438,129.63999938964844,130.24000549316406,35895400.0,0.160003662109375,0.0,0.160003662109375,64.44185409952794,123.8499984741211,131.85000610351562,81.62500226497434,-18.37499773502566,3.2850021348822622,3.5584211091946543,0.044460490029225586,2473218400.0,1.0
AMZN,2023-07-06,128.36000061035156,128.72999572753906,127.37000274658205,128.25,40639900.0,-2.0200042724609375,2.0200042724609375,0.0,51.75252477647428,123.8499984741211,131.85000610351562,56.37497293951708,-43.62502706048292,3.0370318297965895,3.454143253315041,-0.013753310565319699,2432578500.0,-1.0
AMZN,2023-07-07,129.77999877929688,130.97000122070312,128.1300048828125,128.58999633789062,41928700.0,1.4199981689453125,0.0,1.4199981689453125,58.39723755994014,123.8499984741211,131.85000610351562,74.12493312365234,-25.875066876347656,2.92141925860777,3.3475984543735873,0.003479447474453945,2474507200.0,1.0
AMZN,2023-07-10,127.12999725341795,129.27999877929688,125.91999816894533,129.07000732421875,61889300.0,-2.6500015258789205,2.6500015258789205,0.0,45.04024670408107,123.8499984741211,131.85000610351562,40.99994564061563,-59.00005435938437,2.586150948533785,3.1953089532056267,-0.0015707576750222385,2412617900.0,-1.0
AMZN,2023-07-11,128.77999877929688,129.77000427246094,127.3499984741211,127.75,49951500.0,1.6500015258789205,0.0,1.6500015258789205,52.79687844732939,123.8499984741211,131.85000610351562,61.62494504456993,-38.37505495543007,2.425628594289165,3.0413728814223346,-0.0030964074869418434,2462569400.0,1.0
AMZN,2023-07-12,130.8000030517578,131.25999450683594,128.8300018310547,130.30999755859375,54022800.0,2.0200042724609375,0.0,2.0200042724609375,60.64316874666289,125.13999938964844,131.85000610351562,84.3516840365028,-15.648315963497192,2.433360667891648,2.919770438716198,0.013639258037795754,2516592200.0,1.0
AMZN,2023-07-13,134.3000030517578,134.6699981689453,132.7100067138672,134.0399932861328,61170900.0,3.5,0.0,3.5,70.4599402969064,125.91999816894533,134.6699981689453,95.771484375,-4.228515625000007,2.690890233615633,2.873994397696085,0.05003910437470904,2577763100.0,1.0
AMZN,2023-07-14,134.67999267578125,136.64999389648438,134.05999755859375,134.05999755859375,54388100.0,0.3799896240234375,0.0,0.3799896240234375,71.35499396799135,125.91999816894533,136.64999389648438,81.64024226359176,-18.35975773640825,2.8923055587218442,2.8776566299012374,0.03313893867139672,2632151200.0,1.0
AMZN,2023-07-17,133.55999755859375,135.6199951171875,133.2100067138672,134.55999755859375,48450200.0,-1.1199951171875,1.1199951171875,0.0,64.6890622167721,125.91999816894533,136.64999389648438,71.2022593824525,-28.79774061754751,2.927804501422912,2.887686204205573,0.02564887349547651,2583701000.0,-1.0
AMZN,2023-07-18,132.8300018310547,133.86000061035156,131.35000610351562,132.7100067138672,54969100.0,-0.7299957275390625,0.7299957275390625,0.0,60.44255926901825,125.91999816894533,136.64999389648438,64.3989414121993,-35.601058587800686,2.8640184924941536,2.8829526618632895,0.018791201537722513,2528731900.0,-1.0
AMZN,2023-07-19,135.36000061035156,135.99000549316406,132.52999877929688,133.38999938964844,54531000.0,2.529998779296875,0.0,2.529998779296875,68.66766119820561,125.91999816894533,136.64999389648438,87.9776905891772,-12.02230941082281,2.983228576240407,2.9030078447387133,0.0545341225203726,2583262900.0,1.0
AMZN,2023-07-20,129.9600067138672,134.7899932861328,129.3300018310547,134.07000732421875,59820600.0,-5.399993896484375,5.399993896484375,0.0,45.41285330167814,125.91999816894533,136.64999389648438,37.65153917585433,-62.34846082414567,2.6118611392708715,2.8447785036451454,0.0013870237036790467,2523442300.0,-1.0
AMZN,2023-07-21,130.0,131.3699951171875,128.4199981689453,131.33999633789062,133265000.0,0.0399932861328125,0.0,0.0399932861328125,45.57037398205993,125.91999816894533,136.64999389648438,38.024263332958775,-61.975736667041225,2.2943292939375795,2.7346886617036326,0.022575338697294667,2656707300.0,1.0
AMZN,2023-07-24,128.8000030517578,131.66000366210938,128.35000610351562,130.30999755859375,45591100.0,-1.1999969482421875,1.1999969482421875,0.0,41.431182897948176,125.91999816894533,136.64999389648438,26.84068993075939,-73.15931006924062,1.9236783275752316,2.5724865948779527,0.00015533679647883325,2611116200.0,-1.0
AMZN,2023-07-25,129.1300048828125,129.5800018310547,128.52999877929688,129.30999755859375,39236700.0,0.3300018310546875,0.0,0.3300018310546875,43.07193665583668,125.91999816894533,136.64999389648438,29.916197502563186,-70.0838024974368,1.6376849435569625,2.385526264613755,-0.012767569801083956,2650352900.0,1.0
AMZN,2023-07-26,128.14999389648438,129.0800018310547,126.11000061035156,126.51000213623048,53910100.0,-0.980010986328125,0.980010986328125,0.0,39.29946413570267,125.91999816894533,136.64999389648438,20.782820274715093,-79.21717972528491,1.3167754620855874,2.1717761041081216,-0.045793067874341675,2596442800.0,-1.0
AMZN,2023-07-27,128.25,132.6300048828125,127.79000091552734,131.0,52610700.0,0.100006103515625,0.0,0.100006103515625,39.91906474869371,125.91999816894533,136.64999389648438,21.714843977753056,-78.28515602224695,1.0583223613604105,1.9490853555585794,-0.047742745956783184,2649053500.0,1.0
AMZN,2023-07-28,132.2100067138672,133.00999450683594,129.3300018310547,129.69000244140625,46317400.0,3.9600067138671875,0.0,3.9600067138671875,59.02761927405032,126.11000061035156,136.64999389648438,57.87485758213185,-42.12514241786814,1.1596679335638953,1.7912018711596427,-0.010107748348335499,2695370900.0,1.0
AMZN,2023-07-31,133.67999267578125,133.8699951171875,132.3800048828125,133.1999969482422,41901500.0,1.4699859619140625,0.0,1.4699859619140625,63.93990071871229,126.11000061035156,136.64999389648438,71.8216023475966,-28.178397652403405,1.343117983578992,1.7015850936435128,0.0063990878040314225,2737272400.0,1.0
AMZN,2023-08-01,131.69000244140625,133.69000244140625,131.6199951171875,133.5500030517578,42098500.0,-1.989990234375,1.989990234375,0.0,53.85437196435735,126.11000061035156,136.64999389648438,52.94122756601891,-47.05877243398108,1.3127948076739813,1.6238270364496066,-0.027112870511206588,2695173900.0,-1.0
AMZN,2023-08-02,128.2100067138672,130.22999572753906,126.81999969482422,130.14999389648438,51027600.0,-3.4799957275390625,3.4799957275390625,0.0,40.852156158980485,126.11000061035156,136.64999389648438,19.924169271327212,-80.0758307286728,0.9964702123016878,1.498355671620023,-0.013465681052579281,2644146300.0,-1.0
AMZN,2023-08-03,128.91000366210938,129.83999633789062,126.41000366210938,127.4800033569336,88585200.0,0.6999969482421875,0.0,0.6999969482421875,43.99065683566599,126.11000061035156,135.99000549316406,28.340097853886352,-71.65990214611364,0.7931219786099462,1.3573089330180077,-0.008384587214543271,2732731500.0,1.0
AMZN,2023-08-04,139.57000732421875,143.6300048828125,139.32000732421875,141.05999755859375,152938700.0,10.660003662109375,0.0,10.660003662109375,71.01534071874492,126.11000061035156,143.6300048828125,76.82650360436547,-23.173496395634523,1.4751357972976393,1.3808743058739341,0.08361804361241387,2885670200.0,1.0
AMZN,2023-08-07,142.22000122070312,142.5399932861328,138.9499969482422,140.99000549316406,71213100.0,2.649993896484375,0.0,2.649993896484375,74.53912200834111,126.11000061035156,143.6300048828125,91.9520358546618,-8.047964145338188,2.204061968384508,1.545511838376049,0.10137067949288792,2956883300.0,1.0
AMZN,2023-08-08,139.94000244140625,140.83999633789062,138.4199981689453,140.6199951171875,51710500.0,-2.279998779296875,2.279998779296875,0.0,66.51169428107637,126.11000061035156,143.6300048828125,78.93834736555155,-21.06165263444845,2.5681602115612634,1.7500415130130924,0.09200163173199583,2905172800.0,-1.0
AMZN,2023-08-09,137.85000610351562,140.32000732421875,137.10000610351562,139.97000122070312,50017300.0,-2.089996337890625,2.089996337890625,0.0,59.7102683666075,126.11000061035156,143.6300048828125,67.00914743278776,-32.99085256721225,2.6574322302690234,1.931519656464279,0.07485384876035583,2855155500.0,-1.0
AMZN,2023-08-10,138.55999755859375,140.41000366210938,137.49000549316406,139.07000732421875,58928400.0,0.709991455078125,0.0,0.709991455078125,61.26295547498994,126.11000061035156,143.6300048828125,71.06160908768663,-28.938390912313373,2.7537280620802846,2.09596133758748,0.04802957811256592,2914083900.0,1.0
AMZN,2023-08-11,138.41000366210938,139.3300018310547,137.0,137.39999389648438,42832100.0,-0.149993896484375,0.149993896484375,0.0,60.69279763384851,126.11000061035156,143.6300048828125,70.2054797503203,-29.794520249679714,2.7858266729014076,2.233934404650266,0.03538308831150205,2871251800.0,-1.0
AMZN,2023-08-14,140.57000732421875,140.58999633789062,137.75,138.3000030517578,47148700.0,2.160003662109375,0.0,2.160003662109375,65.95722269373084,126.11000061035156,143.6300048828125,82.53426476953747,-17.465735230462528,2.9515358290930465,2.377454689538822,0.06743112398956441,2918400500.0,1.0
AMZN,2023-08-15,137.6699981689453,141.27999877929688,137.22999572753906,140.0500030517578,42781500.0,-2.9000091552734375,2.9000091552734375,0.0,54.623963729613806,126.41000366210938,143.6300048828125,65.38904592700239,-34.61095407299762,2.8163894424510545,2.4652416401212687,0.07378512565084305,2875619000.0,-1.0
AMZN,2023-08-16,135.07000732421875,137.27000427246094,135.00999450683594,137.19000244140625,41675900.0,-2.5999908447265625,2.5999908447265625,0.0,46.37987942903626,126.41000366210938,143.6300048828125,50.290377748043916,-49.709622251956084,2.4710032380388327,2.4663939597047815,0.047785303600297535,2833943100.0,-1.0
AMZN,2023-08-17,133.97999572753906,136.08999633789062,133.52999877929688,135.4600067138672,48354100.0,-1.0900115966796875,1.0900115966796875,0.0,43.22419658223684,126.41000366210938,143.6300048828125,43.96046183973842,-56.03953816026158,2.085289437832131,2.3901730553302514,-0.04005166800410198,2785589000.0,-1.0
AMZN,2023-08-18,133.22000122070312,134.07000732421875,131.14999389648438,131.6199951171875,48469400.0,-0.7599945068359375,0.7599945068359375,0.0,40.980969674576706,126.41000366210938,143.6300048828125,39.547021346353226,-60.45297865364678,1.6987016913946036,2.251878782543122,-0.06328223824181667,2737119600.0,-1.0
AMZN,2023-08-21,134.67999267578125,135.19000244140625,132.7100067138672,133.74000549316406,41442500.0,1.459991455078125,0.0,1.459991455078125,47.06984660508862,126.41000366210938,143.6300048828125,48.02548447981002,-51.97451552018998,1.4929276848598079,2.100088563006459,-0.037587606644693294,2778562100.0,1.0
AMZN,2023-08-22,134.25,135.64999389648438,133.72999572753906,135.0800018310547,32935100.0,-0.42999267578125,0.42999267578125,0.0,45.47550525402345,126.41000366210938,143.6300048828125,45.52843079049737,-54.471569209502626,1.280393902927102,1.9361496309905877,-0.02611538588407658,2745627000.0,-1.0
AMZN,2023-08-23,135.52000427246094,135.9499969482422,133.22000122070312,134.5,42801000.0,1.2700042724609375,0.0,1.2700042724609375,51.11809738912189,131.14999389648438,143.6300048828125,35.016077956693444,-64.98392204330655,1.2005983302367724,1.789039370839825,-0.021939905742617172,2788428000.0,1.0
AMZN,2023-08-24,131.83999633789062,136.77999877929688,131.8300018310547,136.39999389648438,43646300.0,-3.6800079345703125,3.6800079345703125,0.0,37.9777303597556,131.14999389648438,142.5399932861328,6.057967325558808,-93.9420326744412,0.8308365126335104,1.597398799198562,-0.047467720181972206,2744781700.0,-1.0
AMZN,2023-08-25,133.25999450683594,133.8699951171875,130.5800018310547,132.47000122070312,44147500.0,1.4199981689453125,0.0,1.4199981689453125,44.347246038927594,130.5800018310547,141.27999877929688,25.046667664905485,-74.95333233509452,0.6449450677304753,1.406908052904945,-0.05200264947360056,2788929200.0,1.0
AMZN,2023-08-28,133.13999938964844,133.9499969482422,131.85000610351562,133.77999877929688,34108400.0,-0.1199951171875,0.1199951171875,0.0,43.90758096887992,130.5800018310547,141.27999877929688,23.925217651714476,-76.07478234828552,0.48238156089144013,1.222002754502244,-0.03290476385230845,2754820800.0,-1.0
AMZN,2023-08-29,134.91000366210938,135.13999938964844,133.25,133.3800048828125,38646100.0,1.7700042724609375,0.0,1.7700042724609375,52.006010503741564,130.5800018310547,141.27999877929688,40.46731837401156,-59.53268162598844,0.49071668626066867,1.075745540853929,-0.0011845980116467203,2793466900.0,1.0
AMZN,2023-08-30,135.07000732421875,135.67999267578125,133.9199981689453,134.92999267578125,36137000.0,0.160003662109375,0.0,0.160003662109375,52.71803618680104,130.5800018310547,141.27999877929688,41.962680128630204,-58.037319871369796,0.5044186670884585,0.9614801661008349,0.008135629433041025,2829603900.0,1.0
AMZN,2023-08-31,138.00999450683594,138.7899932861328,135.0,135.05999755859375,58781300.0,2.9399871826171875,0.0,2.9399871826171875,64.03147944335652,130.5800018310547,141.27999877929688,69.43920369063153,-30.56079630936847,0.7439343684348216,0.9179710065676323,0.03595551150158993,2888385200.0,1.0
AMZN,2023-09-01,138.1199951171875,139.9600067138672,136.8800048828125,139.4600067138672,40948300.0,0.1100006103515625,0.0,0.1100006103515625,64.39923244216264,130.5800018310547,141.27999877929688,70.4672470712386,-29.5327529287614,0.9318862131252956,0.9207540478791649,0.0255420450585222,2929333500.0,1.0
AMZN,2023-09-05,137.27000427246094,137.8000030517578,135.82000732421875,137.72999572753906,40636700.0,-0.8499908447265625,0.8499908447265625,0.0,59.019096328214516,130.5800018310547,139.9600067138672,71.32195052120612,-28.67804947879387,1.0007166085242432,0.9367465600081807,0.02249537633118015,2888696800.0,-1.0
AMZN,2023-09-06,135.36000061035156,137.4499969482422,134.61000061035156,136.32000732421875,41785500.0,-1.910003662109375,1.910003662109375,0.0,48.51106736684989,130.5800018310547,139.9600067138672,50.95944873179683,-49.040551268203174,0.8908744141126874,0.9275721308290821,-0.0011806645297006702,2846911300.0,-1.0
AMZN,2023-09-07,137.85000610351562,138.02999877929688,133.16000366210938,133.89999389648438,48498900.0,2.4900054931640625,0.0,2.4900054931640625,59.38781542390424,130.5800018310547,139.9600067138672,77.50533569318463,-22.49466430681537,0.9932962166453763,0.9407169479923411,0.04558563359044743,2895410200.0,1.0
AMZN,2023-09-08,138.22999572753906,138.85000610351562,136.75,136.86000061035156,38348200.0,0.3799896240234375,0.0,0.3799896240234375,60.84427937729235,130.5800018310547,139.9600067138672,81.55639567418436,-18.443604325815645,1.0925341662253345,0.9710803916389399,0.037295523229577965,2933758400.0,1.0
AMZN,2023-09-11,143.10000610351562,143.6199951171875,138.63999938964844,138.75,56764500.0,4.8700103759765625,0.0,4.8700103759765625,74.41361072509767,130.5800018310547,143.6199951171875,96.0123521365241,-3.9876478634758934,1.5463250209174646,1.0861293174946451,0.07480852305487962,2990522900.0,1.0
AMZN,2023-09-12,141.22999572753906,143.0,140.61000061035156,142.32000732421875,42668500.0,-1.8700103759765625,1.8700103759765625,0.0,64.50883864691099,130.5800018310547,143.6199951171875,81.67177438511378,-18.32822561488622,1.7350626118841888,1.215915976372554,0.04684598542639207,2947854400.0,-1.0
AMZN,2023-09-13,144.85000610351562,144.97999572753906,140.8699951171875,140.9499969482422,60465200.0,3.6200103759765625,0.0,3.6200103759765625,72.64244421041236,130.5800018310547,144.97999572753906,99.0972938949983,-0.9027061050017059,2.1519369070284995,1.4031201625037433,0.07240688716201227,3008319600.0,1.0
AMZN,2023-09-14,144.72000122070312,145.86000061035156,142.9499969482422,145.0800018310547,64033600.0,-0.1300048828125,0.1300048828125,0.0,71.95908931352254,130.5800018310547,145.86000061035156,92.53927041412436,-7.460729585875633,2.4436535646291304,1.611226842928821,0.048619715824529175,2944286000.0,-1.0
AMZN,2023-09-15,140.38999938964844,143.57000732421875,140.08999633789062,142.69000244140625,102861700.0,-4.3300018310546875,4.3300018310546875,0.0,52.85202980469032,131.85000610351562,145.86000061035156,60.95643565003447,-39.04356434996553,2.298945346145132,1.7487705435720833,0.0164350155857953,2841424300.0,-1.0
AMZN,2023-09-18,139.97999572753906,141.75,139.22000122070312,140.47999572753906,42823500.0,-0.410003662109375,0.410003662109375,0.0,51.36199089345234,133.16000366210938,145.86000061035156,53.70073782870984,-46.29926217129016,2.1266643090888806,1.824349296675443,0.019742051218263112,2798600800.0,-1.0
AMZN,2023-09-19,137.6300048828125,138.83999633789062,135.55999755859375,138.6999969482422,61482500.0,-2.3499908447265625,2.3499908447265625,0.0,43.290482445642326,133.16000366210938,145.86000061035156,35.19686846319928,-64.80313153680073,1.7799871407721923,1.8154768654947928,0.01677012605071848,2737118300.0,-1.0
AMZN,2023-09-20,135.2899932861328,139.3699951171875,135.1999969482422,138.5500030517578,46263700.0,-2.3400115966796875,2.3400115966796875,0.0,36.66956257825239,133.16000366210938,145.86000061035156,16.771575872844995,-83.22842412715501,1.3014216292131664,1.7126658182384675,-0.018571002568258277,2690854600.0,-1.0
AMZN,2023-09-21,129.3300018310547,132.24000549316406,129.30999755859375,131.94000244140625,70234800.0,-5.959991455078125,5.959991455078125,0.0,25.2985873888599,129.30999755859375,145.86000061035156,0.12087171463580365,-99.87912828536419,0.43620521058704753,1.4573736967081836,-0.06438540238420376,2620619800.0,-1.0
AMZN,2023-09-22,129.1199951171875,132.02999877929688,128.52000427246094,131.11000061035156,59904300.0,-0.2100067138671875,0.2100067138671875,0.0,24.98360767590603,128.52000427246094,145.86000061035156,3.460155544643847,-96.53984445535615,-0.2633945727542937,1.1132200428156882,-0.09769399294235714,2560715500.0,-1.0
AMZN,2023-09-25,131.27000427246094,131.77999877929688,128.77000427246094,129.36000061035156,46017800.0,2.1500091552734375,0.0,2.1500091552734375,34.602064239188266,128.52000427246094,145.86000061035156,15.85928823981823,-84.14071176018176,-0.637001711729198,0.7631756919067109,-0.07052320156047409,2606733300.0,1.0
AMZN,2023-09-26,125.9800033569336,130.38999938964844,125.27999877929688,130.1199951171875,73048200.0,-5.290000915527344,5.290000915527344,0.0,25.367908092846633,125.27999877929688,145.86000061035156,3.4013824847208225,-96.59861751527917,-1.3444489539113818,0.3416507627430923,-0.13027270936458757,2533685100.0,-1.0
AMZN,2023-09-29,127.12000274658205,129.14999389648438,126.31999969482422,128.1999969482422,62377600.0,1.1399993896484517,0.0,1.1399993896484517,31.426146412745624,123.04000091552734,145.86000061035156,17.879061724878476,-82.12093827512152,-2.4812208647778107,-0.9278629766524762,-0.09187021984189847,2596062700.0,1.0
AMZN,2023-10-02,129.4600067138672,130.47000122070312,126.54000091552734,127.27999877929688,48029700.0,2.340003967285142,0.0,2.340003967285142,42.4839671155358,123.04000091552734,145.86000061035156,28.133242262031928,-71.86675773796807,-2.4206517392658498,-1.2264207291751512,-0.05936204228069164,2644092400.0,1.0
AMZN,2023-10-03,124.72000122070312,128.52000427246094,124.25,128.05999755859375,51565000.0,-4.7400054931640625,4.7400054931640625,0.0,30.85489198434206,123.04000091552734,145.86000061035156,7.361964625954051,-92.63803537404594,-2.7237316177152593,-1.525882906883173,-0.07812841000793447,2592527400.0,-1.0
AMZN,2023-10-04,127.0,127.36000061035156,125.68000030517578,126.05999755859376,44203900.0,2.279998779296875,0.0,2.279998779296875,39.97419746056381,123.04000091552734,143.57000732421875,19.288835111109297,-80.7111648888907,-2.748267441881694,-1.7703598138828773,-0.01801594214850777,2636731300.0,1.0
AMZN,2023-10-05,125.95999908447266,126.7300033569336,124.33000183105467,126.70999908447266,39660600.0,-1.0400009155273438,1.0400009155273438,0.0,37.37953307668879,123.04000091552734,141.75,15.606618449108348,-84.39338155089166,-2.819134414853238,-1.9801147340769496,-0.02447332831639959,2597070700.0,-1.0
AMZN,2023-10-06,127.95999908447266,128.4499969482422,124.12999725341795,124.16000366210938,46795900.0,2.0,0.0,2.0,45.26314850380167,123.04000091552734,139.3699951171875,30.128597158014486,-69.87140284198551,-2.6829859245619616,-2.1206889721739524,-0.025215244002873005,2643866600.0,1.0
AMZN,2023-10-09,128.25999450683594,128.7899932861328,124.76000213623048,126.22000122070312,38773700.0,0.29999542236328125,0.0,0.29999542236328125,46.43038851137888,123.04000091552734,139.3699951171875,31.965679392451428,-68.03432060754857,-2.5218102825262747,-2.200913234244417,0.018098040078968314,2682640300.0,1.0
AMZN,2023-10-10,129.47999572753906,130.74000549316406,128.0500030517578,128.82000732421875,42178600.0,1.220001220703125,0.0,1.220001220703125,51.30314603529515,123.04000091552734,132.24000549316406,69.99990877902383,-30.000091220976184,-2.2694724566869127,-2.2146250787329165,0.02778212634817212,2724818900.0,1.0
AMZN,2023-10-11,131.8300018310547,132.0500030517578,129.61000061035156,129.74000549316406,40741800.0,2.350006103515625,0.0,2.350006103515625,59.492480136918566,123.04000091552734,132.0500030517578,97.55825562106727,-2.441744378932715,-1.8584440725529987,-2.143388877496933,0.04643592886361936,2765560700.0,1.0
AMZN,2023-10-12,132.3300018310547,134.47999572753906,131.22999572753906,132.1699981689453,55528600.0,0.5,0.0,0.5,61.098542762198576,123.04000091552734,134.47999572753906,81.20633853586251,-18.793661464137497,-1.475348397547208,-2.009780781506988,0.04098488807350753,2821089300.0,1.0
AMZN,2023-10-13,129.7899932861328,133.30999755859375,128.9499969482422,132.97999572753906,45786600.0,-2.540008544921875,2.540008544921875,0.0,49.576795294665736,123.04000091552734,134.47999572753906,59.00345657078567,-40.99654342921433,-1.3610108905415927,-1.880026803313909,0.0025489460462870817,2775302700.0,-1.0
AMZN,2023-10-16,132.5500030517578,133.07000732421875,130.42999267578125,130.69000244140625,42832900.0,2.760009765625,0.0,2.760009765625,59.2188630192461,123.04000091552734,134.47999572753906,83.12942700153322,-16.870572998466784,-1.0357484078458299,-1.7111711242202932,0.0627806426749371,2818135600.0,1.0
AMZN,2023-10-17,131.47000122070312,132.5800018310547,128.7100067138672,130.38999938964844,49344600.0,-1.0800018310546875,1.0800018310546875,0.0,54.512378397389675,123.04000091552734,134.47999572753906,73.68884727399076,-26.311152726009247,-0.8552637209421903,-1.5399896435646725,0.035196860005536346,2768791000.0,-1.0
AMZN,2023-10-18,128.1300048828125,130.6699981689453,127.51000213623048,129.89999389648438,42699500.0,-3.339996337890625,3.339996337890625,0.0,42.4683586024972,124.12999725341795,134.47999572753906,38.64742240683484,-61.35257759316516,-0.9705501986591969,-1.4261017545835775,0.017227737488983097,2726091500.0,-1.0
AMZN,2023-10-19,128.39999389648438,132.24000549316406,127.47000122070312,130.57000732421875,60961400.0,0.269989013671875,0.0,0.269989013671875,43.63000076622673,124.12999725341795,134.47999572753906,41.25601229548989,-58.743987704510104,-1.0282763758521298,-1.3465366788372881,0.003438534035321794,2787052900.0,1.0
AMZN,2023-10-20,125.16999816894533,128.1699981689453,124.97000122070312,128.0500030517578,56343300.0,-3.2299957275390483,3.2299957275390483,0.0,34.12003707155439,124.12999725341795,134.47999572753906,10.048319505821821,-89.95168049417818,-1.3194486652986939,-1.3411190761295695,-0.024091661236785078,2730709600.0,-1.0
AMZN,2023-10-23,126.55999755859376,127.87999725341795,123.9800033569336,124.62999725341795,48260000.0,1.3899993896484375,0.0,1.3899993896484375,40.55397713702684,123.9800033569336,134.47999572753906,24.571391202938546,-75.42860879706146,-1.4216555086788958,-1.357226362639435,-0.02255173204585026,2778969600.0,1.0
AMZN,2023-10-24,128.55999755859375,128.8000030517578,126.33999633789062,127.73999786376952,46477400.0,1.9999999999999858,0.0,1.9999999999999858,48.8477427991958,123.9800033569336,134.47999572753906,43.619024090739,-56.380975909261,-1.3259867334505486,-1.3509784368016577,-0.02480470474885965,2825447000.0,1.0
AMZN,2023-10-25,121.38999938964844,126.33999633789062,120.79000091552734,126.04000091552734,74577500.0,-7.1699981689453125,7.1699981689453125,0.0,30.972755126190876,120.79000091552734,134.47999572753906,4.3827516544757925,-95.6172483455242,-1.8078872707977354,-1.4423602036008734,-0.08267212491520493,2750869500.0,-1.0
AMZN,2023-10-26,119.56999969482422,121.63999938964844,118.3499984741211,120.62999725341795,100419500.0,-1.8199996948242188,1.8199996948242188,0.0,27.974530079939385,118.3499984741211,134.47999572753906,7.563555043040104,-92.43644495695989,-2.310027128753191,-1.615893588631337,-0.0787425388702947,2650450000.0,-1.0
AMZN,2023-10-27,127.73999786376952,130.02000427246094,125.5199966430664,126.1999969482422,125309300.0,8.169998168945298,0.0,8.169998168945298,52.027742836871845,118.3499984741211,134.47999572753906,58.21451325826277,-41.78548674173723,-2.0253787062240463,-1.697790612149879,-0.036288231439044916,2775759300.0,1.0
AMZN,2023-10-30,132.7100067138672,133.0,128.55999755859375,129.72000122070312,72485500.0,4.9700088500976705,0.0,4.9700088500976705,61.13739866841487,118.3499984741211,134.47999572753906,89.02672464313774,-10.97327535686227,-1.3828143790925793,-1.634795365538419,0.00943185123336554,2848244800.0,1.0
AMZN,2023-10-31,133.08999633789062,133.57000732421875,131.7100067138672,132.75,51589400.0,0.3799896240234375,0.0,0.3799896240234375,61.77770973103535,118.3499984741211,134.47999572753906,91.38251936556347,-8.617480634436529,-0.8333096584367752,-1.4744982241180904,0.03871061629642902,2899834200.0,1.0
AMZN,2023-11-01,137.0,137.35000610351562,133.7100067138672,133.9600067138672,61529400.0,3.910003662109375,0.0,3.910003662109375,68.03139663371529,118.3499984741211,137.35000610351562,98.15786335278025,-1.8421366472197493,-0.08138048649050234,-1.195874676592573,0.06697824386540807,2961363600.0,1.0
AMZN,2023-11-02,138.07000732421875,138.80999755859375,136.47000122070312,138.72999572753906,52236700.0,1.07000732421875,0.0,1.07000732421875,69.60184666361582,118.3499984741211,138.80999755859375,96.38323427425475,-3.616765725745255,0.5940219331941705,-0.8378953546352242,0.10305991326980712,3013600300.0,1.0
AMZN,2023-11-03,138.60000610351562,139.49000549316406,137.4499969482422,138.99000549316406,44007200.0,0.529998779296875,0.0,0.529998779296875,70.43200021618902,118.3499984741211,139.49000549316406,95.78997590281439,-4.210024097185606,1.158692997299056,-0.43857768424836807,0.09513281271475749,3057607500.0,1.0
AMZN,2023-11-06,139.74000549316406,140.72999572753906,138.36000061035156,138.75999450683594,44970400.0,1.1399993896484375,0.0,1.1399993896484375,72.30885146969705,118.3499984741211,140.72999572753906,95.57645059932345,-4.4235494006765546,1.678834745304215,-0.01509519833785134,0.08696334899566871,3102577900.0,1.0
AMZN,2023-11-07,142.7100067138672,143.3699951171875,140.5,140.5500030517578,53553500.0,2.970001220703125,0.0,2.970001220703125,76.74601308947206,118.3499984741211,143.3699951171875,97.36215630747013,-2.6378436925298705,2.3041443632525898,0.44875271398023703,0.17563232087829483,3156131400.0,1.0
AMZN,2023-11-08,142.0800018310547,143.1199951171875,141.22000122070312,142.97000122070312,44521700.0,-0.6300048828125,0.6300048828125,0.0,73.8496826636638,118.3499984741211,143.3699951171875,94.84415084248103,-5.155849157518964,2.717544450899453,0.9025110613640805,0.18825794257491202,3111609700.0,-1.0
AMZN,2023-11-09,140.60000610351562,142.64999389648438,139.83999633789062,142.02000427246094,36235400.0,-1.4799957275390625,1.4799957275390625,0.0,66.99626316347522,118.3499984741211,143.3699951171875,88.92889933924312,-11.071100660756883,2.892401903686334,1.3004892298285313,0.10067330871150393,3075374300.0,-1.0
AMZN,2023-11-10,143.55999755859375,143.64999389648438,139.91000366210938,140.4600067138672,49287800.0,2.959991455078125,0.0,2.959991455078125,72.8176182661712,118.3499984741211,143.64999389648438,99.64428318508281,-0.3557168149171879,3.2325613129280555,1.6869036464484366,0.08175714185683036,3124662100.0,1.0
AMZN,2023-11-13,142.58999633789062,143.22999572753906,140.6699981689453,142.0800018310547,35680600.0,-0.970001220703125,0.970001220703125,0.0,68.26472910232613,118.3499984741211,143.64999389648438,95.8102855716061,-4.189714428393898,3.3848506522729735,2.0264930476133443,0.07138027095501065,3088981500.0,-1.0
AMZN,2023-11-14,145.8000030517578,147.25999450683594,144.67999267578125,145.0,56674600.0,3.2100067138671875,0.0,3.2100067138671875,74.38108681217022,118.3499984741211,147.25999450683594,94.94987320847092,-5.050126791529075,3.721660776771671,2.3655265934450096,0.06423359891794034,3145656100.0,1.0
AMZN,2023-11-15,143.1999969482422,147.2899932861328,142.58999633789062,147.05999755859375,63875700.0,-2.600006103515625,2.600006103515625,0.0,63.02829753342201,125.5199966430664,147.2899932861328,81.2126919220575,-18.787308077942498,3.735723370024118,2.6395659487608314,0.037154989149649875,3081780400.0,-1.0
AMZN,2023-11-16,142.8300018310547,143.32000732421875,139.52000427246094,140.91000366210938,49653500.0,-0.3699951171875,0.3699951171875,0.0,61.487323993174186,128.55999755859375,147.2899932861328,76.1879739859176,-23.812026014082406,3.674653445189591,2.8465834480465837,0.030519448349661804,3032126900.0,-1.0
AMZN,2023-11-17,145.17999267578125,145.22999572753906,142.5399932861328,142.66000366210938,49636700.0,2.3499908447265625,0.0,2.3499908447265625,67.33930732601576,131.7100067138672,147.2899932861328,86.45698055922824,-13.543019440771756,3.7723939025744357,3.0317455389521544,0.0389293471359089,3081763600.0,1.0
AMZN,2023-11-20,146.1300048828125,146.6300048828125,144.72999572753906,145.1300048828125,41951200.0,0.95001220703125,0.0,0.95001220703125,69.50100909069698,133.7100067138672,147.2899932861328,91.45810345873718,-8.541896541262819,3.8817653896610977,3.201749509093943,0.023964669666104,3123714800.0,1.0
AMZN,2023-11-21,143.89999389648438,144.0500030517578,141.5,143.91000366210938,71226000.0,-2.230010986328125,2.230010986328125,0.0,58.93585783696986,136.47000122070312,147.2899932861328,68.66911390370034,-31.330886096299672,3.745326044285008,3.310464816132156,0.012809628673807305,3052488800.0,-1.0
AMZN,2023-11-22,146.7100067138672,147.74000549316406,144.57000732421875,144.57000732421875,45669100.0,2.8100128173828125,0.0,2.8100128173828125,66.369016200061,137.4499969482422,147.74000549316406,89.99030200217686,-10.00969799782314,3.819907909615978,3.412353434828921,0.043456616963822414,3098157900.0,1.0
AMZN,2023-11-24,146.74000549316406,147.1999969482422,145.32000732421875,146.6999969482422,22378400.0,0.029998779296875,0.0,0.029998779296875,66.44383764766815,138.36000061035156,147.74000549316406,89.33902473939693,-10.660975260603063,3.8372023459346565,3.497323217050068,0.022151072643146197,3120536300.0,1.0
AMZN,2023-11-27,147.72999572753906,149.25999450683594,146.8800048828125,147.52999877929688,53762400.0,0.989990234375,0.0,0.989990234375,69.06454360924927,139.52000427246094,149.25999450683594,84.29157789196641,-15.708422108033588,3.8859968962662776,3.57505795289331,0.03604740529951589,3174298700.0,1.0
AMZN,2023-11-28,147.02999877929688,147.60000610351562,145.52999877929688,146.97999572753906,42711700.0,-0.6999969482421875,0.6999969482421875,0.0,64.92752028801809,139.52000427246094,149.25999450683594,77.10474370221833,-22.89525629778168,3.8241011675065977,3.6248665958159676,0.008436184511617872,3131587000.0,-1.0
AMZN,2023-11-29,146.32000732421875,148.5399932861328,145.97000122070312,147.85000610351562,40610900.0,-0.709991455078125,0.709991455078125,0.0,60.67407483455544,139.52000427246094,149.25999450683594,69.81529640305803,-30.184703596941976,3.6753903674464254,3.6349713501420595,0.02178778241946655,3090976100.0,-1.0
AMZN,2023-11-30,146.08999633789062,146.92999267578125,144.3300018310547,144.75999450683594,65814000.0,-0.230010986328125,0.230010986328125,0.0,59.22379551821379,139.52000427246094,149.25999450683594,67.45378493545557,-32.546215064544434,3.498645811595935,3.6077062424328346,0.022824297871899546,3025162100.0,-1.0
AMZN,2023-12-01,147.02999877929688,147.25,145.5500030517578,146.0,39924600.0,0.94000244140625,0.0,0.94000244140625,63.35427198589402,139.52000427246094,149.25999450683594,77.10474370221833,-22.89525629778168,3.395286074428128,3.5652222088318934,0.012742844722737345,3065086700.0,1.0
AMZN,2023-12-04,144.83999633789062,145.35000610351562,142.80999755859375,145.25,48294200.0,-2.19000244140625,2.19000244140625,0.0,49.79484681779172,139.52000427246094,149.25999450683594,54.620096503321214,-45.37990349667878,3.1009124551169123,3.472360258088898,-0.008827814287396873,3016792500.0,-1.0
AMZN,2023-12-05,146.8800048828125,148.57000732421875,143.1300048828125,143.5500030517578,46822400.0,2.040008544921875,0.0,2.040008544921875,59.18408234347467,139.52000427246094,149.25999450683594,75.5647637548565,-24.435236245143503,2.9976755437971576,3.3774233152305495,0.020708902798646456,3063614900.0,1.0
AMZN,2023-12-06,144.52000427246094,147.85000610351562,144.27999877929688,147.5800018310547,39679000.0,-2.3600006103515625,2.3600006103515625,0.0,47.36099734875926,139.52000427246094,149.25999450683594,51.33475372853741,-48.665246271462586,2.6943682222075154,3.2408122966259425,-0.014927423769242054,3023935900.0,-1.0
AMZN,2023-12-07,146.8800048828125,147.9199981689453,145.33999633789062,146.14999389648438,52352800.0,2.3600006103515625,0.0,2.3600006103515625,57.221505503656786,141.5,149.25999450683594,69.33000890752106,-30.669991092478945,2.614291386776898,3.115508114656134,0.0009540642252119369,3076288700.0,1.0
AMZN,2023-12-08,147.4199981689453,147.83999633789062,145.39999389648438,145.47999572753906,41858000.0,0.5399932861328125,0.0,0.5399932861328125,59.2374436741931,141.5,149.25999450683594,76.28869020113693,-23.711309798863063,2.564837018461219,3.0053738954171516,-0.0020984063328985947,3118146700.0,1.0
AMZN,2023-12-11,145.88999938964844,146.19000244140625,143.63999938964844,145.66000366210938,50907300.0,-1.529998779296875,1.529998779296875,0.0,51.32940834455262,141.5,149.25999450683594,56.5721971295366,-43.4278028704634,2.3748106219342446,2.8792612407205707,-0.0077535156030278385,3067239400.0,-1.0
AMZN,2023-12-12,147.47999572753906,147.5,145.3000030517578,145.52000427246094,44944300.0,1.589996337890625,0.0,1.589996337890625,58.04532902431683,142.80999755859375,149.25999450683594,72.40310664360892,-27.59689335639107,2.325703487826786,2.768549690141814,0.007927749762546066,3112183700.0,1.0
AMZN,2023-12-13,148.83999633789062,149.4600067138672,146.82000732421875,148.1199951171875,52766200.0,1.3600006103515625,0.0,1.3600006103515625,63.074090324089944,142.80999755859375,149.4600067138672,90.67654853550245,-9.32345146449755,2.3692155711857197,2.6886828663505953,0.018824013066846446,3164949900.0,1.0
AMZN,2023-12-14,147.4199981689453,150.5399932861328,145.52000427246094,149.92999267578125,58400800.0,-1.4199981689453125,1.4199981689453125,0.0,55.1152615331815,142.80999755859375,150.5399932861328,59.637815761370575,-40.36218423862943,2.2630304199278726,2.603552377066051,0.002652515764717256,3106549100.0,-1.0
AMZN,2023-12-15,149.97000122070312,150.57000732421875,147.8800048828125,148.3800048828125,110039100.0,2.5500030517578125,0.0,2.5500030517578125,64.41831470873163,142.80999755859375,150.57000732421875,92.26797231398459,-7.7320276860154165,2.3574664517614963,2.5543351920051403,0.03541842731647793,3216588200.0,1.0
AMZN,2023-12-18,154.07000732421875,154.85000610351562,150.0500030517578,150.55999755859375,62512800.0,4.100006103515625,0.0,4.100006103515625,74.30033886402198,142.80999755859375,154.85000610351562,93.52160942090148,-6.478390579098516,2.731655095196345,2.5897991726433816,0.048951540048917774,3279101000.0,1.0
AMZN,2023-12-19,153.7899932861328,155.1199951171875,152.69000244140625,154.39999389648438,43171300.0,-0.2800140380859375,0.2800140380859375,0.0,72.70904264303473,142.80999755859375,155.1199951171875,89.19575877473511,-10.80424122526489,2.971355561000877,2.6661104503148807,0.06414329324399493,3235929700.0,-1.0
AMZN,2023-12-20,152.1199951171875,155.6300048828125,151.55999755859375,152.89999389648438,50322100.0,-1.6699981689453125,1.6699981689453125,0.0,63.369518646032844,142.80999755859375,155.6300048828125,72.62084430330931,-27.379155696690678,2.9920742422594913,2.731303208703803,0.0356753135905441,3185607600.0,-1.0
AMZN,2023-12-21,153.83999633789062,153.97000122070312,152.10000610351562,153.3000030517578,36305700.0,1.720001220703125,0.0,1.720001220703125,68.22063991013533,142.80999755859375,155.6300048828125,86.03738282161272,-13.962617178387282,3.111417189714672,2.807326004905977,0.04354903166928481,3221913300.0,1.0
AMZN,2023-12-22,153.4199981689453,154.35000610351562,152.7100067138672,153.77000427246094,29480100.0,-0.4199981689453125,0.4199981689453125,0.0,65.7666554387343,143.1300048828125,155.6300048828125,82.3199462890625,-17.6800537109375,3.1359576257854656,2.873052329081875,0.0516142217478901,3192433200.0,-1.0
AMZN,2023-12-26,153.41000366210938,153.97999572753906,153.02999877929688,153.55999755859375,25067200.0,-0.0099945068359375,0.0099945068359375,0.0,65.7017628763897,143.63999938964844,155.6300048828125,81.48456877714669,-18.515431222853305,3.1186497717254156,2.9221718176105833,0.040208896842699016,3167366000.0,-1.0
AMZN,2023-12-27,153.33999633789062,154.77999877929688,153.1199951171875,153.55999755859375,31434700.0,-0.07000732421875,0.07000732421875,0.0,65.18195059595271,143.63999938964844,155.6300048828125,80.90068810871279,-19.099311891287226,3.063964689014483,2.9505303918913635,0.030233808859980726,3135931300.0,-1.0
AMZN,2023-12-28,153.3800048828125,154.0800018310547,152.9499969482422,153.72000122070312,27057000.0,0.040008544921875,0.0,0.040008544921875,65.36265605800507,143.63999938964844,155.6300048828125,81.23437056569485,-18.765629434305154,2.9893948393171854,2.958303281376528,0.04042875313997052,3162988300.0,1.0
AMZN,2023-12-29,151.94000244140625,153.88999938964844,151.02999877929688,153.10000610351562,39789000.0,-1.44000244140625,1.44000244140625,0.0,53.77258418226083,143.63999938964844,155.6300048828125,69.22434736572845,-30.775652634271555,2.782032000618017,2.9230490252248265,0.013135968558165123,3123199300.0,-1.0
AMZN,2024-01-02,149.92999267578125,152.3800048828125,148.38999938964844,151.5399932861328,47339400.0,-2.010009765625,2.010009765625,0.0,41.82724376659269,145.3000030517578,155.6300048828125,44.82080158112342,-55.17919841887659,2.427521510355234,2.823943522250908,-0.026870996635480204,3075859900.0,-1.0
AMZN,2024-01-03,148.47000122070312,151.0500030517578,148.3300018310547,149.1999969482422,49425500.0,-1.459991455078125,1.459991455078125,0.0,35.262079511923275,145.52000427246094,155.6300048828125,29.17899871560547,-70.82100128439454,2.005640508629085,2.660282919526544,-0.034592576225239924,3026434400.0,-1.0
AMZN,2024-01-04,144.57000732421875,147.3800048828125,144.0500030517578,145.58999633789062,56039800.0,-3.899993896484375,3.899993896484375,0.0,23.765032958932764,144.0500030517578,155.6300048828125,4.490537048676583,-95.50946295132341,1.341140033954531,2.3964543424121416,-0.04963179092368841,2970394600.0,-1.0
AMZN,2024-01-05,145.24000549316406,146.58999633789062,144.52999877929688,144.69000244140625,45124800.0,0.6699981689453125,0.0,0.6699981689453125,28.393011876214246,144.0500030517578,155.6300048828125,10.276357972716024,-89.72364202728397,0.8586835042085283,2.088900174771419,-0.05590217790851826,3015519400.0,1.0
AMZN,2024-01-08,149.10000610351562,149.39999389648438,146.14999389648438,146.74000549316406,46757100.0,3.8600006103515625,0.0,3.8600006103515625,48.98156920068134,144.0500030517578,155.6300048828125,43.609691306049356,-56.390308693950644,0.7788252061824608,1.8268851810536273,-0.028157946271597067,3062276500.0,1.0
AMZN,2024-01-09,151.3699951171875,151.7100067138672,148.2100067138672,148.3300018310547,43812600.0,2.269989013671875,0.0,2.269989013671875,57.31028516012882,144.0500030517578,155.6300048828125,63.21235671828037,-36.78764328171963,0.8884644073247046,1.6392010263078427,-0.013297754359064218,3106089100.0,1.0
AMZN,2024-01-10,153.72999572753906,154.4199981689453,151.8800048828125,152.05999755859375,44421800.0,2.3600006103515625,0.0,2.3600006103515625,64.30129190333867,144.0500030517578,155.6300048828125,83.5923242241803,-16.4076757758197,1.1525012727795456,1.5418610756021836,0.002543363760026729,3150510900.0,1.0
AMZN,2024-01-11,155.17999267578125,157.1699981689453,153.1199951171875,155.0399932861328,49072700.0,1.4499969482421875,0.0,1.4499969482421875,68.01467774733896,144.0500030517578,157.1699981689453,84.83226955963491,-15.167730440365096,1.4619031173942005,1.525869483960587,0.011735478782544106,3199583600.0,1.0
AMZN,2024-01-12,154.6199951171875,156.1999969482422,154.00999450683594,155.38999938964844,40460300.0,-0.55999755859375,0.55999755859375,0.0,65.00161167779291,144.0500030517578,157.1699981689453,80.5639938964821,-19.436006103517897,1.6429799355105104,1.549291574270572,0.01763849304145393,3159123300.0,-1.0
AMZN,2024-01-16,153.16000366210938,154.99000549316406,152.14999389648438,153.52999877929688,41384600.0,-1.459991455078125,1.459991455078125,0.0,57.35779062206495,144.0500030517578,157.1699981689453,69.4360061035179,-30.563993896482106,1.649659264563951,1.569365112329248,0.02154346124269435,3117738700.0,-1.0
AMZN,2024-01-17,151.7100067138672,152.14999389648438,149.91000366210938,151.49000549316406,34953400.0,-1.4499969482421875,1.4499969482421875,0.0,50.54632383876226,144.0500030517578,157.1699981689453,58.384195982471,-41.61580401752901,1.5204235491242173,1.5595767996882421,0.021822627241362635,3082785300.0,-1.0
AMZN,2024-01-18,153.5,153.77999877929688,151.82000732421875,152.77000427246094,37850200.0,1.7899932861328125,0.0,1.7899932861328125,57.70128983062463,144.0500030517578,157.1699981689453,72.0274425701765,-27.972557429823503,1.5446352188373282,1.5565884835180595,0.061769331281518625,3120635500.0,1.0
AMZN,2024-01-19,155.33999633789062,155.75999450683594,152.74000549316406,153.8300018310547,51033700.0,1.839996337890625,0.0,1.839996337890625,63.896691384965145,144.0500030517578,157.1699981689453,86.0518101210469,-13.948189878953098,1.6927821298250763,1.583827212779463,0.06954000594004328,3171669200.0,1.0
AMZN,2024-01-22,154.77999877929688,157.0500030517578,153.89999389648438,156.88999938964844,43687500.0,-0.55999755859375,0.55999755859375,0.0,60.770933569619345,144.0500030517578,157.1699981689453,81.7835344578941,-18.2164655421059,1.744888512621941,1.616039472747959,0.03809518741292206,3127981700.0,-1.0
AMZN,2024-01-23,156.02000427246094,156.2100067138672,153.92999267578125,154.85000610351562,37986000.0,1.2400054931640625,0.0,1.2400054931640625,65.12929341639668,144.0500030517578,157.1699981689453,91.23479935615329,-8.765200643846704,1.8647456494516916,1.665780708088706,0.03071949068686619,3165967700.0,1.0
AMZN,2024-01-24,156.8699951171875,158.50999450683594,156.47999572753906,157.8000030517578,48547300.0,0.8499908447265625,0.0,0.8499908447265625,67.9459659056182,144.0500030517578,158.50999450683594,88.65836543027488,-11.341634569725109,2.00520568843379,1.7336657041577233,0.020425417790380873,3214515000.0,1.0
AMZN,2024-01-25,157.75,158.50999450683594,154.5500030517578,156.9499969482422,43638600.0,0.8800048828125,0.0,0.8800048828125,70.76675947571417,144.52999877929688,158.50999450683594,94.56370000643969,-5.436299993560309,2.1626012003571304,1.8194528033976047,0.016561460533048855,3258153600.0,1.0
AMZN,2024-01-26,159.1199951171875,160.72000122070312,157.91000366210938,158.4199981689453,51047400.0,1.3699951171875,0.0,1.3699951171875,74.75709795877096,146.14999389648438,160.72000122070312,89.01849485788492,-10.981505142115076,2.370559104228164,1.9296740635637166,0.02910360976657267,3309201000.0,1.0
AMZN,2024-01-29,161.25999450683594,161.2899932861328,158.89999389648438,159.33999633789062,45270400.0,2.1399993896484375,0.0,2.1399993896484375,79.74121939192305,148.2100067138672,161.2899932861328,99.77065129898158,-0.22934870101842023,2.6771863693500677,2.079176524720987,0.05288580994419534,3354471400.0,1.0
AMZN,2024-01-30,159.0,161.72999572753906,158.49000549316406,160.6999969482422,45207400.0,-2.2599945068359375,2.2599945068359375,0.0,64.27646698864794,149.91000366210938,161.72999572753906,76.90357394127557,-23.096426058724433,2.706627697668381,2.204666759310466,0.04805215848340261,3309264000.0,-1.0
AMZN,2024-01-31,155.1999969482422,159.00999450683594,154.80999755859375,157.0,50284400.0,-3.8000030517578125,3.8000030517578125,0.0,46.70382628151331,149.91000366210938,161.72999572753906,44.75462637242056,-55.24537362757944,2.3957153587727475,2.2428764792029225,0.01107489868561684,3258979600.0,-1.0
AMZN,2024-02-01,159.27999877929688,159.75999450683594,155.6199951171875,155.8699951171875,76542400.0,4.0800018310546875,0.0,4.0800018310546875,60.18797698972569,149.91000366210938,161.72999572753906,79.27243153227003,-20.727568467729963,2.450291702471162,2.2843595238565704,0.025363734609830102,3335522000.0,1.0
AMZN,2024-02-02,171.80999755859375,172.5,167.3300018310547,169.19000244140625,117154900.0,12.529998779296875,0.0,12.529998779296875,79.0079957037253,149.91000366210938,172.5,96.94553982618892,-3.0544601738110777,3.4646714561107785,2.5204219103074124,0.11002712826984973,3452676900.0,1.0
AMZN,2024-02-05,170.30999755859375,170.5500030517578,167.6999969482422,170.1999969482422,55081300.0,-1.5,1.5,0.0,74.1652212969066,149.91000366210938,172.5,90.30543250804818,-9.694567491951815,4.100271873280121,2.8363919029019544,0.09159077614930644,3397595600.0,-1.0
AMZN,2024-02-06,169.14999389648438,170.7100067138672,167.64999389648438,169.38999938964844,42505500.0,-1.160003662109375,1.160003662109375,0.0,70.31918792223509,151.82000732421875,172.5,83.80073844301268,-16.199261556987317,4.45898675843506,3.160910874008576,0.07828137414120073,3355090100.0,-1.0
AMZN,2024-02-07,170.52999877929688,170.8800048828125,168.94000244140625,169.47999572753906,47174100.0,1.3800048828125,0.0,1.3800048828125,72.2915818386543,152.74000549316406,172.5,90.03035542331955,-9.969644576680455,4.799302379810058,3.488589175168873,0.08101425533627182,3402264200.0,1.0
AMZN,2024-02-08,169.83999633789062,171.42999267578125,168.8800048828125,169.64999389648438,42316500.0,-0.69000244140625,0.69000244140625,0.0,69.62236084464097,153.89999389648438,172.5,85.6989097352683,-14.3010902647317,4.956195593483841,3.7821104588318666,0.067370547697718,3359947700.0,-1.0
AMZN,2024-02-09,174.4499969482422,175.0,170.5800018310547,170.89999389648438,56986000.0,4.6100006103515625,0.0,4.6100006103515625,76.35317867243228,153.92999267578125,175.0,97.38963995932922,-2.6103600406707783,5.39038610196306,4.103765587458105,0.08179339508068195,3416933700.0,1.0
AMZN,2024-02-12,172.33999633789062,175.38999938964844,171.5399932861328,174.8000030517578,51050400.0,-2.1100006103515625,2.1100006103515625,0.0,68.35462889361042,154.5500030517578,175.38999938964844,85.36466608579775,-14.635333914202246,5.500815812316574,4.3831756324298,0.08389934803704802,3365883300.0,-1.0
AMZN,2024-02-13,168.63999938964844,170.9499969482422,165.75,167.72999572753906,56345100.0,-3.6999969482421875,3.6999969482421875,0.0,56.40014020785768,154.5500030517578,175.38999938964844,67.61035899163109,-32.389641008368905,5.229491004758671,4.5524387068955745,0.08659795557784955,3309538200.0,-1.0
AMZN,2024-02-14,170.97999572753906,171.2100067138672,168.27999877929688,169.2100067138672,42815500.0,2.339996337890625,0.0,2.339996337890625,61.33467745557368,154.80999755859375,175.38999938964844,78.57141268347803,-21.428587316521973,5.1439856240278345,4.670748090322027,0.07345553137813643,3352353700.0,1.0
AMZN,2024-02-15,169.8000030517578,171.1699981689453,167.58999633789062,170.5800018310547,49855200.0,-1.17999267578125,1.17999267578125,0.0,57.54517416635203,154.80999755859375,175.38999938964844,72.83772672237829,-27.162273277621708,4.924242840213111,4.7214470403002435,-0.011698937986134639,3302498500.0,-1.0
AMZN,2024-02-16,169.50999450683594,170.4199981689453,167.1699981689453,168.74000549316406,48074600.0,-0.290008544921875,0.290008544921875,0.0,56.554293906643615,154.80999755859375,175.38999938964844,71.42855024463736,-28.571449755362632,4.67282837819684,4.711723307879563,-0.004697334644036877,3254423900.0,-1.0
AMZN,2024-02-20,167.0800018310547,168.7100067138672,165.74000549316406,167.8300018310547,41980300.0,-2.42999267578125,2.42999267578125,0.0,48.48298936087533,154.80999755859375,175.38999938964844,59.62100670926967,-40.37899329073033,4.228754060564,4.61512945841645,-0.012237612415738397,3212443600.0,-1.0
AMZN,2024-02-21,168.58999633789062,170.22999572753906,167.13999938964844,168.94000244140625,44575600.0,1.5099945068359375,0.0,1.5099945068359375,53.26528137933808,155.6199951171875,175.38999938964844,65.60444318552815,-34.395556814471846,3.9530970594246924,4.482722978618098,-0.011376311823687035,3257019200.0,1.0
AMZN,2024-02-22,174.5800018310547,174.8000030517578,171.77000427246094,173.10000610351562,55392400.0,5.9900054931640625,0.0,5.9900054931640625,67.20137003348428,165.74000549316406,175.38999938964844,91.60623760716736,-8.393762392832633,4.169912131383654,4.42016080917121,0.02790865282247168,3312411600.0,1.0
AMZN,2024-02-23,174.99000549316406,175.75,173.6999969482422,174.27999877929688,59715200.0,0.410003662109375,0.0,0.410003662109375,67.9560379699474,165.74000549316406,175.75,92.40764311791652,-7.592356882083489,4.324967968427046,4.401122241022377,0.0030954918565122558,3372126800.0,1.0
AMZN,2024-02-26,174.72999572753906,176.3699951171875,174.25999450683594,175.6999969482422,44368600.0,-0.260009765625,0.260009765625,0.0,66.83084508061285,165.74000549316406,176.3699951171875,84.57195681600581,-15.42804318399419,4.376421557816599,4.3961821043812215,0.013867932229513213,3327758200.0,-1.0
AMZN,2024-02-27,173.5399932861328,174.6199951171875,172.86000061035156,174.0800018310547,31141700.0,-1.19000244140625,1.19000244140625,0.0,61.45709965175978,165.74000549316406,176.3699951171875,73.37719103075159,-26.622808969248414,4.271931479444788,4.371331979393935,0.02905594114218868,3296616500.0,-1.0
AMZN,2024-02-28,173.16000366210938,174.0500030517578,172.27000427246094,172.44000244140625,28180500.0,-0.3799896240234375,0.3799896240234375,0.0,59.68876474692528,165.74000549316406,176.3699951171875,69.80249681689578,-30.197503183104214,4.111070491004085,4.319279681715965,0.012750075968209762,3268436000.0,-1.0
AMZN,2024-02-29,176.75999450683594,177.22000122070312,172.85000610351562,173.00999450683594,53805400.0,3.5999908447265625,0.0,3.5999908447265625,69.334242114382,165.74000549316406,177.22000122070312,95.99297138444321,-4.007028615556793,4.2253687527338,4.300497495919532,0.04098934823314826,3322241400.0,1.0
AMZN,2024-03-01,178.22000122070312,178.72999572753906,176.07000732421875,176.75,31956200.0,1.4600067138671875,0.0,1.4600067138671875,72.42211836027226,165.74000549316406,178.72999572753906,96.07394233841411,-3.9260576615858813,4.383234094480258,4.317044815631678,0.051383440482124065,3354197600.0,1.0
AMZN,2024-03-04,177.5800018310547,180.13999938964844,177.49000549316406,177.52999877929688,37381500.0,-0.6399993896484375,0.6399993896484375,0.0,68.91236996779115,165.74000549316406,180.13999938964844,82.22223164123182,-17.777768358768192,4.405912298731579,4.334818312251659,0.0628441458279203,3316816100.0,-1.0
AMZN,2024-03-05,174.1199951171875,176.92999267578125,173.3000030517578,176.92999267578125,37228300.0,-3.4600067138671875,3.4600067138671875,0.0,52.91555832339951,165.74000549316406,180.13999938964844,58.19439705505246,-41.80560294494754,4.0974583642184825,4.287346322645024,0.032801464496230004,3279587800.0,-1.0
AMZN,2024-03-06,173.50999450683594,176.4600067138672,173.25999450683594,175.5399932861328,32090900.0,-0.6100006103515625,0.6100006103515625,0.0,50.529492520170244,165.74000549316406,180.13999938964844,53.95827990988834,-46.04172009011167,3.7604364766463334,4.181964353445286,-0.006129037192096121,3247496900.0,-1.0
AMZN,2024-03-07,176.82000732421875,177.99000549316406,173.72000122070312,174.8300018310547,34063300.0,3.3100128173828125,0.0,3.3100128173828125,61.42118224573209,165.74000549316406,180.13999938964844,76.94448977342809,-23.055510226571922,3.7175806188053,4.089087606517289,0.010457750577796077,3281560200.0,1.0
AMZN,2024-03-08,175.35000610351562,178.7899932861328,174.3300018310547,176.44000244140625,37853500.0,-1.470001220703125,1.470001220703125,0.0,55.19419178465248,165.74000549316406,180.13999938964844,66.73614363612859,-33.263856363871405,3.5243734462662815,3.9761447744670875,0.0035483911814624403,3243706700.0,-1.0
AMZN,2024-03-11,171.9600067138672,174.47000122070312,171.47000122070312,174.30999755859375,28484800.0,-3.3899993896484375,3.3899993896484375,0.0,43.46794629213305,167.13999938964844,180.13999938964844,37.07697941706731,-62.923020582932686,3.06240920369234,3.793397660312138,-0.009104452191954104,3215221900.0,-1.0
AMZN,2024-03-12,175.38999938964844,176.75999450683594,171.97999572753906,173.5,36610600.0,3.42999267578125,0.0,3.42999267578125,54.70302840057905,171.47000122070312,180.13999938964844,45.21336789880974,-54.78663210119026,2.93918980596942,3.622556089443594,0.012878237932418157,3251832500.0,1.0
AMZN,2024-03-13,176.55999755859375,177.6199951171875,175.5500030517578,175.89999389648438,30772600.0,1.1699981689453125,0.0,1.1699981689453125,57.98914454447423,171.47000122070312,180.13999938964844,58.708159317983025,-41.291840682016975,2.9024885385414905,3.478542579263174,-0.0011314604800717332,3282605100.0,1.0
AMZN,2024-03-14,178.75,179.52999877929688,176.47000122070312,177.69000244140625,43705800.0,2.19000244140625,0.0,2.19000244140625,63.679879351737696,171.47000122070312,180.13999938964844,83.967708382832,-16.03229161716799,3.0153582412837636,3.385905711667292,0.0029738456720160844,3326310900.0,1.0
AMZN,2024-03-15,174.4199981689453,177.92999267578125,173.89999389648438,176.63999938964844,72115500.0,-4.3300018310546875,4.3300018310546875,0.0,48.64668000041481,171.47000122070312,180.13999938964844,34.02534684273236,-65.97465315726764,2.7240126117095826,3.25352709167575,-0.017794817150163844,3254195400.0,-1.0
AMZN,2024-03-18,174.47999572753906,176.69000244140625,174.27999877929688,175.8000030517578,31250700.0,0.05999755859375,0.0,0.05999755859375,48.839776775499644,171.47000122070312,180.13999938964844,34.717360352131394,-65.2826396478686,2.4694936175810653,3.0967203968568136,0.0020675431911727493,3285446100.0,1.0
AMZN,2024-03-19,175.89999389648438,176.08999633789062,173.52000427246094,174.22000122070312,26880900.0,1.4199981689453125,0.0,1.4199981689453125,53.603970603487944,171.47000122070312,180.13999938964844,51.095658723998895,-48.904341276001105,2.355217979047694,2.94841991329499,0.013774419141914462,3312327000.0,1.0
AMZN,2024-03-20,178.14999389648438,178.52999877929688,174.63999938964844,176.13999938964844,29947200.0,2.25,0.0,2.25,60.35391160465691,171.47000122070312,180.13999938964844,77.04722129824691,-22.95277870175309,2.418332872173437,2.84240250507068,0.007521697303331409,3342274200.0,1.0
AMZN,2024-03-22,178.8699951171875,179.25999450683594,176.75,177.75,27964100.0,0.720001220703125,0.0,0.720001220703125,62.66783444592869,171.47000122070312,181.4199981689453,74.371820765148,-25.628179234852006,2.486999708706662,2.7069731471535263,0.04018369465882943,3370238300.0,1.0
AMZN,2024-03-25,179.7100067138672,180.9900054931641,177.24000549316406,178.00999450683594,29815500.0,0.8400115966796875,0.0,0.8400115966796875,65.38730232157981,171.47000122070312,181.4199981689453,82.8141509593104,-17.185849040689604,2.5623161034134796,2.678041738405517,0.024630864583227385,3400053800.0,1.0
AMZN,2024-03-26,178.3000030517578,180.4499969482422,177.9499969482422,180.1499938964844,29659000.0,-1.410003662109375,1.410003662109375,0.0,57.30269936081187,171.47000122070312,181.4199981689453,68.64325553648845,-31.35674446351155,2.479645566637572,2.6383625040519285,0.009855038044994435,3370394800.0,-1.0
AMZN,2024-03-27,179.8300018310547,180.0,177.30999755859375,179.8800048828125,33272600.0,1.529998779296875,0.0,1.529998779296875,63.02638692062267,171.47000122070312,181.4199981689453,84.02013240645746,-15.97986759354254,2.508668318604464,2.6124236669624357,0.006041968285620536,3403667400.0,1.0
AMZN,2024-03-28,180.3800048828125,181.6999969482422,179.25999450683594,180.1699981689453,38051600.0,0.5500030517578125,0.0,0.5500030517578125,64.97393747406645,171.47000122070312,181.6999969482422,87.09684636645272,-12.903153633547273,2.546693016512421,2.599277536872433,0.03417043215477067,3441719000.0,1.0
AMZN,2024-04-01,180.97000122070312,183.0,179.9499969482422,180.7899932861328,29174500.0,0.589996337890625,0.0,0.589996337890625,67.11776711804559,171.97999572753906,183.0,81.57896558742853,-18.421034412571466,2.5945275387904303,2.598327537256033,0.03719627265064007,3470893500.0,1.0
AMZN,2024-04-02,180.69000244140625,180.7899932861328,178.3800048828125,179.07000732421875,32611500.0,-0.279998779296875,0.279998779296875,0.0,64.94119065327831,173.52000427246094,183.0,75.63292616384535,-24.367073836154653,2.580101378251868,2.5946823054552,0.027231430989933747,3438282000.0,-1.0
AMZN,2024-04-03,182.41000366210935,182.8699951171875,179.8000030517578,179.89999389648438,31046600.0,1.7200012207030966,0.0,1.7200012207030966,71.49357922543238,173.52000427246094,183.0,93.77640713300393,-6.223592866996071,2.676604040697981,2.6110666525037565,0.023912488978811153,3469328600.0,1.0
AMZN,2024-04-04,180.0,185.1000061035156,180.0,184.0,41624300.0,-2.4100036621093466,2.4100036621093466,0.0,54.90376676318411,173.52000427246094,185.1000061035156,55.95850347934609,-44.04149652065391,2.529457925230247,2.594744907049055,0.010384542053875068,3427704300.0,-1.0
AMZN,2024-04-05,185.07000732421875,186.2700042724609,181.97000122070312,182.3800048828125,42335200.0,5.07000732421875,0.0,5.07000732421875,71.15254549577674,173.52000427246094,186.2700042724609,90.58825922947324,-9.411740770526759,2.789791804499714,2.633754286539187,0.03466211425213772,3470039500.0,1.0
AMZN,2024-04-08,185.19000244140625,187.2899932861328,184.80999755859372,186.8999938964844,39221300.0,0.1199951171875,0.0,0.1199951171875,71.43363096375982,173.52000427246094,187.2899932861328,84.74950965725874,-15.250490342741266,2.971536855389587,2.7013108003092676,0.030493548065268605,3509260800.0,1.0
AMZN,2024-04-09,185.6699981689453,187.33999633789065,184.1999969482422,187.2400054931641,36546900.0,0.4799957275390625,0.0,0.4799957275390625,72.66305738346108,174.63999938964844,187.33999633789065,86.85040495874699,-13.149595041253,3.118356291128208,2.784719898473056,0.04133480084713237,3545807700.0,1.0
AMZN,2024-04-10,185.9499969482422,186.2700042724609,182.6699981689453,182.7700042724609,35879200.0,0.279998779296875,0.0,0.279998779296875,73.43265261263495,176.75,187.33999633789065,86.87441104511912,-13.125588954880888,3.220185024700612,2.8718129237185672,0.03403211396804107,3581686900.0,1.0
AMZN,2024-04-11,189.0500030517578,189.7700042724609,185.50999450683597,186.7400054931641,40020700.0,3.100006103515625,0.0,3.100006103515625,80.459998570645,176.75,189.7700042724609,94.47003852198422,-5.529961478015776,3.510562040461423,2.999562747067139,0.04806518424577022,3621707600.0,1.0
AMZN,2024-04-12,186.1300048828125,188.3800048828125,185.0800018310547,187.72000122070312,38554300.0,-2.9199981689453125,2.9199981689453125,0.0,62.494063002021306,177.24000549316406,189.7700042724609,70.94972271136425,-29.050277288635755,3.465124668501062,3.092675131353924,0.028513033250281428,3583153300.0,-1.0
AMZN,2024-04-15,183.6199951171875,188.69000244140625,183.0,187.42999267578125,48052400.0,-2.510009765625,2.510009765625,0.0,51.16308749615897,177.30999755859375,189.7700042724609,50.642007693070845,-49.35799230692916,3.189808288442407,3.112101762771621,0.016215577155307193,3535100900.0,-1.0
AMZN,2024-04-16,183.32000732421875,184.8300018310547,182.25999450683597,183.2700042724609,32891300.0,-0.29998779296875,0.29998779296875,0.0,49.91502618243258,177.30999755859375,189.7700042724609,48.23440230522716,-51.765597694772836,2.9138228301146682,3.072445976240231,0.004988781557151212,3502209600.0,-1.0
AMZN,2024-04-17,181.27999877929688,184.57000732421875,179.82000732421875,184.30999755859372,31359700.0,-2.040008544921875,2.040008544921875,0.0,41.895900551637745,178.3800048828125,189.7700042724609,25.460878418658922,-74.53912158134108,2.501653224364219,2.958287425865029,0.007111104329427187,3470849900.0,-1.0
AMZN,2024-04-18,179.22000122070312,182.38999938964844,178.64999389648438,181.47000122070312,30723800.0,-2.05999755859375,2.05999755859375,0.0,35.2900260473631,178.3800048828125,189.7700042724609,7.374858497833109,-92.62514150216688,1.9858891613458525,2.763807772961194,-0.03160969293780369,3440126100.0,-1.0
AMZN,2024-04-19,174.6300048828125,179.0,173.44000244140625,178.74000549316406,55950000.0,-4.589996337890625,4.589996337890625,0.0,25.110831365989583,173.44000244140625,189.7700042724609,7.287215603021122,-92.71278439697888,1.1930157384501854,2.4496493660589924,-0.05702250347955429,3384176100.0,-1.0
AMZN,2024-04-22,177.22999572753906,178.8699951171875,174.55999755859375,176.94000244140625,37924900.0,2.5999908447265625,0.0,2.5999908447265625,36.989821875146056,173.44000244140625,189.7700042724609,23.20877441008859,-76.7912255899114,0.7656296683711048,2.1128454265214147,-0.04545700718823997,3422101000.0,1.0
AMZN,2024-04-23,179.5399932861328,179.92999267578125,175.97999572753906,178.0800018310547,37046500.0,2.30999755859375,0.0,2.30999755859375,45.80284002019399,173.44000244140625,189.7700042724609,37.35450190291007,-62.64549809708993,0.6063312173608608,1.8115425846893038,-0.03447165241897554,3459147500.0,1.0
AMZN,2024-04-24,176.58999633789062,180.32000732421875,176.17999267578125,179.94000244140625,34185100.0,-2.9499969482421875,2.9499969482421875,0.0,37.9760796237575,173.44000244140625,189.7700042724609,19.289611410171748,-80.71038858982826,0.23928758930375693,1.4970915856121945,-0.06590852426728555,3424962400.0,-1.0
AMZN,2024-04-25,173.6699981689453,173.9199981689453,166.32000732421875,169.67999267578125,49249400.0,-2.9199981689453125,2.9199981689453125,0.0,31.774799265039505,166.32000732421875,189.7700042724609,31.343248619388532,-68.65675138061147,-0.2839434557201628,1.140884577345723,-0.06694249388599116,3375713000.0,-1.0
AMZN,2024-04-26,179.6199951171875,180.82000732421875,176.1300048828125,177.8000030517578,43919800.0,5.9499969482421875,0.0,5.9499969482421875,50.70188095955622,166.32000732421875,189.7700042724609,56.716373235885364,-43.28362676411464,-0.21600285460311852,0.8695070909559547,-0.021784119956256287,3419632800.0,1.0
AMZN,2024-04-29,180.9600067138672,183.52999877929688,179.38999938964844,182.75,54063900.0,1.3400115966796875,0.0,1.3400115966796875,54.016834315020404,166.32000732421875,189.7700042724609,62.430709146620465,-37.569290853379535,-0.053415955934667636,0.6849224815778302,-0.012873666354254909,3473696700.0,1.0
AMZN,2024-04-30,175.0,182.9900054931641,174.8000030517578,181.08999633789065,94639800.0,-5.9600067138671875,5.9600067138671875,0.0,40.15850900795252,166.32000732421875,189.7700042724609,37.01489895687135,-62.98510104312866,-0.4008664602957026,0.46776469320312364,-0.034642535423571985,3379056900.0,-1.0
AMZN,2024-05-01,179.0,185.1499938964844,176.55999755859375,181.63999938964844,94645100.0,4.0,0.0,4.0,50.076958927786464,166.32000732421875,188.69000244140625,56.68303729775449,-43.316962702245505,-0.34942891858085545,0.3043259708463278,-0.0012275483718594549,3473702000.0,1.0
AMZN,2024-05-02,184.72000122070312,185.1000061035156,179.91000366210938,180.8500061035156,54303500.0,5.720001220703125,0.0,5.720001220703125,60.79793604080983,166.32000732421875,188.69000244140625,82.25300810346239,-17.74699189653761,0.15114963932680325,0.2736907045424229,0.057779282229658335,3528005500.0,1.0
AMZN,2024-05-03,186.2100067138672,187.8699951171875,185.4199981689453,186.9900054931641,39172000.0,1.4900054931640625,0.0,1.4900054931640625,63.174870844606446,166.32000732421875,187.8699951171875,92.29703320824187,-7.702966791758126,0.6604791512239387,0.3510483938787261,0.05066868590423801,3567177500.0,1.0
AMZN,2024-05-06,188.6999969482422,188.75,184.8000030517578,186.27999877929688,34725300.0,2.489990234375,0.0,2.489990234375,67.02957111633793,166.32000732421875,188.75,99.77707058365738,-0.22292941634262423,1.2506313612790052,0.5309649873587821,0.051019293776574326,3601902800.0,1.0
AMZN,2024-05-07,188.75999450683597,189.94000244140625,187.30999755859372,188.9199981689453,34048900.0,0.05999755859377842,0.0,0.05999755859377842,67.12524484593783,166.32000732421875,189.94000244140625,95.00419907491163,-4.995800925088383,1.7035352472067586,0.7654790393283775,0.06891669076009843,3635951700.0,1.0
AMZN,2024-05-08,188.0,188.42999267578125,186.38999938964844,187.44000244140625,26136400.0,-0.7599945068359659,0.7599945068359659,0.0,64.39413478937908,166.32000732421875,189.94000244140625,91.786609473113,-8.213390526887,1.978334624556851,1.0080501563740722,0.08251282306754293,3609815300.0,-1.0
AMZN,2024-05-09,189.5,191.6999969482422,187.44000244140625,188.8800048828125,43368400.0,1.5,0.0,1.5,67.41352609585059,166.32000732421875,191.6999969482422,91.33176576967637,-8.66823423032364,2.2907462777564547,1.2645893806505488,0.0550050392572754,3653183700.0,1.0
AMZN,2024-05-10,187.47999572753903,189.88999938964844,186.92999267578125,189.16000366210935,34141800.0,-2.020004272460966,2.020004272460966,0.0,59.5648430014393,166.32000732421875,191.6999969482422,83.37272282921381,-16.627277170786193,2.3482679298645905,1.4813250904933573,0.036029999844005456,3619041900.0,-1.0
AMZN,2024-05-13,186.57000732421875,188.30999755859372,185.3600006103516,188.0,24898600.0,-0.9099884033202841,0.9099884033202841,0.0,56.16582570385358,166.32000732421875,191.6999969482422,79.7872666615764,-20.212733338423604,2.2939821957258744,1.643856511539861,0.06611432756696423,3594143300.0,-1.0
AMZN,2024-05-14,187.07000732421875,187.72000122070312,183.4499969482422,183.82000732421875,38698200.0,0.5,0.0,0.5,57.696292313948966,166.32000732421875,191.6999969482422,81.7573226285289,-18.242677371471103,2.2651944302813263,1.7681240952881545,0.045083839800104775,3632841500.0,1.0
AMZN,2024-05-15,185.9900054931641,186.72000122070312,182.72999572753903,185.97000122070312,75459900.0,-1.080001831054659,1.080001831054659,0.0,53.077544538358865,174.8000030517578,191.6999969482422,66.21305611083137,-33.78694388916861,2.1306717394325574,1.8406336241170351,0.006875293763903612,3557381600.0,-1.0
AMZN,2024-05-16,183.6300048828125,187.30999755859372,183.4600067138672,185.6000061035156,38834500.0,-2.360000610351591,2.360000610351591,0.0,44.16349050247635,174.8000030517578,191.6999969482422,52.248550414515535,-47.751449585484465,1.812733152449681,1.8350535297835644,-0.013855333967197292,3518547100.0,-1.0
AMZN,2024-05-17,184.6999969482422,185.3000030517578,183.3500061035156,183.75999450683597,33175700.0,1.0699920654296875,0.0,1.0699920654296875,48.672974827165426,174.8000030517578,191.6999969482422,58.57986669772599,-41.42013330227401,1.6283335336517837,1.7937095305572086,-0.021197668599311825,3551722800.0,1.0
AMZN,2024-05-20,183.5399932861328,186.6699981689453,183.27999877929688,184.33999633789065,30511800.0,-1.160003662109375,1.160003662109375,0.0,44.20690564145432,176.55999755859375,191.6999969482422,46.1030119480153,-53.89698805198469,1.3727684856658016,1.7095213215789271,-0.02765417128953196,3521211000.0,-1.0
AMZN,2024-05-21,183.1499938964844,183.25999450683597,180.75,182.3000030517578,50839100.0,-0.3899993896484091,0.3899993896484091,0.0,42.68744251244477,179.91000366210938,191.6999969482422,27.48084884989586,-72.51915115010414,1.1257843117371351,1.5927739196105688,-0.025797904805934024,3470371900.0,-1.0
AMZN,2024-05-22,183.1300048828125,185.22000122070312,181.97000122070312,183.8800048828125,28148800.0,-0.01998901367190342,0.01998901367190342,0.0,42.60084734997328,180.75,191.6999969482422,21.73521046683547,-78.26478953316453,0.9178541765230364,1.4577899709930624,-0.033614749958773116,3442223100.0,-1.0
AMZN,2024-05-23,181.0500030517578,184.75999450683597,180.0800018310547,183.66000366210935,33670200.0,-2.0800018310546875,2.0800018310546875,0.0,34.257050491933484,180.0800018310547,191.6999969482422,8.347690432919078,-91.65230956708092,0.5785600022794313,1.2819439772503363,-0.0342969533940346,3408552900.0,-1.0
AMZN,2024-05-24,180.75,182.44000244140625,180.3000030517578,181.6499938964844,27434100.0,-0.3000030517578125,0.3000030517578125,0.0,33.17567839557303,180.0800018310547,191.6999969482422,5.765907491254425,-94.23409250874558,0.2822060895291827,1.0819963997061055,-0.03119476387276343,3381118800.0,-1.0
AMZN,2024-05-28,182.1499938964844,182.2400054931641,179.49000549316406,179.92999267578125,29927000.0,1.3999938964844034,0.0,1.3999938964844034,42.883755397559376,179.49000549316406,191.6999969482422,21.785342054552004,-78.214657945448,0.1584843765295716,0.8972939950707987,-0.026300386139437415,3411045800.0,1.0
AMZN,2024-05-29,182.0200042724609,184.0800018310547,181.5500030517578,181.6999969482422,32009300.0,-0.12998962402349434,0.12998962402349434,0.0,42.22652975782309,179.49000549316406,191.6999969482422,20.720725224132917,-79.27927477586708,0.04937577808610172,0.7277103516738592,-0.021345239547557848,3379036500.0,-1.0
AMZN,2024-05-30,179.32000732421875,181.33999633789065,178.36000061035156,181.30999755859372,29249200.0,-2.699996948242159,2.699996948242159,0.0,30.883086979016113,178.36000061035156,189.88999938964844,8.326164921985628,-91.67383507801438,-0.252055225432656,0.5317572362525562,-0.023471096465658037,3349787300.0,-1.0
AMZN,2024-05-31,176.44000244140625,179.2100067138672,173.8699951171875,178.3000030517578,58903900.0,-2.8800048828125,2.8800048828125,0.0,23.209437394104256,173.8699951171875,188.30999755859372,17.797831646131446,-82.20216835386856,-0.715090672112666,0.2823876545795117,-0.044721140461905895,3290883400.0,-1.0
AMZN,2024-06-03,178.33999633789062,178.6999969482422,175.9199981689453,177.6999969482422,30786600.0,1.899993896484375,0.0,1.899993896484375,35.42355932619897,173.8699951171875,187.72000122070312,32.2743628218942,-67.72563717810579,-0.9181520853519203,0.04227970659322523,-0.028331683221408666,3321670000.0,1.0
AMZN,2024-06-04,179.33999633789062,179.82000732421875,176.44000244140625,177.63999938964844,27198400.0,1.0,0.0,1.0,41.111805003470465,173.8699951171875,187.30999755859372,40.6994064513786,-59.30059354862141,-0.9870104337832686,-0.1635783214820736,-0.020802608165781167,3348868400.0,1.0
AMZN,2024-06-05,181.27999877929688,181.5,178.75,180.10000610351562,32116400.0,1.94000244140625,0.0,1.94000244140625,50.81075240993945,173.8699951171875,187.30999755859372,55.13394580406094,-44.86605419593905,-0.8749532706040952,-0.30585331130647797,-0.010102146312394145,3380984800.0,1.0
AMZN,2024-06-06,185.0,185.0,181.4900054931641,181.75,31371200.0,3.720001220703125,0.0,3.720001220703125,63.94822285452709,173.8699951171875,186.6699981689453,86.953142415728,-13.046857584272006,-0.4804359853152107,-0.34076984610822453,0.021817160351623954,3412356000.0,1.0
AMZN,2024-06-07,184.3000030517578,186.2899932861328,183.3600006103516,184.8999938964844,28021500.0,-0.6999969482421875,0.6999969482421875,0.0,60.443206574564314,173.8699951171875,186.6699981689453,81.48441756143151,-18.515582438568487,-0.22170640456050705,-0.31695715779868106,0.01964040415910273,3384334500.0,-1.0
AMZN,2024-06-10,187.05999755859372,187.22999572753903,183.7899932861328,184.07000732421875,34494500.0,2.759994506835909,0.0,2.759994506835909,68.33827808029415,173.8699951171875,187.22999572753903,98.72755867381028,-1.2724413261897256,0.20369902711243526,-0.2128259208164578,0.026955826662830695,3418829000.0,1.0
AMZN,2024-06-11,187.22999572753903,187.7700042724609,184.5399932861328,187.05999755859372,27265100.0,0.1699981689453125,0.0,0.1699981689453125,68.78110744723222,173.8699951171875,187.7700042724609,96.11504899824467,-3.8849510017553164,0.5482336320471006,-0.06061401024374606,0.02862318059986113,3446094100.0,1.0
AMZN,2024-06-12,186.88999938964844,188.3500061035156,185.42999267578125,188.0200042724609,33984200.0,-0.3399963378905966,0.3399963378905966,0.0,66.6305397525972,173.8699951171875,188.3500061035156,89.91708835548754,-10.08291164451246,0.7847982598758847,0.10846844378018014,0.04221498860270945,3412109900.0,-1.0
AMZN,2024-06-13,183.8300018310547,187.6699981689453,182.6699981689453,186.08999633789065,39721500.0,-3.05999755859375,3.05999755859375,0.0,50.29869001953537,173.8699951171875,188.3500061035156,68.78452456473508,-31.21547543526492,0.7170949777471378,0.23019375057357175,0.0418839225084604,3372388400.0,-1.0
AMZN,2024-06-14,183.66000366210935,183.72000122070312,182.22999572753903,183.0800018310547,25456400.0,-0.16999816894534092,0.16999816894534092,0.0,49.520619106860465,173.8699951171875,188.3500061035156,67.61050495172614,-32.389495048273865,0.6423179657047626,0.31261859359981,0.02983070221746109,3346932000.0,-1.0
AMZN,2024-06-17,184.05999755859372,185.0,181.22000122070312,182.5200042724609,35601900.0,0.399993896484375,0.0,0.399993896484375,51.55516285812025,173.8699951171875,188.3500061035156,70.3728916437117,-29.627108356288296,0.6083204697705469,0.3717589688339574,0.026318731555063923,3382533900.0,1.0
AMZN,2024-06-18,182.80999755859372,184.2899932861328,181.42999267578125,183.7400054931641,36659200.0,-1.25,1.25,0.0,45.01333963418459,173.8699951171875,188.3500061035156,61.740301508384874,-38.259698491615126,0.47503672828625554,0.3924145207244171,0.00843997567078314,3345874700.0,-1.0
AMZN,2024-06-20,186.1000061035156,186.50999450683597,182.72000122070312,182.91000366210935,44726800.0,3.290008544921875,0.0,3.290008544921875,60.30862807248112,173.8699951171875,188.3500061035156,84.46133775641171,-15.53866224358829,0.6276494446294976,0.4394615055054332,0.005945978937922147,3390601500.0,1.0
AMZN,2024-06-21,189.0800018310547,189.27999877929688,185.8600006103516,187.8000030517578,72931800.0,2.979995727539091,0.0,2.979995727539091,69.24852962682284,175.9199981689453,189.27999877929688,98.50301692286432,-1.496983077135688,0.9777855688088835,0.5471263181661233,0.025935966902585816,3463533300.0,1.0
AMZN,2024-06-24,185.57000732421875,191.0,185.3300018310547,189.3300018310547,50610400.0,-3.5099945068359375,3.5099945068359375,0.0,53.01897347294655,176.44000244140625,191.0,62.70608800633827,-37.29391199366173,0.9609663257396619,0.6298943196808311,-0.007965306606551481,3412922900.0,-1.0
AMZN,2024-06-25,186.33999633789065,188.83999633789065,185.4199981689453,186.80999755859372,45898500.0,0.7699890136719034,0.0,0.7699890136719034,55.64994557082595,178.75,191.0,61.95915377869922,-38.04084622130079,0.9982612979214878,0.7035677153289625,-0.004753508572117537,3458821400.0,1.0
AMZN,2024-06-26,193.6100006103516,194.8000030517578,186.25999450683597,186.9199981689453,65103900.0,7.2700042724609375,0.0,7.2700042724609375,72.4548711361782,181.22000122070312,194.8000030517578,91.23709660565046,-8.762903394349545,1.596048169110162,0.8820638060852026,0.035956986690831805,3523925300.0,1.0
AMZN,2024-06-27,197.8500061035156,199.83999633789065,194.1999969482422,195.00999450683597,74397500.0,4.240005493164006,0.0,4.240005493164006,78.05150444715703,181.22000122070312,199.83999633789065,89.31261677647724,-10.687383223522758,2.3844451796771864,1.1825400808035995,0.07626613791445047,3598322800.0,1.0
AMZN,2024-06-28,193.25,198.8500061035156,192.5,197.72999572753903,76930200.0,-4.600006103515597,4.600006103515597,0.0,62.22494650931961,181.22000122070312,199.83999633789065,64.60795882912109,-35.39204117087891,2.608009926938678,1.4676340500306153,0.05221603041854417,3521392600.0,-1.0
AMZN,2024-07-01,197.1999969482422,198.3000030517578,192.82000732421875,193.4900054931641,41192000.0,3.9499969482421875,0.0,3.9499969482421875,68.54452000553376,181.22000122070312,199.83999633789065,85.82169665978286,-14.17830334021713,3.0685460532633044,1.7878164506771532,0.07138976183820422,3562584600.0,1.0
AMZN,2024-07-02,200.0,200.42999267578125,195.92999267578125,197.27999877929688,45600000.0,2.8000030517578125,0.0,2.8000030517578125,72.33061754837954,181.22000122070312,200.42999267578125,97.76161964055646,-2.2383803594435348,3.6177578366691137,2.1538047278755457,0.09403206974988665,3608184600.0,1.0
AMZN,2024-07-03,197.58999633789065,200.02999877929688,196.75999450683597,199.94000244140625,31597900.0,-2.4100036621093466,2.4100036621093466,0.0,64.60761313015863,181.22000122070312,200.42999267578125,85.21604580339441,-14.783954196605583,3.8145729550476517,2.485958373309967,0.06174094496259119,3576586700.0,-1.0
AMZN,2024-07-05,200.0,200.5500030517578,198.1699981689453,198.6499938964844,39858900.0,2.4100036621093466,0.0,2.4100036621093466,68.48969447333877,181.22000122070312,200.5500030517578,97.15466632354787,-2.845333676452131,4.117552921637241,2.812277282975422,0.05775332167969016,3616445600.0,1.0
AMZN,2024-07-08,199.2899932861328,201.1999969482422,197.9600067138672,200.0399932861328,34767300.0,-0.7100067138671875,0.7100067138671875,0.0,66.02777359301493,181.22000122070312,201.1999969482422,90.4404200673739,-9.559579932626093,4.251367996102516,3.1000954256008413,0.07393428582423445,3581678300.0,-1.0
AMZN,2024-07-09,199.33999633789065,200.57000732421875,199.0500030517578,199.3999938964844,32700100.0,0.05000305175784092,0.0,0.05000305175784092,66.12671728504526,181.42999267578125,201.1999969482422,90.59180471224045,-9.408195287759561,4.311749075711504,3.342426155622974,0.06976494716908266,3614378400.0,1.0
AMZN,2024-07-10,199.7899932861328,200.1100006103516,197.69000244140625,200.0,32883800.0,0.4499969482421591,0.0,0.4499969482421591,67.12107506312789,182.72000122070312,201.1999969482422,92.37010828953724,-7.6298917104627595,4.34581664021411,3.5431042525412018,0.03191980092091784,3647262200.0,1.0
AMZN,2024-07-11,195.0500030517578,200.2700042724609,192.8600006103516,200.08999633789065,44565000.0,-4.739990234375,4.739990234375,0.0,49.470841063499705,185.3300018310547,201.1999969482422,61.24766358734529,-38.75233641265471,3.944863896951631,3.6234561814232875,-0.014152150444174394,3602697200.0,-1.0
AMZN,2024-07-12,194.4900054931641,196.47000122070312,193.8300018310547,194.8000030517578,30598500.0,-0.5599975585937216,0.5599975585937216,0.0,47.75884800421475,185.3300018310547,201.1999969482422,57.71900743806121,-42.280992561938795,3.5410992484455903,3.6069847948277483,0.006416587286748099,3572098700.0,-1.0
AMZN,2024-07-15,192.72000122070312,196.19000244140625,190.8300018310547,194.55999755859372,40683200.0,-1.770004272460966,1.770004272460966,0.0,42.40675299748794,185.4199981689453,201.1999969482422,46.26111290537809,-53.7388870946219,3.043208094708149,3.494229454803829,-0.022718031424284968,3531415500.0,-1.0
AMZN,2024-07-16,193.0200042724609,196.6199951171875,192.2400054931641,195.58999633789065,33994700.0,0.3000030517577841,0.0,0.3000030517577841,43.64191928869228,186.25999450683597,201.1999969482422,45.247715267365514,-54.75228473263449,2.642373866197005,3.323858337082464,-0.03489997863769545,3565410200.0,1.0
AMZN,2024-07-17,187.92999267578125,191.5800018310547,185.9900054931641,191.3500061035156,48076100.0,-5.090011596679659,5.090011596679659,0.0,30.736977872038736,185.9900054931641,201.1999969482422,12.75468949701128,-87.24531050298872,1.8921766211474562,3.0375219938954627,-0.04888913326153532,3517334100.0,-1.0
AMZN,2024-07-18,183.75,189.67999267578125,181.4499969482422,189.58999633789065,51043600.0,-4.17999267578125,4.17999267578125,0.0,24.009648959901938,181.4499969482422,201.1999969482422,11.645585072191455,-88.35441492780855,0.9494052713039025,2.619898649377151,-0.08125000000000004,3466290500.0,-1.0
AMZN,2024-07-19,183.1300048828125,184.92999267578125,180.11000061035156,181.13999938964844,43081800.0,-0.6199951171875,0.6199951171875,0.0,23.142771867579327,180.11000061035156,201.1999969482422,14.319605485351126,-85.68039451464887,0.1504890161088781,2.1260167227234965,-0.08108780645156843,3423208700.0,-1.0
AMZN,2024-07-22,182.5500030517578,185.05999755859372,182.47999572753903,185.0,39931900.0,-0.5800018310546875,0.5800018310546875,0.0,22.27466748626523,180.11000061035156,201.1999969482422,11.569477786122242,-88.43052221387777,-0.5234254497389372,1.5961282882310097,-0.08422792010928415,3383276800.0,-1.0
AMZN,2024-07-23,186.41000366210935,189.38999938964844,183.55999755859372,184.1000061035156,47537700.0,3.860000610351534,0.0,3.860000610351534,39.65641997669479,180.11000061035156,201.1999969482422,29.87199689759594,-70.12800310240407,-0.7375358748653298,1.1293954556117418,-0.06697026915087323,3430814500.0,1.0
AMZN,2024-07-24,180.8300018310547,185.4499969482422,180.41000366210935,183.1999969482422,41532400.0,-5.580001831054659,5.580001831054659,0.0,28.882736975789996,180.11000061035156,201.1999969482422,3.4139466369160023,-96.586053363084,-1.3420095919018422,0.6351144461090249,-0.0729043886091596,3389282100.0,-1.0
AMZN,2024-07-25,179.85000610351562,183.8999938964844,176.8000030517578,182.91000366210935,44464200.0,-0.9799957275390625,0.9799957275390625,0.0,27.375602115092235,176.8000030517578,201.1999969482422,12.500015634009099,-87.4999843659909,-1.8784828516982088,0.13239498654757803,-0.07527378773282534,3344817900.0,-1.0
AMZN,2024-07-26,182.5,183.19000244140625,180.2400054931641,180.38999938964844,29506000.0,2.649993896484375,0.0,2.649993896484375,37.544080600045106,176.8000030517578,200.57000732421875,23.979789329890853,-76.02021067010915,-2.065993922739949,-0.3072827953099275,-0.05303030902848105,3374323900.0,1.0
AMZN,2024-07-29,183.1999969482422,184.75,182.3800048828125,183.83999633789065,33270100.0,0.6999969482421875,0.0,0.6999969482421875,40.10029508765109,176.8000030517578,200.2700042724609,27.268826432096148,-72.73117356790385,-2.1335200033517765,-0.6725302369182975,-0.050875593756371074,3407594000.0,1.0
AMZN,2024-07-30,181.7100067138672,185.8600006103516,179.3800048828125,184.72000122070312,39508600.0,-1.489990234375,1.489990234375,0.0,36.43753971859885,176.8000030517578,200.2700042724609,20.920338332910767,-79.07966166708923,-2.280971053828523,-0.9942184003003428,-0.03309735648553369,3368085400.0,-1.0
AMZN,2024-07-31,186.97999572753903,187.94000244140625,184.4600067138672,185.0500030517578,41667300.0,5.269989013671847,0.0,5.269989013671847,53.69747649706689,176.8000030517578,196.6199951171875,51.36224395133493,-48.637756048665075,-1.9501034250050964,-1.1853954052412936,0.01757820804102872,3409752700.0,1.0
AMZN,2024-08-01,184.07000732421875,190.6000061035156,181.8699951171875,189.2899932861328,70435600.0,-2.909988403320284,2.909988403320284,0.0,45.777560081594984,176.8000030517578,196.6199951171875,36.68015733034214,-63.31984266965787,-1.9007890764766273,-1.3284741394883606,0.005132978847501191,3339317100.0,-1.0
AMZN,2024-08-02,167.89999389648438,168.77000427246094,160.5500030517578,166.75,141448400.0,-16.170013427734375,16.170013427734375,0.0,23.52807020928546,160.5500030517578,196.6199951171875,20.377023735946324,-79.62297626405368,-3.1304066657225462,-1.6888606447351981,-0.08025203456786445,3197868700.0,-1.0
AMZN,2024-08-05,161.02000427246094,162.9600067138672,151.61000061035156,154.2100067138672,83149400.0,-6.8799896240234375,6.8799896240234375,0.0,18.99550913565851,151.61000061035156,191.5800018310547,23.54266543588522,-76.45733456411477,-4.606939200914553,-2.2724763559710697,-0.13620513325921524,3114719300.0,-1.0
AMZN,2024-08-06,161.92999267578125,165.0800018310547,158.5399932861328,161.7100067138672,59950800.0,0.9099884033203125,0.0,0.9099884033203125,21.30905492653511,151.61000061035156,190.6000061035156,26.468301132296716,-73.53169886770328,-5.638674286615924,-2.945715942100041,-0.10451810520320226,3174670100.0,1.0
AMZN,2024-08-07,162.77000427246094,167.5800018310547,161.42999267578125,166.5500030517578,48408200.0,0.8400115966796875,0.0,0.8400115966796875,23.6322014652538,151.61000061035156,190.6000061035156,28.622729135203674,-71.37727086479633,-6.315745872696766,-3.619721928219387,-0.09496803587109148,3223078300.0,1.0
AMZN,2024-08-08,165.8000030517578,166.69000244140625,162.5500030517578,165.1699981689453,44616200.0,3.029998779296875,0.0,3.029998779296875,31.988934033701227,151.61000061035156,190.6000061035156,36.393948300146114,-63.606051699853886,-6.532531447799727,-4.202283832135455,-0.09150683259310788,3267694500.0,1.0
AMZN,2024-08-09,166.94000244140625,168.5500030517578,165.85000610351562,166.39999389648438,36401000.0,1.1399993896484375,0.0,1.1399993896484375,35.073257505202506,151.61000061035156,190.6000061035156,39.317772945024174,-60.682227054975826,-6.536992771024671,-4.669225619913298,-0.08875543000925767,3304095500.0,1.0
AMZN,2024-08-12,166.8000030517578,168.5500030517578,166.11000061035156,168.13999938964844,30072800.0,-0.1399993896484375,0.1399993896484375,0.0,34.849311167035836,151.61000061035156,190.6000061035156,38.958708133727896,-61.041291866272104,-6.477160508098478,-5.030812597550335,-0.08205383914595121,3274022700.0,-1.0
AMZN,2024-08-13,170.22999572753906,171.0399932861328,167.10000610351562,167.80999755859375,39237900.0,3.42999267578125,0.0,3.42999267578125,44.81104608778493,151.61000061035156,190.6000061035156,47.75581557805133,-52.24418442194867,-6.082851934711101,-5.241220464982488,-0.08958177549863411,3313260600.0,1.0
AMZN,2024-08-14,170.10000610351562,172.27999877929688,168.86000061035156,172.11000061035156,28843800.0,-0.1299896240234375,0.1299896240234375,0.0,44.51342045067543,151.61000061035156,190.6000061035156,47.422423411573625,-52.577576588426375,-5.714970008934159,-5.335970373772823,-0.07589504354230037,3284416800.0,-1.0
AMZN,2024-08-15,177.58999633789062,177.91000366210938,173.99000549316406,174.86000061035156,51698500.0,7.489990234375,0.0,7.489990234375,61.50978569847027,151.61000061035156,190.6000061035156,66.63244951861839,-33.367550481381606,-4.764123467091167,-5.221600992436493,0.05771294099855928,3336115300.0,1.0
AMZN,2024-08-16,177.05999755859375,178.33999633789062,176.25999450683594,177.0399932861328,31489200.0,-0.529998779296875,0.529998779296875,0.0,60.0089752759298,151.61000061035156,190.6000061035156,65.27312993763039,-34.726870062369606,-4.00714532733366,-4.978709859415926,0.09961491032500303,3304626100.0,-1.0
AMZN,2024-08-19,178.22000122070312,178.3000030517578,176.16000366210938,177.63999938964844,31129800.0,1.160003662109375,0.0,1.160003662109375,62.33015039735106,151.61000061035156,190.6000061035156,68.24826073701628,-31.751739262983712,-3.275869907727639,-4.638141869078269,0.1005990815891531,3335755900.0,1.0
AMZN,2024-08-20,178.8800048828125,179.00999450683594,177.42999267578125,177.9199981689453,26255200.0,0.660003662109375,0.0,0.660003662109375,63.712866218589284,151.61000061035156,190.6000061035156,69.94101161961129,-30.05898838038871,-2.6129516098312706,-4.233103817228869,0.09897401356201363,3362011100.0,1.0
AMZN,2024-08-21,180.11000061035156,182.38999938964844,178.88999938964844,179.9199981689453,35599100.0,1.2299957275390625,0.0,1.2299957275390625,66.36749288656503,151.61000061035156,182.38999938964844,92.59259626471967,-7.407403735280324,-1.9656746333870387,-3.779617980460503,0.08630878947647913,3397610200.0,1.0
AMZN,2024-08-22,176.1300048828125,181.47000122070312,175.67999267578125,181.3800048828125,32047500.0,-3.9799957275390625,3.9799957275390625,0.0,52.129178507835555,151.61000061035156,182.38999938964844,79.66213529856762,-20.33786470143238,-1.7536404832884216,-3.374422481026087,0.05504973228110388,3365562700.0,-1.0
AMZN,2024-08-23,177.0399932861328,178.97000122070312,175.24000549316406,177.33999633789062,29150100.0,0.9099884033203125,0.0,0.9099884033203125,54.69345733835934,158.5399932861328,182.38999938964844,77.56811432124957,-22.43188567875043,-1.4949406869828863,-2.998526122217447,0.06139082762005432,3394712800.0,1.0
AMZN,2024-08-26,175.5,177.47000122070312,174.3000030517578,176.6999969482422,22366200.0,-1.5399932861328125,1.5399932861328125,0.0,49.51433474096381,161.42999267578125,182.38999938964844,67.12787603693849,-32.87212396306151,-1.3980677675520212,-2.678434451284362,0.030958141365965863,3372346600.0,-1.0
AMZN,2024-08-27,173.1199951171875,174.88999938964844,172.25,174.14999389648438,29842000.0,-2.3800048828125,2.3800048828125,0.0,42.361205777160606,162.5500030517578,182.38999938964844,53.27617951845591,-46.723820481544095,-1.496095724261579,-2.4419667058798056,0.01775419697418501,3342504600.0,-1.0
AMZN,2024-08-28,170.8000030517578,173.69000244140625,168.9199981689453,173.69000244140625,29045000.0,-2.3199920654296875,2.3199920654296875,0.0,36.44011870136574,165.85000610351562,182.38999938964844,29.927442306716546,-70.07255769328346,-1.7409193226380069,-2.301757229231446,-0.03823409778788367,3313459600.0,-1.0
AMZN,2024-08-29,172.1199951171875,174.2899932861328,170.80999755859375,173.22000122070312,26407800.0,1.3199920654296875,0.0,1.3199920654296875,41.78232572701216,166.11000061035156,182.38999938964844,36.916430942727054,-63.083569057272946,-1.8075946344069962,-2.202924710266556,-0.027900161016163327,3339867400.0,1.0
AMZN,2024-08-30,178.5,178.89999389648438,172.60000610351562,172.77999877929688,43377700.0,6.3800048828125,0.0,6.3800048828125,60.362258403420334,167.10000610351562,182.38999938964844,74.55852781062727,-25.441472189372732,-1.3302874990226599,-2.028397268017777,0.0015710850486985173,3383245100.0,1.0
AMZN,2024-09-03,176.25,178.25999450683594,175.25999450683594,177.5500030517578,36925919.0,-2.25,2.25,0.0,53.42421733355488,168.86000061035156,182.38999938964844,54.61936479223009,-45.38063520776991,-1.1206561251571259,-1.8468490394456467,-0.014702620812960365,3346319181.0,-1.0
