symbol,datetime,close,high,low,open,volume,change_in_price,down_days,up_days,RSI,low_14,high_14,k_percent,r_percent,MACD,MACD_EMA,Price_Rate_Of_Change,On Balance Volume,Prediction
KO,2021-01-22,48.4900016784668,48.93999862670898,48.4900016784668,48.810001373291016,15400300.0,-0.45999908447265625,0.45999908447265625,0.0,23.657503286309023,48.2400016784668,54.630001068115234,3.9123634409885977,-96.0876365590114,-0.33191915515720183,-0.2508221747107214,-0.05070477799030282,-161945900.0,-1.0
KO,2021-01-25,48.77999877929688,48.84000015258789,48.2400016784668,48.41999816894531,16604200.0,0.28999710083008523,0.0,0.28999710083008523,31.495927960388116,48.2400016784668,52.619998931884766,12.328708663200503,-87.6712913367995,-0.32620076132026554,-0.2664476651005774,-0.02828689167452958,-145341700.0,1.0
KO,2021-01-26,49.290000915527344,49.400001525878906,48.61000061035156,48.90999984741211,12922600.0,0.5100021362304616,0.0,0.5100021362304616,43.30764813733673,48.2400016784668,52.02000045776367,27.777766564672255,-72.22223343532774,-0.2868302296362373,-0.27064224493379596,-0.01636399291232149,-132419100.0,1.0
KO,2021-01-27,48.52999877929688,49.31999969482422,48.22999954223633,48.88999938964844,21242400.0,-0.7600021362304616,0.7600021362304616,0.0,33.40416252977279,48.22999954223633,51.130001068115234,10.344795834879188,-89.65520416512082,-0.3002775624645011,-0.2767058486572851,-0.0324960341521876,-153661500.0,-1.0
KO,2021-01-28,49.150001525878906,49.5,48.61000061035156,48.68999862670898,17498900.0,0.6200027465820241,0.0,0.6200027465820241,45.20004382486406,48.22999954223633,51.130001068115234,31.724189640340008,-68.27581035966,-0.26779868495912496,-0.2748917357650716,-0.0016249851127622117,-136162600.0,1.0
KO,2021-01-29,48.150001525878906,49.119998931884766,48.11000061035156,49.02999877929688,18670300.0,-1.0,1.0,0.0,33.99424149172006,48.11000061035156,50.86000061035156,1.4545787464488635,-98.54542125355114,-0.3037298782870792,-0.280743699961552,-0.011293618653885007,-154832900.0,-1.0
KO,2021-02-01,48.47999954223633,48.68999862670898,48.18000030517578,48.27000045776367,12183600.0,0.3299980163574219,0.0,0.3299980163574219,39.68761696367682,48.11000061035156,50.369998931884766,16.37164631315987,-83.62835368684013,-0.30624785308514646,-0.2859040250843189,-0.0006184040473066199,-142649300.0,1.0
KO,2021-02-02,48.959999084472656,49.34999847412109,48.630001068115234,48.79999923706055,13319800.0,0.4799995422363281,0.0,0.4799995422363281,47.314644515392786,48.11000061035156,50.36000061035156,37.7777099609375,-62.2222900390625,-0.27276637337871534,-0.2832520344469111,0.005751823696416469,-129329500.0,1.0
KO,2021-02-03,48.77000045776367,49.09000015258789,48.66999816894531,48.95000076293945,12274100.0,-0.18999862670898438,0.18999862670898438,0.0,44.73109999180811,48.11000061035156,50.18000030517578,31.884055300218563,-68.11594469978144,-0.2563389444599835,-0.2778294045028115,-0.003677227831874963,-141603600.0,-1.0
KO,2021-02-04,49.0099983215332,49.06999969482422,48.650001525878906,48.959999084472656,20597400.0,0.23999786376953125,0.0,0.23999786376953125,48.80536818668063,48.11000061035156,49.5,64.7480652066524,-35.25193479334761,-0.2242547910437338,-0.26705085649368054,0.010723790989211723,-121006200.0,1.0
KO,2021-02-05,49.650001525878906,49.77999877929688,49.27000045776367,49.5,12742000.0,0.6400032043457031,0.0,0.6400032043457031,58.270641876627394,48.11000061035156,49.77999877929688,92.21572479327477,-7.784275206725232,-0.1526905717743361,-0.2440702768306541,0.017835235103598857,-108264200.0,1.0
KO,2021-02-08,49.91999816894531,50.16999816894531,49.4900016784668,49.959999084472656,17833200.0,0.26999664306640625,0.0,0.26999664306640625,61.71611508412796,48.11000061035156,50.16999816894531,87.86406328701372,-12.135936712986283,-0.07647800507108116,-0.21042471313289668,0.012781441300795393,-90431000.0,1.0
KO,2021-02-09,49.70000076293945,50.02000045776367,49.630001068115234,49.84999847412109,14592900.0,-0.21999740600585938,0.21999740600585938,0.0,57.270372783895674,48.11000061035156,50.16999816894531,77.18456490178069,-22.81543509821931,-0.031701569483203684,-0.17457172539649593,0.024108840162215373,-105023900.0,-1.0
KO,2021-02-10,49.59999847412109,50.58000183105469,49.52999877929688,50.40999984741211,22965400.0,-0.10000228881836648,0.10000228881836648,0.0,55.1853546825892,48.11000061035156,50.58000183105469,60.3237703398937,-39.676229660106294,-0.003532342613311812,-0.14028093880528908,0.00915558360675206,-127989300.0,-1.0
KO,2021-02-11,50.29999923706055,50.59000015258789,49.79999923706055,49.810001373291016,21928600.0,0.7000007629394602,0.0,0.7000007629394602,65.36860257449966,48.11000061035156,50.59000015258789,88.30641253805084,-11.693587461949157,0.06852654087401078,-0.09843850783718466,0.04465207981408037,-106060700.0,1.0
KO,2021-02-12,50.68999862670898,50.84999847412109,50.38999938964844,50.56999969482422,13137100.0,0.3899993896484304,0.0,0.3899993896484304,69.78264160234838,48.11000061035156,50.84999847412109,94.16058495782946,-5.839415042170551,0.1520660357390895,-0.0482599515670294,0.04558579012665365,-92923600.0,1.0
KO,2021-02-16,50.27000045776367,50.720001220703125,50.15999984741211,50.619998931884766,15093400.0,-0.4199981689453054,0.4199981689453054,0.0,60.24163342746426,48.11000061035156,50.84999847412109,78.83217268062069,-21.16782731937931,0.18501274005870272,-0.0015475861343841864,0.026756564497291357,-108017000.0,-1.0
KO,2021-02-17,50.130001068115234,50.4900016784668,49.88999938964844,50.0,12794300.0,-0.1399993896484375,0.1399993896484375,0.0,57.23200766733125,48.11000061035156,50.84999847412109,73.72270192155102,-26.27729807844898,0.19836234543232933,0.038474035673416916,0.02788600774218497,-120811300.0,-1.0
KO,2021-02-18,50.77000045776367,50.84999847412109,50.02999877929688,50.15999984741211,12747100.0,0.6399993896484375,0.0,0.6399993896484375,66.15176611964068,48.11000061035156,50.84999847412109,97.08036209023322,-2.919637909766773,0.25360885063839333,0.08153511516845491,0.035911083381065634,-108064200.0,1.0
KO,2021-02-19,50.11000061035156,50.83000183105469,49.970001220703125,50.790000915527344,15968800.0,-0.6599998474121094,0.6599998474121094,0.0,52.99907303411835,48.18000030517578,50.84999847412109,72.28470519656439,-27.715294803435608,0.2449867931892129,0.11424618387554683,0.009264835253487202,-124033000.0,-1.0
KO,2021-02-22,50.630001068115234,50.880001068115234,49.66999816894531,49.84999847412109,14370900.0,0.5200004577636719,0.0,0.5200004577636719,60.194044744305856,48.630001068115234,50.880001068115234,88.88888888888889,-11.11111111111111,0.27413926474557826,0.14624102336054406,0.01422281500826661,-109662100.0,1.0
KO,2021-02-23,50.540000915527344,51.5099983215332,50.41999816894531,51.0,16222300.0,-0.09000015258789062,0.09000015258789062,0.0,58.408438524616855,48.650001525878906,51.5099983215332,66.08396878347034,-33.91603121652966,0.28704232929915463,0.17441271234296954,0.01690141126143141,-125884400.0,-1.0
KO,2021-02-24,50.709999084472656,50.900001525878906,50.130001068115234,50.38999938964844,14442000.0,0.1699981689453125,0.0,0.1699981689453125,60.934120549691436,48.650001525878906,51.5099983215332,72.02796736429467,-27.97203263570534,0.3066142788557542,0.2008616088031516,0.022379045252001628,-111442400.0,1.0
KO,2021-02-25,50.16999816894531,50.75,49.97999954223633,50.470001220703125,14211100.0,-0.5400009155273438,0.5400009155273438,0.0,49.84090343118494,49.27000045776367,51.5099983215332,40.178507566391126,-59.82149243360888,0.2776125725266638,0.216215787720602,-0.0025845143158461648,-125653500.0,-1.0
KO,2021-02-26,48.9900016784668,50.209999084472656,48.970001220703125,50.20000076293945,23638400.0,-1.1799964904785156,1.1799964904785156,0.0,34.160547548803194,48.970001220703125,51.5099983215332,0.7874204957610255,-99.21257950423897,0.16223784310860623,0.20541795617633055,-0.033537127526108046,-149291900.0,-1.0
KO,2021-03-01,49.900001525878906,50.43999862670898,49.400001525878906,49.43999862670898,13901200.0,0.9099998474121094,0.0,0.9099998474121094,48.56086786902699,48.970001220703125,51.5099983215332,36.614227034820416,-63.38577296517959,0.1393545621387844,0.1922030816711772,-0.007360233310434006,-135390700.0,1.0
KO,2021-03-02,50.09999847412109,50.560001373291016,49.70000076293945,49.84000015258789,11755100.0,0.1999969482421804,0.0,0.1999969482421804,51.26399118424803,48.970001220703125,51.5099983215332,44.48813162222412,-55.51186837777588,0.13512191184896238,0.18078533002722083,-0.0005984957780746925,-123635600.0,1.0
KO,2021-03-03,49.97999954223633,50.560001373291016,49.709999084472656,49.720001220703125,15410700.0,-0.11999893188475852,0.11999893188475852,0.0,49.46442785712166,48.970001220703125,51.5099983215332,39.76375883276138,-60.236241167238624,0.12106204298771672,0.1688394023103955,-0.01556038818996186,-139046300.0,-1.0
KO,2021-03-04,49.93999862670898,51.09000015258789,49.619998931884766,50.310001373291016,22036400.0,-0.040000915527350855,0.040000915527350855,0.0,48.80546096449339,48.970001220703125,51.5099983215332,38.188917841239046,-61.811082158760954,0.10559217555704237,0.15618888077237192,-0.0033925759643169684,-161082700.0,-1.0
KO,2021-03-05,50.790000915527344,50.95000076293945,49.900001525878906,50.04999923706055,21310800.0,0.8500022888183665,0.0,0.8500022888183665,61.41036069467227,48.970001220703125,51.5099983215332,71.65361307811878,-28.346386921881216,0.15778798462328325,0.15650872330990934,0.0031601786299955137,-139771900.0,1.0
KO,2021-03-08,51.63999938964844,52.4900016784668,51.15999984741211,51.470001220703125,25084900.0,0.8499984741210938,0.0,0.8499984741210938,69.94795856222031,48.970001220703125,52.4900016784668,75.85221084435929,-24.147789155640712,0.2625346303433389,0.1777150592993479,0.021764908076666423,-114687000.0,1.0
KO,2021-03-09,50.86000061035156,51.880001068115234,50.81999969482422,51.720001220703125,23082700.0,-0.779998779296875,0.779998779296875,0.0,56.67221520450735,48.970001220703125,52.4900016784668,53.69315749604171,-46.30684250395829,0.28113057419460574,0.19839906319383022,0.0029580265941049344,-137769700.0,-1.0
KO,2021-03-10,51.43999862670898,51.630001068115234,50.720001220703125,51.18000030517578,21331600.0,0.5799980163574148,0.0,0.5799980163574148,62.73972338786416,48.970001220703125,52.4900016784668,70.1703717270279,-29.829628272972098,0.33750010886030424,0.2262202417537097,0.02531394267719511,-116438100.0,1.0
KO,2021-03-11,50.880001068115234,51.43000030517578,50.810001373291016,51.40999984741211,17417700.0,-0.5599975585937429,0.5599975585937429,0.0,54.272664825717456,48.970001220703125,52.4900016784668,54.261352244981566,-45.73864775501844,0.33422179885613446,0.24782115531978152,0.03857928811786859,-133855800.0,-1.0
KO,2021-03-12,50.36000061035156,50.68000030517578,50.20000076293945,50.59000015258789,17598600.0,-0.5200004577636719,0.5200004577636719,0.0,47.416448868716905,48.970001220703125,52.4900016784668,39.4886138887474,-60.5113861112526,0.2873057319734116,0.25571824676153154,0.009218418244618665,-151454400.0,-1.0
KO,2021-03-15,51.02999877929688,51.119998931884766,50.470001220703125,50.5,13411900.0,0.6699981689453196,0.0,0.6699981689453196,55.73071056502444,48.970001220703125,52.4900016784668,58.522650303929666,-41.477349696070334,0.2995821977422395,0.26449119347227257,0.01856288090819369,-138042500.0,1.0
KO,2021-03-16,51.220001220703125,51.52000045776367,51.040000915527344,51.20000076293945,14214200.0,0.1900024414062429,0.0,0.1900024414062429,57.90843213810606,48.970001220703125,52.4900016784668,63.92044623282438,-36.07955376717562,0.32062950197988016,0.2757190154226238,0.02480995777958972,-123828300.0,1.0
KO,2021-03-17,51.2400016784668,51.619998931884766,51.150001525878906,51.25,17502700.0,0.020000457763671875,0.0,0.020000457763671875,58.15843008063032,48.970001220703125,52.4900016784668,64.48864098176423,-35.511359018235765,0.3350161344390301,0.2875785746381333,0.026031299309298594,-106325600.0,1.0
KO,2021-03-18,50.56999969482422,51.18999862670898,50.4900016784668,51.060001373291016,18007300.0,-0.6700019836425781,0.6700019836425781,0.0,47.29960362686947,49.400001525878906,52.4900016784668,37.8640165426993,-62.1359834573007,0.2899155797238038,0.28804597992472736,-0.004331585287210893,-124332900.0,-1.0
KO,2021-03-19,50.810001373291016,51.08000183105469,50.16999816894531,50.459999084472656,67845700.0,0.24000167846679688,0.0,0.24000167846679688,51.075198494984484,49.619998931884766,52.4900016784668,41.46346002015009,-58.53653997984991,0.2701215220567832,0.28446106215432254,-0.016072773550880437,-56487200.0,1.0
KO,2021-03-22,51.0,51.08000183105469,50.31999969482422,50.31999969482422,17911400.0,0.18999862670898438,0.0,0.18999862670898438,54.080270717997195,49.619998931884766,52.4900016784668,48.08361489405254,-51.91638510594747,0.26646737952664523,0.2808623045904268,0.002752642311607545,-38575800.0,1.0
KO,2021-03-23,51.38999938964844,51.650001525878906,50.83000183105469,50.9900016784668,16936700.0,0.3899993896484375,0.0,0.3899993896484375,59.912049805197135,49.619998931884766,52.4900016784668,61.672430797204505,-38.327569202795495,0.2912536114705233,0.28294057568611525,-0.00097199141515103,-21639100.0,1.0
KO,2021-03-24,51.52000045776367,51.88999938964844,51.150001525878906,51.16999816894531,14997400.0,0.13000106811523438,0.0,0.13000106811523438,61.779008026734985,49.900001525878906,52.4900016784668,62.54821762331119,-37.45178237668881,0.3175846261488715,0.28986941170251973,0.012578604092237322,-6641700.0,1.0
KO,2021-03-25,52.02000045776367,52.060001373291016,51.16999816894531,51.70000076293945,17091900.0,0.5,0.0,0.5,68.32541090924954,50.16999816894531,52.4900016784668,79.74135733958153,-20.258642660418467,0.3740099772980301,0.30669757519092944,0.032962665355307674,10450200.0,1.0
KO,2021-03-26,53.040000915527344,53.11000061035156,51.7599983215332,52.13999938964844,17126700.0,1.0200004577636719,0.0,1.0200004577636719,77.42626970306115,50.16999816894531,53.11000061035156,97.61905997633332,-2.380940023666674,0.4944381773627171,0.34424578553538837,0.03938863774862433,27576900.0,1.0
KO,2021-03-29,53.84999847412109,53.93999862670898,52.709999084472656,52.72999954223633,17514100.0,0.8099975585937429,0.0,0.8099975585937429,82.13072691060223,50.16999816894531,53.93999862670898,97.61272833793558,-2.387271662064413,0.6471084584330953,0.40481843614907603,0.05134707518036752,45091000.0,1.0
KO,2021-03-30,53.150001525878906,53.790000915527344,52.93000030517578,53.75,14871800.0,-0.6999969482421804,0.6999969482421804,0.0,67.99970519142585,50.16999816894531,53.93999862670898,79.04517228364764,-20.954827716352355,0.7039930236050793,0.46465344533716146,0.03727556176515057,30219200.0,-1.0
KO,2021-03-31,52.709999084472656,53.16999816894531,52.5,53.02999877929688,15826500.0,-0.44000244140625,0.44000244140625,0.0,60.455545267494045,50.16999816894531,53.93999862670898,67.3740214088476,-32.6259785911524,0.705719988338295,0.5128668130468049,0.04231756777857898,14392700.0,-1.0
KO,2021-04-01,52.5099983215332,53.150001525878906,52.459999084472656,52.959999084472656,15834700.0,-0.20000076293945312,0.20000076293945312,0.0,57.13123217533649,50.16999816894531,53.93999862670898,62.06896202808316,-37.93103797191684,0.683191372210203,0.5469317582902856,0.0334579197460092,-1442000.0,-1.0
KO,2021-04-05,52.810001373291016,53.220001220703125,52.290000915527344,52.34999847412109,16368700.0,0.3000030517578125,0.0,0.3000030517578125,60.856577214300515,50.16999816894531,53.93999862670898,70.0266016920256,-29.973398307974406,0.6815052944216617,0.5738464866348718,0.035490223005706145,14926700.0,1.0
KO,2021-04-06,53.18999862670898,53.650001525878906,52.900001525878906,53.040000915527344,15614300.0,0.37999725341796164,0.0,0.37999725341796164,65.26781347476918,50.16999816894531,53.93999862670898,80.10610321132708,-19.89389678867292,0.7025182372230958,0.5995808529062402,0.03502625527221004,30541000.0,1.0
KO,2021-04-07,53.27999877929688,53.5,53.119998931884766,53.27999877929688,10062700.0,0.09000015258790484,0.0,0.09000015258790484,66.30551171474636,50.16999816894531,53.93999862670898,82.49337487339187,-17.506625126608128,0.7181006577486144,0.623284825778095,0.034161457800763406,40603700.0,1.0
KO,2021-04-08,53.119998931884766,53.380001068115234,52.970001220703125,53.16999816894531,9695600.0,-0.15999984741211648,0.15999984741211648,0.0,62.476556641861755,50.16999816894531,53.93999862670898,78.24934760589845,-21.75065239410154,0.7094273435467997,0.6405133362531232,0.021145683668615245,30908100.0,-1.0
KO,2021-04-09,53.18000030517578,53.27999877929688,52.810001373291016,53.16999816894531,10828200.0,0.060001373291015625,0.0,0.060001373291015625,63.39131070726135,50.31999969482422,53.93999862670898,79.00556503375813,-20.99443496624187,0.6993017061340723,0.6522710140080851,0.0026395057924566423,41736300.0,1.0
KO,2021-04-12,53.34999847412109,53.54999923706055,53.09999847412109,53.33000183105469,8565300.0,0.1699981689453054,0.0,0.1699981689453054,66.09349894310394,50.83000183105469,53.93999862670898,81.0289144537924,-18.971085546207604,0.6968873053905398,0.6611942745788363,-0.009285051330879535,50301600.0,1.0
KO,2021-04-13,53.09000015258789,53.290000915527344,52.810001373291016,53.040000915527344,11071700.0,-0.259998321533196,0.259998321533196,0.0,58.47645186673605,51.150001525878906,53.93999862670898,69.5340732121837,-30.465926787816294,0.6664028124799088,0.6622359823733177,-0.0011289063324260162,39229900.0,-1.0
KO,2021-04-14,53.08000183105469,53.18999862670898,52.650001525878906,52.97999954223633,9787600.0,-0.009998321533203125,0.009998321533203125,0.0,58.178944178776284,51.16999816894531,53.93999862670898,68.95318940313099,-31.04681059686902,0.6341265924530362,0.6566141034641787,0.007019593113425593,29442300.0,-1.0
KO,2021-04-15,53.33000183105469,53.65999984741211,53.119998931884766,53.130001068115234,13078100.0,0.25,0.0,0.25,63.53187284926381,51.7599983215332,53.93999862670898,72.01849952928767,-27.981500470712344,0.6214737197244631,0.6495860257910568,0.015616140463390993,42520400.0,1.0
KO,2021-04-16,53.68000030517578,53.79999923706055,53.380001068115234,53.7400016784668,17974100.0,0.34999847412109375,0.0,0.34999847412109375,69.78018018442772,52.290000915527344,53.93999862670898,84.24250410947539,-15.75749589052461,0.6322928537649375,0.6461273910215961,0.01647413196858527,60494500.0,1.0
KO,2021-04-19,54.0,54.36000061035156,53.29999923706055,54.0,19352900.0,0.31999969482421875,0.0,0.31999969482421875,74.40626789170874,52.290000915527344,54.36000061035156,82.60866360262274,-17.39133639737726,0.6590003635642105,0.6487019857470282,0.015228452607710441,79847400.0,1.0
KO,2021-04-20,54.16999816894531,54.59000015258789,53.810001373291016,53.84000015258789,14419200.0,0.1699981689453125,0.0,0.1699981689453125,76.60183343458803,52.290000915527344,54.59000015258789,81.73903813205823,-18.260961867941774,0.6859291536554935,0.6561474198305425,0.01670419313136806,94266600.0,1.0
KO,2021-04-21,54.61000061035156,54.7400016784668,54.2400016784668,54.2400016784668,13866500.0,0.44000244140625,0.0,0.44000244140625,81.37378605442515,52.290000915527344,54.7400016784668,94.6938356068403,-5.306164393159705,0.7342042572902017,0.6717587881642375,0.02804973095683616,108133100.0,1.0
KO,2021-04-22,54.43999862670898,54.869998931884766,54.31999969482422,54.470001220703125,12558900.0,-0.17000198364258523,0.17000198364258523,0.0,74.59186729147001,52.290000915527344,54.869998931884766,83.33330869056692,-16.666691309433084,0.7501295809895794,0.6874329474054252,0.023693086015468934,95574200.0,-1.0
KO,2021-04-23,54.470001220703125,54.59000015258789,54.16999816894531,54.400001525878906,9020500.0,0.03000259399414773,0.0,0.03000259399414773,75.01588572860877,52.650001525878906,54.869998931884766,81.98206402856559,-18.017935971434415,0.7564417993388304,0.7012347182683878,0.020993491632906647,104594700.0,1.0
KO,2021-04-26,53.65999984741211,54.5099983215332,53.58000183105469,54.470001220703125,11684600.0,-0.8100013732910156,0.8100013732910156,0.0,49.35708509887847,52.650001525878906,54.869998931884766,45.49547304878866,-54.50452695121134,0.6882963860155016,0.6986470517463729,0.010736479434657387,92910100.0,-1.0
KO,2021-04-27,53.58000183105469,53.70000076293945,53.31999969482422,53.560001373291016,9852400.0,-0.07999801635742188,0.07999801635742188,0.0,47.50539865293764,52.650001525878906,54.869998931884766,41.89195458786615,-58.10804541213385,0.6206930349948507,0.6830562480517364,0.009419743458024321,83057700.0,-1.0
KO,2021-04-28,53.59000015258789,54.04999923706055,53.43999862670898,53.97999954223633,10868100.0,0.009998321533203125,0.0,0.009998321533203125,47.78787694873604,52.650001525878906,54.869998931884766,42.342329957952366,-57.657670042047634,0.5614491615669124,0.6587348303250493,0.0048752730659349375,93925800.0,1.0
KO,2021-04-29,54.2599983215332,54.36000061035156,53.43000030517578,53.540000915527344,15391000.0,0.6699981689453125,0.0,0.6699981689453125,63.12881613334658,52.650001525878906,54.869998931884766,72.52246292264576,-27.477537077354246,0.5619836929560549,0.6393846025777392,0.010804731986961302,109316800.0,1.0
KO,2021-04-30,53.97999954223633,54.27000045776367,53.68999862670898,54.25,14912600.0,-0.279998779296875,0.279998779296875,0.0,55.294628500714545,52.650001525878906,54.869998931884766,59.90989055930057,-40.09010944069943,0.5336979656618155,0.6182472749555372,-0.0003703788474753722,94404200.0,-1.0
KO,2021-05-03,54.47999954223633,54.79999923706055,54.15999984741211,54.27000045776367,10417900.0,0.5,0.0,0.5,64.39800378383327,52.650001525878906,54.869998931884766,82.4324393986518,-17.567560601348205,0.5452773828206858,0.6036532963965461,0.00572275030034497,104822100.0,1.0
KO,2021-05-04,54.13999938964844,54.619998931884766,53.93999862670898,54.56999969482422,14151000.0,-0.3400001525878906,0.3400001525878906,0.0,55.526450502328686,53.119998931884766,54.869998931884766,58.28574044363839,-41.714259556361604,0.521050683033387,0.5871327736043552,-0.008606504586158747,90671100.0,-1.0
KO,2021-05-05,54.0,54.2400016784668,53.709999084472656,54.13999938964844,9665900.0,-0.1399993896484375,0.1399993896484375,0.0,52.11539909260053,53.29999923706055,54.869998931884766,44.58604452262821,-55.41395547737179,0.48497771447411964,0.5667017616600206,-0.008082267410144839,81005200.0,-1.0
KO,2021-05-06,54.540000915527344,54.61000061035156,54.04999923706055,54.119998931884766,11572700.0,0.5400009155273438,0.0,0.5400009155273438,62.396374717980365,53.29999923706055,54.869998931884766,78.98101398074671,-21.01898601925329,0.4942115171925465,0.5522037126993754,0.0012851054388742789,92577900.0,1.0
KO,2021-05-07,54.5099983215332,54.77000045776367,54.15999984741211,54.43999862670898,10637500.0,-0.030002593994140625,0.030002593994140625,0.0,61.54919981012588,53.31999969482422,54.869998931884766,76.77414273865865,-23.225857261341346,0.493422159476296,0.5404474020111983,0.01584044868688328,81940400.0,-1.0
KO,2021-05-10,54.90999984741211,55.5,54.83000183105469,54.880001068115234,15545800.0,0.40000152587890625,0.0,0.40000152587890625,68.19262824654788,53.31999969482422,55.5,72.93577660575984,-27.064223394240155,0.5190547324547055,0.5361688680872171,0.024822657165094686,97486200.0,1.0
KO,2021-05-11,54.31999969482422,55.13999938964844,54.04999923706055,55.02999877929688,12986700.0,-0.5900001525878906,0.5900001525878906,0.0,52.696945828803734,53.31999969482422,55.5,45.87155321151968,-54.12844678848031,0.486201677028383,0.5261754298517516,0.013621935811863883,84499500.0,-1.0
KO,2021-05-12,54.040000915527344,54.560001373291016,53.880001068115234,54.36000061035156,15836500.0,-0.279998779296875,0.279998779296875,0.0,46.86547363539061,53.31999969482422,55.5,33.02757430784253,-66.97242569215747,0.4326051089855838,0.5074613656430148,-0.00405450447495781,68663000.0,-1.0
KO,2021-05-13,54.5099983215332,54.77999877929688,53.83000183105469,53.970001220703125,15475800.0,0.4699974060058594,0.0,0.4699974060058594,56.24369775071451,53.31999969482422,55.5,54.58708532671652,-45.412914673283474,0.42314433368775184,0.49059795922636845,0.009818428747524921,84138800.0,1.0
KO,2021-05-14,54.72999954223633,55.09999847412109,54.68999862670898,54.900001525878906,11725300.0,0.220001220703125,0.0,0.220001220703125,60.051879608476305,53.31999969482422,55.5,64.6788830287992,-35.32111697120079,0.4284455897803241,0.47816748532206693,0.004588839979820181,95864100.0,1.0
KO,2021-05-17,54.63999938964844,55.02000045776367,54.5,54.84000015258789,12119800.0,-0.09000015258789062,0.09000015258789062,0.0,57.682224566308214,53.43000030517578,55.5,58.45407066958083,-41.54592933041917,0.4205415076785073,0.4666422897821602,0.009235315951916956,83744300.0,-1.0
KO,2021-05-18,54.34000015258789,54.560001373291016,54.09999847412109,54.38999938964844,13232500.0,-0.2999992370605469,0.2999992370605469,0.0,50.08141387112717,53.43000030517578,55.5,43.96135176673952,-56.03864823326048,0.3856403596787388,0.45044190374888715,0.006296299121997917,70511800.0,-1.0
KO,2021-05-19,54.16999816894531,54.18000030517578,53.61000061035156,54.119998931884766,15126100.0,-0.17000198364257812,0.17000198364257812,0.0,46.10873999004341,53.61000061035156,55.5,29.629510023170763,-70.37048997682925,0.34034817381856186,0.42842315774913403,-0.0067840619796669666,55385700.0,-1.0
KO,2021-05-20,54.650001525878906,54.79999923706055,54.119998931884766,54.119998931884766,10948400.0,0.48000335693359375,0.0,0.48000335693359375,57.17583078332847,53.61000061035156,55.5,55.026521237173334,-44.97347876282667,0.33925300571796413,0.4105891273340308,0.0025683949487556035,66334100.0,1.0
KO,2021-05-21,54.619998931884766,55.119998931884766,54.220001220703125,54.79999923706055,16033200.0,-0.030002593994140625,0.030002593994140625,0.0,56.341371809887626,53.61000061035156,55.5,53.43908188886108,-46.560918111138925,0.3321364122318329,0.3948985843073486,-0.005281386201661298,50300900.0,-1.0
KO,2021-05-24,54.79999923706055,54.93000030517578,54.4900016784668,54.630001068115234,10326100.0,0.18000030517578125,0.0,0.18000030517578125,60.347504863329256,53.61000061035156,55.5,62.962910635137206,-37.037089364862794,0.33712736322020476,0.3833443400862423,0.008836515922920007,60627000.0,1.0
KO,2021-05-25,54.790000915527344,54.81999969482422,54.34999847412109,54.81999969482422,11916500.0,-0.009998321533203125,0.009998321533203125,0.0,59.99467143284218,53.61000061035156,55.5,62.43389874296602,-37.56610125703398,0.3363982137758441,0.3739551148217719,0.0138786082030673,48710500.0,-1.0
KO,2021-05-26,55.02999877929688,55.04999923706055,54.59000015258789,54.97999954223633,16064300.0,0.23999786376953836,0.0,0.23999786376953836,65.57005688778293,53.61000061035156,55.5,75.13220251406834,-24.86779748593166,0.351130130331029,0.3693901179226934,0.009539542721986427,64774800.0,1.0
KO,2021-05-27,55.4900016784668,55.56999969482422,54.77999877929688,55.209999084472656,59109600.0,0.46000289916991477,0.0,0.46000289916991477,73.68180213970318,53.61000061035156,55.56999969482422,95.9184666466849,-4.08153335331509,0.39535147651067604,0.37458238964113605,0.01388639032682537,123884400.0,1.0
KO,2021-05-28,55.290000915527344,55.709999084472656,55.20000076293945,55.34999847412109,17011600.0,-0.20000076293945312,0.20000076293945312,0.0,65.89355174788265,53.61000061035156,55.709999084472656,80.0000726609531,-19.999927339046906,0.4095432695765524,0.3815745656291309,0.011896074911048604,106872800.0,-1.0
KO,2021-06-01,55.27999877929688,55.650001525878906,55.09999847412109,55.34000015258789,13304000.0,-0.010002136230461645,0.010002136230461645,0.0,65.4940757377291,53.61000061035156,55.709999084472656,79.52378011342408,-20.476219886575915,0.41519710902363016,0.38829907430873206,0.01729846566193327,93568800.0,-1.0
KO,2021-06-02,55.5,55.560001373291016,55.2599983215332,55.5,11328500.0,0.2200012207031179,0.0,0.2200012207031179,70.09524552508236,53.61000061035156,55.709999084472656,90.00003633047655,-9.999963669523453,0.43243941619929416,0.3971271426875811,0.024552369872834046,104897300.0,1.0
KO,2021-06-03,55.63999938964844,55.7400016784668,55.09999847412109,55.18000030517578,17364300.0,0.1399993896484375,0.0,0.1399993896484375,72.76208801153592,53.61000061035156,55.7400016784668,95.30505921732481,-4.694940782675194,0.4521848142041449,0.40813867699162887,0.018115239453391885,122261600.0,1.0
KO,2021-06-04,56.2400016784668,56.47999954223633,55.77999877929688,55.900001525878906,18935100.0,0.6000022888183594,0.0,0.6000022888183594,81.09781930291898,53.61000061035156,56.47999954223633,91.63770198297874,-8.362298017021265,0.5103521717458435,0.4285813759435634,0.029659516262574348,141196700.0,1.0
KO,2021-06-07,56.040000915527344,56.34000015258789,55.810001373291016,56.310001373291016,14010800.0,-0.20000076293945312,0.20000076293945312,0.0,72.55741645676898,53.61000061035156,56.47999954223633,84.66903169124068,-15.330968308759319,0.5341579822392006,0.4496966972035929,0.02262776817026313,127185900.0,-1.0
KO,2021-06-08,55.650001525878906,56.25,55.54999923706055,56.25,10968300.0,-0.3899993896484375,0.3899993896484375,0.0,58.658516282696496,53.61000061035156,56.47999954223633,71.08019772633325,-28.91980227366675,0.5156177398786213,0.4628809057390492,0.015696305821886636,116217600.0,-1.0
KO,2021-06-09,55.47999954223633,55.91999816894531,55.47999954223633,55.75,9838800.0,-0.17000198364257812,0.17000198364257812,0.0,53.50362185294458,54.119998931884766,56.47999954223633,57.627129602689685,-42.372870397310315,0.4816572135185453,0.46663616729505114,0.008177371850292436,106378800.0,-1.0
KO,2021-06-10,55.90999984741211,56.119998931884766,55.7599983215332,55.90999984741211,12444400.0,0.43000030517578125,0.0,0.43000030517578125,62.99469588794889,54.220001220703125,56.47999954223633,74.77875583387488,-25.221244166125125,0.48385619652353284,0.47008017314082273,0.007568898112113365,118823200.0,1.0
KO,2021-06-11,56.15999984741211,56.209999084472656,55.65999984741211,55.9900016784668,11825800.0,0.25,0.0,0.25,67.45170598966749,54.34999847412109,56.47999954223633,84.9765476827965,-15.023452317203509,0.5000042581120923,0.47606499013518133,0.015735194745501335,130649000.0,1.0
KO,2021-06-14,55.54999923706055,55.709999084472656,55.20000076293945,55.68999862670898,9710800.0,-0.6100006103515625,0.6100006103515625,0.0,50.371218395833736,54.34999847412109,56.47999954223633,56.338035736352765,-43.66196426364724,0.4583047763479158,0.47251294737767846,0.004884234148441857,120938200.0,-1.0
KO,2021-06-15,55.40999984741211,55.790000915527344,55.18999862670898,55.77999877929688,11154200.0,-0.1399993896484375,0.1399993896484375,0.0,47.205695178910965,54.59000015258789,56.47999954223633,43.38624125041377,-56.61375874958624,0.40924502094740944,0.45985936209148287,-0.0016216243709530342,109784000.0,-1.0
KO,2021-06-16,54.66999816894531,55.459999084472656,54.63999938964844,55.43999862670898,15211700.0,-0.7400016784667969,0.7400016784667969,0.0,34.12588504095211,54.63999938964844,56.47999954223633,1.6303683048440432,-98.36963169515596,0.30712110417382377,0.4293117105076774,-0.01743352320890912,94572300.0,-1.0
KO,2021-06-17,54.95000076293945,55.150001525878906,54.650001525878906,54.66999816894531,10658400.0,0.2800025939941406,0.0,0.2800025939941406,41.23481750169281,54.63999938964844,56.47999954223633,16.847899325171817,-83.15210067482818,0.24594301258604645,0.3926379709230884,-0.022937426689680573,105230700.0,1.0
KO,2021-06-18,53.77000045776367,54.619998931884766,53.720001220703125,54.5099983215332,31445600.0,-1.1800003051757812,1.1800003051757812,0.0,27.043548270138714,53.720001220703125,56.47999954223633,1.8115676618517602,-98.18843233814823,0.10108923136968428,0.33432822301207327,-0.0405067883775625,73785100.0,-1.0
KO,2021-06-21,54.36000061035156,54.43000030517578,54.0,54.220001220703125,14404300.0,0.5900001525878906,0.0,0.5900001525878906,39.12952524921884,53.720001220703125,56.47999954223633,23.188397784709966,-76.81160221529004,0.03350810440596774,0.27416419929057617,-0.02318060880784445,88189400.0,1.0
KO,2021-06-22,54.560001373291016,54.84999847412109,54.2599983215332,54.34000015258789,13072800.0,0.20000076293945312,0.0,0.20000076293945312,42.833652829485125,53.720001220703125,56.47999954223633,30.434806645870104,-69.56519335412989,-0.0038690729988530848,0.2185575448324863,-0.016582519404040874,101262200.0,1.0
KO,2021-06-23,54.119998931884766,54.59999847412109,54.11000061035156,54.560001373291016,12339200.0,-0.44000244140625,0.44000244140625,0.0,37.10236543286035,53.720001220703125,56.47999954223633,14.49267950856718,-85.50732049143282,-0.06820553277120212,0.16120492931158026,-0.032015756043866195,88923000.0,-1.0
KO,2021-06-24,54.38999938964844,54.41999816894531,54.0,54.2599983215332,11488400.0,0.2700004577636719,0.0,0.2700004577636719,42.54549282999013,53.720001220703125,56.34000015258789,25.57245962170418,-74.42754037829582,-0.09629770165206253,0.10970440311873074,-0.03151710225378912,100411400.0,1.0
KO,2021-06-25,54.31999969482422,54.470001220703125,54.0099983215332,54.2400016784668,18880300.0,-0.06999969482421875,0.06999969482421875,0.0,41.47188055536639,53.720001220703125,56.25,23.715366150802744,-76.28463384919726,-0.12279333984952245,0.06320485452499273,-0.02214220628495933,81531100.0,-1.0
KO,2021-06-28,54.2599983215332,54.369998931884766,54.0,54.25,10556900.0,-0.060001373291015625,0.060001373291015625,0.0,40.46203585507726,53.720001220703125,56.209999084472656,21.68664916091908,-78.31335083908093,-0.14693870038230727,0.021176143543469566,-0.020754404061465004,70974200.0,-1.0
KO,2021-06-29,53.86000061035156,54.34000015258789,53.720001220703125,54.130001068115234,12300900.0,-0.3999977111816406,0.3999977111816406,0.0,34.078942528558926,53.720001220703125,56.209999084472656,5.622470271379941,-94.37752972862006,-0.19608780835147144,-0.022276646835570874,-0.01481612558483425,58673300.0,-1.0
KO,2021-06-30,54.11000061035156,54.18000030517578,53.75,53.79999923706055,14614200.0,0.25,0.0,0.25,40.81249022678482,53.720001220703125,56.209999084472656,15.662639527651217,-84.33736047234879,-0.21241857533359365,-0.060305032535212,-0.015286626768428069,73287500.0,1.0
KO,2021-07-01,53.959999084472656,54.47999954223633,53.86000061035156,54.34000015258789,13214700.0,-0.15000152587890625,0.15000152587890625,0.0,38.11697506835204,53.720001220703125,55.790000915527344,11.594101408305352,-88.40589859169464,-0.23475777278271437,-0.09519558058473933,0.0035335433344143574,60072800.0,-1.0
KO,2021-07-02,54.18000030517578,54.45000076293945,54.0,54.0,10604600.0,0.220001220703125,0.0,0.220001220703125,44.33829466497,53.720001220703125,55.790000915527344,22.22218127001795,-77.77781872998204,-0.23203569955128955,-0.12256360437806621,-0.0033112638549438467,70677400.0,1.0
KO,2021-07-06,53.880001068115234,54.09000015258789,53.54999923706055,53.9900016784668,15278200.0,-0.2999992370605469,0.2999992370605469,0.0,38.28270353374657,53.54999923706055,55.459999084472656,17.27758415802035,-82.72241584197964,-0.2511890166878601,-0.14828868684003765,-0.012463348388196072,55399200.0,-1.0
KO,2021-07-07,54.31999969482422,54.380001068115234,53.720001220703125,53.720001220703125,14377700.0,0.4399986267089844,0.0,0.4399986267089844,49.86939802879312,53.54999923706055,55.150001525878906,48.12495976692233,-51.87504023307768,-0.22823470345706198,-0.16427789016344882,0.0036955056704854883,69776900.0,1.0
KO,2021-07-08,54.130001068115234,54.16999816894531,53.7400016784668,54.0099983215332,11943900.0,-0.18999862670898438,0.18999862670898438,0.0,45.60361303472503,53.54999923706055,54.84999847412109,44.61555164956434,-55.384448350435655,-0.2228054799604493,-0.1759834081228526,-0.004780259688377364,57833000.0,-1.0
KO,2021-07-09,54.459999084472656,54.52000045776367,54.18000030517578,54.25,10847000.0,0.3299980163574219,0.0,0.3299980163574219,53.563909763788836,53.54999923706055,54.84999847412109,70.00002934384273,-29.999970656157277,-0.18968918225365883,-0.17872456294901454,0.0025773083658868767,68680000.0,1.0
KO,2021-07-12,54.47999954223633,54.59999847412109,54.27000045776367,54.31999969482422,15107600.0,0.020000457763671875,0.0,0.020000457763671875,54.03431211011857,53.54999923706055,54.84999847412109,71.53852699780253,-28.46147300219746,-0.15998624819836493,-0.17497689999888388,0.004054574779001063,83787600.0,1.0
KO,2021-07-13,55.02000045776367,55.29999923706055,54.75,54.95000076293945,15170800.0,0.5400009155273438,0.0,0.5400009155273438,65.06064661103677,53.54999923706055,55.29999923706055,84.00006975446429,-15.999930245535715,-0.09181606697801215,-0.15834473339470684,0.021537315898009224,98958400.0,1.0
KO,2021-07-14,56.2599983215332,56.34999847412109,54.959999084472656,55.02000045776367,22002700.0,1.2399978637695312,0.0,1.2399978637695312,78.63797201523025,53.54999923706055,56.34999847412109,96.78570796032193,-3.214292039678066,0.06155385298747973,-0.11436501611826387,0.0397338326913701,120961100.0,1.0
KO,2021-07-15,56.43999862670898,56.470001220703125,55.90999984741211,56.2400016784668,15068200.0,0.18000030517577414,0.0,0.18000030517577414,79.94341120191899,53.54999923706055,56.470001220703125,98.9725146023113,-1.0274853976886953,0.19537250687113783,-0.05241751152037714,0.045959962644809504,136029300.0,1.0
KO,2021-07-16,56.400001525878906,56.68000030517578,56.2599983215332,56.459999084472656,14860500.0,-0.03999710083007102,0.03999710083007102,0.0,78.71016952949954,53.54999923706055,56.68000030517578,91.0543551518505,-8.945644848149508,0.29479910401721554,0.01702581158714712,0.040974551646339785,121168800.0,-1.0
KO,2021-07-19,55.72999954223633,56.34999847412109,55.15999984741211,56.08000183105469,19527000.0,-0.6700019836425781,0.6700019836425781,0.0,60.63172944325993,53.54999923706055,56.68000030517578,69.6485482827165,-30.351451717283496,0.31589182106249325,0.07679901348222029,0.034335531504209094,101641800.0,-1.0
KO,2021-07-20,55.83000183105469,56.33000183105469,55.52000045776367,55.72999954223633,16257900.0,0.10000228881835938,0.0,0.10000228881835938,62.12972433129613,53.54999923706055,56.68000030517578,72.84350849653448,-27.156491503465524,0.3367947229326944,0.12879815537231784,0.02779827217808961,117899700.0,1.0
KO,2021-07-21,56.54999923706055,57.560001373291016,56.43000030517578,57.33000183105469,20918200.0,0.7199974060058594,0.0,0.7199974060058594,71.22551492966514,53.54999923706055,57.560001373291016,74.8129277262704,-25.187072273729594,0.4067678935893255,0.1843921030157217,0.04470715169393902,138817900.0,1.0
KO,2021-07-22,56.470001220703125,56.7400016784668,56.04999923706055,56.619998931884766,13402700.0,-0.07999801635742188,0.07999801635742188,0.0,69.09785247351707,53.54999923706055,57.560001373291016,72.81796578760614,-27.18203421239386,0.45057314165078566,0.23762831074273624,0.03690786210100305,125415200.0,-1.0
KO,2021-07-23,57.0099983215332,57.33000183105469,56.45000076293945,56.59000015258789,12144000.0,0.5399971008300781,0.0,0.5399971008300781,74.9305783278831,53.54999923706055,57.560001373291016,86.28422047987154,-13.715779520128462,0.5228345858516334,0.2946695657645172,0.04643903818933515,137559200.0,1.0
KO,2021-07-26,57.060001373291016,57.119998931884766,56.560001373291016,56.88999938964844,8681100.0,0.0500030517578125,0.0,0.0500030517578125,75.42615293290048,53.720001220703125,57.560001373291016,86.97916718406807,-13.020832815931923,0.5774801934644174,0.35123169130449844,0.037077442721821896,146240300.0,1.0
KO,2021-07-27,57.2599983215332,57.540000915527344,56.91999816894531,57.11000061035156,12794400.0,0.1999969482421875,0.0,0.1999969482421875,77.48060586091299,53.7400016784668,57.560001373291016,92.14651634228423,-7.853483657715775,0.6296666123864156,0.40691867552088284,0.017774618376006135,159034700.0,1.0
KO,2021-07-28,56.7400016784668,57.15999984741211,56.630001068115234,56.9900016784668,9858000.0,-0.5199966430664062,0.5199966430664062,0.0,61.94425112535146,54.18000030517578,57.560001373291016,75.73966166580328,-24.260338334196717,0.6218971198256469,0.4499143643818362,0.0053154333638811835,149176700.0,-1.0
KO,2021-07-29,57.04999923706055,57.25,56.86000061035156,57.06999969482422,9599100.0,0.30999755859375,0.0,0.30999755859375,66.55706700152852,54.27000045776367,57.560001373291016,84.49841962585832,-15.501580374141694,0.6334515453025205,0.48662180056597343,0.011524781801351303,158775800.0,1.0
KO,2021-07-30,57.02999877929688,57.25,56.900001525878906,57.150001525878906,11727000.0,-0.02000045776366477,0.02000045776366477,0.0,65.9618596218979,54.75,57.560001373291016,81.13870694043807,-18.86129305956194,0.6336898626856211,0.5160354129899032,0.02332674049414485,147048800.0,-1.0
KO,2021-08-02,56.880001068115234,57.2400016784668,56.709999084472656,57.20000076293945,9778000.0,-0.14999771118164773,0.14999771118164773,0.0,61.22393675105391,54.959999084472656,57.560001373291016,73.8461651322305,-26.153834867769504,0.6146895443733484,0.5357662392665924,0.018807078678555467,137270800.0,-1.0
KO,2021-08-03,56.91999816894531,57.0,56.75,57.0,8825500.0,0.039997100830078125,0.0,0.039997100830078125,62.062348443550455,55.15999984741211,57.560001373291016,73.33321677321322,-26.666783226786787,0.5959888510392588,0.5478107616211257,0.0065428636052444755,146096300.0,1.0
KO,2021-08-04,56.09999847412109,56.95000076293945,56.0099983215332,56.75,11888400.0,-0.8199996948242259,0.8199996948242259,0.0,41.06071086266539,55.15999984741211,57.560001373291016,39.16658454476356,-60.83341545523644,0.5091330109518069,0.540075211487262,-0.006552200081171411,134207900.0,-1.0
KO,2021-08-05,56.5,56.59000015258789,56.290000915527344,56.43999862670898,9806800.0,0.40000152587891336,0.0,0.40000152587891336,50.490634556997016,55.15999984741211,57.560001373291016,55.8333041933033,-44.1666958066967,0.4671901208949123,0.525498193368792,-0.008945769804391879,144014700.0,1.0
KO,2021-08-06,56.63999938964844,56.7400016784668,56.43999862670898,56.59999847412109,10409300.0,0.1399993896484375,0.0,0.1399993896484375,53.49540665019385,55.52000045776367,57.560001373291016,54.90188378642193,-45.09811621357807,0.44017271631295785,0.5084330979576251,-0.0073607075628142615,154424000.0,1.0
KO,2021-08-09,56.650001525878906,56.880001068115234,56.43000030517578,56.79999923706055,8859900.0,0.01000213623046875,0.0,0.01000213623046875,53.72691526637251,56.0099983215332,57.560001373291016,41.290448016853546,-58.709551983146454,0.4147869008439642,0.48970385853489296,-0.010653105370855398,163283900.0,1.0
KO,2021-08-10,56.79999923706055,57.16999816894531,56.65999984741211,56.84000015258789,10906900.0,0.14999771118164062,0.0,0.14999771118164062,57.39680683511392,56.0099983215332,57.540000915527344,51.63395922519391,-48.36604077480609,0.4021363460377927,0.4721903560354729,0.0010574119989235076,174190800.0,1.0
KO,2021-08-11,56.72999954223633,57.18000030517578,56.709999084472656,56.88999938964844,8370700.0,-0.06999969482421875,0.06999969482421875,0.0,55.046036220151,56.0099983215332,57.540000915527344,47.05882352941176,-52.94117647058824,0.3820582065586251,0.45416392614010337,-0.005609109537311641,165820100.0,-1.0
KO,2021-08-12,56.84000015258789,56.97999954223633,56.72999954223633,56.72999954223633,6169200.0,0.1100006103515625,0.0,0.1100006103515625,58.15364947401779,56.0099983215332,57.540000915527344,54.24839371598256,-45.75160628401744,0.37074844689786346,0.4374808302916553,-0.0033315558614033236,171989300.0,1.0
KO,2021-08-13,57.22999954223633,57.29999923706055,56.77000045776367,56.810001373291016,7714200.0,0.3899993896484375,0.0,0.3899993896484375,67.37883617432092,56.0099983215332,57.540000915527344,79.73850668568194,-20.261493314318056,0.38877333890269483,0.42773933201386316,0.006153278262107653,179703500.0,1.0
KO,2021-08-16,57.47999954223633,57.4900016784668,57.02999877929688,57.20000076293945,7972000.0,0.25,0.0,0.25,71.95224177053177,56.0099983215332,57.4900016784668,99.32418151731817,-0.6758184826818292,0.4184078415778103,0.42587303392665266,0.00983839408477949,187675500.0,1.0
KO,2021-08-17,57.27999877929688,57.560001373291016,57.0099983215332,57.459999084472656,10346400.0,-0.20000076293944602,0.20000076293944602,0.0,63.70761223218151,56.0099983215332,57.560001373291016,81.9353520835594,-18.064647916440606,0.4209031775444032,0.4248790626502028,0.021033874104651407,177329100.0,-1.0
KO,2021-08-18,56.5,57.22999954223633,56.41999816894531,57.18999862670898,13873700.0,-0.7799987792968821,0.7799987792968821,0.0,42.0337887804048,56.0099983215332,57.560001373291016,31.612949272009526,-68.38705072799047,0.3558397692242252,0.41107120396500724,0.0,163455400.0,-1.0
KO,2021-08-19,56.86000061035156,56.97999954223633,55.95000076293945,56.060001373291016,9223700.0,0.3600006103515625,0.0,0.3600006103515625,50.9250139535323,55.95000076293945,57.560001373291016,56.52170822552671,-43.47829177447329,0.32952687847491546,0.3947623388669889,0.00388420238477849,172679100.0,1.0
KO,2021-08-20,56.63999938964844,57.02999877929688,56.58000183105469,56.84000015258789,10543600.0,-0.220001220703125,0.220001220703125,0.0,45.95467348449018,55.95000076293945,57.560001373291016,42.85704131244491,-57.14295868755509,0.2876061905206768,0.37333110919772655,-0.0001765602111396536,162135500.0,-1.0
KO,2021-08-23,56.43999862670898,56.75,56.380001068115234,56.66999816894531,8912800.0,-0.20000076293946023,0.20000076293946023,0.0,41.68683144385246,55.95000076293945,57.560001373291016,30.434638385790887,-69.56536161420912,0.235530367617244,0.34577096088163006,-0.006338038999773032,153222700.0,-1.0
KO,2021-08-24,56.0099983215332,56.63999938964844,55.900001525878906,56.63999938964844,12067200.0,-0.43000030517577414,0.43000030517577414,0.0,33.88098945823394,55.900001525878906,57.560001373291016,6.626313600316207,-93.37368639968379,0.15774421900513147,0.30816561250633034,-0.012691719134724666,141155500.0,-1.0
KO,2021-08-25,56.06999969482422,56.16999816894531,55.72999954223633,56.060001373291016,11270700.0,0.060001373291015625,0.0,0.060001373291015625,35.81602009705688,55.72999954223633,57.560001373291016,18.579224720881175,-81.42077527911883,0.09978942051784401,0.2664903741086331,-0.01354680604673808,152426200.0,1.0
KO,2021-08-26,55.540000915527344,55.97999954223633,55.5099983215332,55.95000076293945,10331500.0,-0.529998779296875,0.529998779296875,0.0,27.587300095040618,55.5099983215332,57.560001373291016,1.463538991730493,-98.5364610082695,0.010967063891769158,0.21538571206526028,-0.029529943040830342,142094700.0,-1.0
KO,2021-08-27,55.650001525878906,55.790000915527344,55.45000076293945,55.65999984741211,8844100.0,0.1100006103515625,0.0,0.1100006103515625,31.363691575947286,55.45000076293945,57.560001373291016,9.478706402181066,-90.52129359781893,-0.04997312725589609,0.162313944201029,-0.031837126494977386,150938800.0,1.0
KO,2021-08-30,56.18000030517578,56.20000076293945,55.63999938964844,55.68999862670898,10034700.0,0.529998779296875,0.0,0.529998779296875,46.79058375921688,55.45000076293945,57.560001373291016,34.59712469536668,-65.40287530463333,-0.054869801221741454,0.11887719511647489,-0.01920388438483489,160973500.0,1.0
KO,2021-08-31,56.310001373291016,56.52000045776367,56.0,56.15999984741211,14185700.0,0.13000106811523438,0.0,0.13000106811523438,49.97294463026614,55.45000076293945,57.560001373291016,40.75831097547747,-59.24168902452253,-0.04771049909353309,0.08555965627447329,-0.003362807552371394,175159200.0,1.0
KO,2021-09-01,56.68999862670898,56.79999923706055,56.27999877929688,56.380001068115234,9518900.0,0.37999725341796164,0.0,0.37999725341796164,58.37035026495055,55.45000076293945,57.560001373291016,58.76765426920512,-41.232345730794876,-0.011244546884590534,0.06619881564266053,-0.002989834361901811,184678100.0,1.0
KO,2021-09-02,56.77000045776367,57.02999877929688,56.40999984741211,56.77000045776367,11653200.0,0.0800018310546946,0.0,0.0800018310546946,60.00134643077138,55.45000076293945,57.560001373291016,62.559209146592806,-37.440790853407194,0.023835684982813632,0.057726189510691146,0.0022952166228129567,196331300.0,1.0
KO,2021-09-03,56.72999954223633,56.77000045776367,56.25,56.459999084472656,13220400.0,-0.04000091552734375,0.04000091552734375,0.0,58.675106854514695,55.45000076293945,57.560001373291016,60.66343170789913,-39.336568292100864,0.04785761455129034,0.05575247451881099,0.005138216204529034,183110900.0,-1.0
KO,2021-09-07,55.66999816894531,56.68999862670898,55.5099983215332,56.59999847412109,20035300.0,-1.0600013732910156,1.0600013732910156,0.0,35.01230738410101,55.45000076293945,57.22999954223633,12.359413307730554,-87.64058669226945,-0.018425534801110643,0.04091687265482666,-0.006070347487533767,163075600.0,-1.0
KO,2021-09-08,56.41999816894531,56.47999954223633,55.61000061035156,55.61000061035156,12040100.0,0.75,0.0,0.75,51.109202041631995,55.45000076293945,57.02999877929688,61.39231796265911,-38.60768203734089,-0.010317837606493185,0.03066993060256269,0.006242170073587516,175115700.0,1.0
KO,2021-09-09,55.86000061035156,56.41999816894531,55.79999923706055,56.18000030517578,12545400.0,-0.55999755859375,0.55999755859375,0.0,42.12083611417555,55.45000076293945,57.02999877929688,25.949390009826363,-74.05060999017363,-0.04852017253700325,0.014831909974649499,0.005761607662033041,162570300.0,-1.0
KO,2021-09-10,55.61000061035156,56.130001068115234,55.52000045776367,56.0099983215332,10573700.0,-0.25,0.25,0.0,38.62204000076266,55.45000076293945,57.02999877929688,10.126585334643485,-89.8734146653565,-0.0978408313432837,-0.007702638288937147,-0.0007187945090844083,151996600.0,-1.0
KO,2021-09-13,56.06999969482422,56.400001525878906,55.7400016784668,55.7400016784668,20274300.0,0.45999908447265625,0.0,0.45999908447265625,47.82358497721678,55.45000076293945,57.02999877929688,39.24048799213864,-60.75951200786136,-0.09867234157534455,-0.02589657894621863,-0.0019580030216096445,172270900.0,1.0
KO,2021-09-14,55.68999862670898,55.97999954223633,55.54999923706055,55.91999816894531,13918900.0,-0.3800010681152415,0.3800010681152415,0.0,41.844166107438056,55.45000076293945,57.02999877929688,15.189757283545319,-84.81024271645468,-0.12851277697573948,-0.04641981855212281,-0.01101052622023413,158352000.0,-1.0
KO,2021-09-15,55.880001068115234,56.0,55.41999816894531,55.68000030517578,15746000.0,0.1900024414062571,0.0,0.1900024414062571,45.756927805667225,55.41999816894531,57.02999877929688,28.571597812591687,-71.42840218740831,-0.13527062896126552,-0.06418998063395136,-0.014288191536701134,174098000.0,1.0
KO,2021-09-16,55.34999847412109,55.9900016784668,54.81999969482422,55.720001220703125,17430400.0,-0.5300025939941477,0.5300025939941477,0.0,37.6120613571147,54.81999969482422,57.02999877929688,23.98185515191437,-76.01814484808563,-0.18130306147636333,-0.08761259680243376,-0.025013245943146578,156667600.0,-1.0
KO,2021-09-17,54.43999862670898,55.18999862670898,54.369998931884766,55.02000045776367,33370200.0,-0.9099998474121094,0.9099998474121094,0.0,27.806296235462355,54.369998931884766,57.02999877929688,2.631567625551315,-97.36843237444869,-0.28789473536985355,-0.12766902451591772,-0.04036666550336232,123297400.0,-1.0
KO,2021-09-20,54.060001373291016,54.400001525878906,53.72999954223633,54.11000061035156,27542500.0,-0.37999725341796164,0.37999725341796164,0.0,24.703204028835458,53.72999954223633,57.02999877929688,10.00005779845676,-89.99994220154323,-0.3984390215476594,-0.18182302392226607,-0.02892036731828762,95754900.0,-1.0
KO,2021-09-21,54.04999923706055,54.81999969482422,53.93999862670898,54.38999938964844,16418200.0,-0.01000213623046875,0.01000213623046875,0.0,24.61975994246933,53.72999954223633,57.02999877929688,9.696962691096127,-90.30303730890388,-0.48130506613892976,-0.24171943236559884,-0.04200636314783257,79336700.0,-1.0
KO,2021-09-22,54.130001068115234,54.560001373291016,54.060001373291016,54.5099983215332,12719700.0,0.0800018310546875,0.0,0.0800018310546875,26.89864679797917,53.72999954223633,57.02999877929688,12.12126116232694,-87.87873883767307,-0.5343617384395074,-0.3002478935803806,-0.03097027431674848,92056400.0,1.0
KO,2021-09-23,54.040000915527344,54.619998931884766,54.0,54.2599983215332,13836200.0,-0.09000015258789062,0.09000015258789062,0.0,25.882936131252876,53.72999954223633,56.77000045776367,10.197410524043878,-89.80258947595613,-0.5770202570420082,-0.3556023662727062,-0.02823232651667995,78220200.0,-1.0
KO,2021-09-24,53.88999938964844,54.2400016784668,53.86000061035156,54.0,9682200.0,-0.15000152587890625,0.15000152587890625,0.0,24.13063527029267,53.72999954223633,56.68999862670898,5.405401922298729,-94.59459807770128,-0.6158323687310698,-0.40764836676437904,-0.03887997711861979,68538000.0,-1.0
KO,2021-09-27,53.61000061035156,54.25,53.56999969482422,53.84999847412109,12429500.0,-0.279998779296875,0.279998779296875,0.0,21.059792447437346,53.56999969482422,56.47999954223633,1.3746019802343614,-98.62539801976564,-0.6615587560763956,-0.4584304446267824,-0.037349579235935626,56108500.0,-1.0
KO,2021-09-28,52.63999938964844,53.459999084472656,52.43000030517578,53.459999084472656,19926100.0,-0.970001220703125,0.970001220703125,0.0,13.958995979357127,52.43000030517578,56.41999816894531,5.263137767052853,-94.73686223294715,-0.7672241122910393,-0.5201891781596337,-0.05798141761875375,36182400.0,-1.0
KO,2021-09-29,52.959999084472656,53.15999984741211,52.560001373291016,52.63999938964844,13941500.0,0.31999969482421875,0.0,0.31999969482421875,23.745820876984368,52.43000030517578,56.400001525878906,13.350091091483524,-86.64990890851648,-0.8157400361424081,-0.5792993497561886,-0.043179755294227795,50123900.0,1.0
KO,2021-09-30,52.470001220703125,53.33000183105469,52.43000030517578,53.16999816894531,17672000.0,-0.48999786376953125,0.48999786376953125,0.0,19.772219473669097,52.43000030517578,56.400001525878906,1.0075794263927005,-98.9924205736073,-0.8835430336610557,-0.640148086537162,-0.03618658074394854,32451900.0,-1.0
KO,2021-10-01,53.02000045776367,53.20000076293945,52.56999969482422,52.77999877929688,16277400.0,0.5499992370605469,0.0,0.5499992370605469,34.06262555642047,52.43000030517578,56.0,16.526616331179863,-83.47338366882013,-0.8827216093562029,-0.6886627911009703,-0.019237900279469256,48729300.0,1.0
KO,2021-10-04,52.9900016784668,53.52999877929688,52.400001525878906,53.060001373291016,18973400.0,-0.029998779296875,0.029998779296875,0.0,33.68501344102003,52.400001525878906,56.0,16.388900073962773,-83.61109992603723,-0.8744116011332395,-0.7258125531074242,-0.01961142596773502,29755900.0,-1.0
KO,2021-10-05,53.08000183105469,53.470001220703125,52.93000030517578,53.02000045776367,17173100.0,0.09000015258789062,0.0,0.09000015258789062,36.13583997457263,52.400001525878906,55.9900016784668,18.941511873908855,-81.05848812609115,-0.8507566091702827,-0.750801364319996,-0.019397731689294928,46929000.0,1.0
KO,2021-10-06,53.709999084472656,53.77000045776367,52.5099983215332,52.77000045776367,21284500.0,0.6299972534179688,0.0,0.6299972534179688,50.816970005837675,52.400001525878906,55.18999862670898,46.95336630292568,-53.04663369707432,-0.7722720900143472,-0.7550955094588663,-0.006106621492670383,68213500.0,1.0
KO,2021-10-07,53.880001068115234,54.27999877929688,53.810001373291016,53.9900016784668,13774400.0,0.17000198364257812,0.0,0.17000198364257812,54.10214077513942,52.400001525878906,54.81999969482422,61.15705215104952,-38.84294784895048,-0.6884191407905931,-0.7417602357252118,-0.0001855320402012195,81987900.0,1.0
KO,2021-10-08,54.119998931884766,54.38999938964844,53.900001525878906,54.0,13786800.0,0.23999786376953125,0.0,0.23999786376953125,58.605967742521806,52.400001525878906,54.81999969482422,71.07432675271285,-28.925673247287147,-0.5957320302946911,-0.7125545946391078,0.009513119114472168,95774700.0,1.0
KO,2021-10-11,54.22999954223633,54.38999938964844,54.0099983215332,54.209999084472656,12378500.0,0.1100006103515625,0.0,0.1100006103515625,60.64813010016057,52.400001525878906,54.619998931884766,82.4324393986518,-17.567560601348205,-0.5075499797397853,-0.6715536716592433,0.03020517042218196,108153200.0,1.0
1.0,1.0,1.0,1.0,1.0,1.0,1.0,1.0,1.0,1.0,1.0,1.0,1.0,1.0,1.0,1.0,1.0,1.0,1.0,1.0
KO,2021-10-13,54.2400016784668,54.43000030517578,53.790000915527344,54.16999816894531,12143300.0,0.01000213623046875,0.0,0.01000213623046875,60.881758342820625,52.400001525878906,54.83000183105469,75.72016137894224,-24.279838621057753,-0.3682879182044161,-0.5726803228193883,0.03373356997493793,120296500.0,1.0
KO,2021-10-14,54.61000061035156,54.810001373291016,54.310001373291016,54.38999938964844,13704000.0,0.3699989318847656,0.0,0.3699989318847656,68.79042738303471,52.400001525878906,54.83000183105469,90.94645295992214,-9.053547040077865,-0.2841277014508776,-0.5149697985456861,0.029988686134669207,134000500.0,1.0
KO,2021-10-15,54.47999954223633,54.880001068115234,54.290000915527344,54.63999938964844,17867000.0,-0.13000106811523438,0.13000106811523438,0.0,63.579272428839715,52.400001525878906,54.880001068115234,83.87090323741727,-16.129096762582734,-0.22532274066450242,-0.4570403869694494,0.028118471722468508,116133500.0,-1.0
KO,2021-10-18,53.93999862670898,54.38999938964844,53.86000061035156,54.34999847412109,15861800.0,-0.5400009155273509,0.5400009155273509,0.0,46.64385520925024,52.400001525878906,54.880001068115234,62.09666875347024,-37.90333124652976,-0.21975968529889656,-0.4095842466353389,0.016201898379572865,100271700.0,-1.0
KO,2021-10-19,54.150001525878906,54.20000076293945,53.77000045776367,54.040000915527344,11068500.0,0.21000289916992898,0.0,0.21000289916992898,52.34037567873698,52.400001525878906,54.880001068115234,70.56452915398306,-29.435470846016948,-0.19614441714892195,-0.3668962807380555,0.008192188585113058,111340200.0,1.0
KO,2021-10-20,54.630001068115234,54.7599983215332,54.11000061035156,54.18000030517578,12474800.0,0.4799995422363281,0.0,0.4799995422363281,62.81157534717156,52.400001525878906,54.880001068115234,89.91935297800242,-10.080647021997578,-0.13711660692547412,-0.3209403459755393,0.013919821550334666,123815000.0,1.0
KO,2021-10-21,54.34999847412109,54.66999816894531,54.209999084472656,54.59999847412109,14388300.0,-0.28000259399414773,0.28000259399414773,0.0,54.71954598605356,52.400001525878906,54.880001068115234,78.6289237168076,-21.371076283192387,-0.11164355056370567,-0.27908098689317257,0.004249806850990412,109426700.0,-1.0
KO,2021-10-22,54.45000076293945,54.52999877929688,54.06999969482422,54.38999938964844,12828600.0,0.10000228881836648,0.0,0.10000228881836648,57.002298334282195,52.5099983215332,54.880001068115234,81.85654823413523,-18.143451765864775,-0.0824363471702867,-0.2397520589485954,0.004056817675828661,122255300.0,1.0
KO,2021-10-25,54.22999954223633,54.470001220703125,54.02000045776367,54.380001068115234,11855000.0,-0.220001220703125,0.220001220703125,0.0,50.535257995618025,52.5099983215332,54.880001068115234,72.5738070634591,-27.426192936540893,-0.0761637177115233,-0.207034390701181,0.0,110400300.0,-1.0
KO,2021-10-26,54.470001220703125,54.58000183105469,54.22999954223633,54.31999969482422,12086700.0,0.24000167846679688,0.0,0.24000167846679688,56.716461673961284,53.77000045776367,54.880001068115234,63.06309712007698,-36.93690287992302,-0.0512358711026053,-0.17587468678146587,0.004240404408535126,122487000.0,1.0
KO,2021-10-27,55.52000045776367,56.08000183105469,55.27000045776367,55.970001220703125,24019800.0,1.0499992370605469,0.0,1.0499992370605469,73.45890302317615,53.77000045776367,56.08000183105469,75.75753071985442,-24.24246928014559,0.05263899112360804,-0.13017195120045108,0.016663611742198325,146506800.0,1.0
KO,2021-10-28,56.040000915527344,56.11000061035156,55.619998931884766,55.75,15928000.0,0.5200004577636719,0.0,0.5200004577636719,78.26342145798762,53.77000045776367,56.11000061035156,97.00856024531436,-2.9914397546856377,0.17490406922442503,-0.06915674711547584,0.028634386681328783,162434800.0,1.0
KO,2021-10-29,56.369998931884766,56.470001220703125,55.77999877929688,55.869998931884766,24463700.0,0.3299980163574219,0.0,0.3299980163574219,80.80743555197782,53.77000045776367,56.470001220703125,96.29621257182578,-3.7037874281742154,0.29502721372238483,0.003680045052096316,0.04505006242199916,186898500.0,1.0
KO,2021-11-01,56.16999816894531,56.400001525878906,55.900001525878906,56.38999938964844,11651100.0,-0.20000076293945312,0.20000076293945312,0.0,74.69403985308955,53.77000045776367,56.470001220703125,88.88877900052134,-11.111220999478657,0.36982417942634527,0.07690887192694613,0.0373037227358346,175247400.0,-1.0
KO,2021-11-02,56.09999847412109,56.5,55.970001220703125,56.470001220703125,11498900.0,-0.06999969482422586,0.06999969482422586,0.0,72.47962235063673,53.77000045776367,56.5,85.3479269981399,-14.6520730018601,0.4186272492701377,0.1452525473955845,0.02690824413810633,163748500.0,-1.0
KO,2021-11-03,56.290000915527344,56.33000183105469,55.77999877929688,56.0,10788300.0,0.1900024414062571,0.0,0.1900024414062571,74.81780326082,53.77000045776367,56.5,92.30772455365938,-7.692275446340615,0.46724948040910164,0.20965193399828796,0.035694618139317846,174536800.0,1.0
KO,2021-11-04,56.59999847412109,56.630001068115234,56.02999877929688,56.11000061035156,10820200.0,0.3099975585937429,0.0,0.3099975585937429,78.29018072009384,53.77000045776367,56.630001068115234,98.95095847582844,-1.0490415241715523,0.524748188773593,0.27267118495334897,0.039485724169998404,185357000.0,1.0
KO,2021-11-05,56.84000015258789,57.15999984741211,56.59000015258789,56.84000015258789,12886700.0,0.24000167846680398,0.0,0.24000167846680398,80.67109851311264,53.77000045776367,57.15999984741211,90.56047927910086,-9.439520720899143,0.5829624297061571,0.33472943390391063,0.04812835390711734,198243700.0,1.0
KO,2021-11-08,56.33000183105469,56.88999938964844,56.130001068115234,56.75,12828000.0,-0.5099983215332031,0.5099983215332031,0.0,63.57562280476762,54.02000045776367,57.15999984741211,73.56693701617723,-26.433062983822765,0.5812448068084564,0.38403250848481985,0.03414724745121922,185415700.0,-1.0
KO,2021-11-09,56.4900016784668,56.52000045776367,56.09000015258789,56.40999984741211,10155800.0,0.15999984741210938,0.0,0.15999984741210938,66.17072596133929,54.02000045776367,57.15999984741211,78.66247454843209,-21.337525451567913,0.5860387382375478,0.4244337544353655,0.017471203398873314,195571500.0,1.0
KO,2021-11-10,56.720001220703125,56.91999816894531,56.290000915527344,56.540000915527344,8813600.0,0.22999954223632812,0.0,0.22999954223632812,69.74593571548107,54.02000045776367,57.15999984741211,85.98730215809857,-14.012697841901419,0.6014637041006523,0.4598397443684229,0.012134195111823676,204385100.0,1.0
KO,2021-11-11,56.7400016784668,56.880001068115234,56.56999969482422,56.83000183105469,7257700.0,0.020000457763671875,0.0,0.020000457763671875,70.06338359598057,54.02000045776367,57.15999984741211,86.62425953553014,-13.375740464469853,0.6082899820634537,0.4895297919074292,0.006563823906208022,211642800.0,1.0
KO,2021-11-12,56.61000061035156,56.9900016784668,56.54999923706055,56.75,10162500.0,-0.13000106811523438,0.13000106811523438,0.0,64.95202562363987,54.22999954223633,57.15999984741211,81.22869693600423,-18.77130306399577,0.5963356708025103,0.5108909676864455,0.00783340672511379,201480300.0,-1.0
KO,2021-11-15,56.619998931884766,56.68000030517578,56.27000045776367,56.52999877929688,10289200.0,0.009998321533203125,0.0,0.009998321533203125,65.17746700373638,55.27000045776367,57.15999984741211,71.42851376117162,-28.57148623882838,0.5809714961506174,0.5249070733792799,0.009269170622233647,211769500.0,1.0
KO,2021-11-16,56.220001220703125,56.93999862670898,56.18999862670898,56.619998931884766,13756500.0,-0.3999977111816406,0.3999977111816406,0.0,50.25532650657675,55.619998931884766,57.15999984741211,38.96116442326271,-61.03883557673729,0.5304046314430622,0.5260065849920363,-0.0012435546932973995,198013000.0,-1.0
KO,2021-11-17,55.90999984741211,56.04999923706055,55.650001525878906,56.040000915527344,13288700.0,-0.3100013732910156,0.3100013732910156,0.0,41.7149112380208,55.650001525878906,57.15999984741211,17.218451029085205,-82.7815489709148,0.4600127668506815,0.5128078213637653,-0.012190788786407114,184724300.0,-1.0
KO,2021-11-18,55.40999984741211,55.93000030517578,55.13999938964844,55.83000183105469,15380100.0,-0.5,0.5,0.0,31.691878217672098,55.13999938964844,57.15999984741211,13.36635626620538,-86.63364373379461,0.35973409626863173,0.4821930763447386,-0.025158344499242147,169344200.0,-1.0
KO,2021-11-19,55.130001068115234,55.4900016784668,54.900001525878906,55.43999862670898,15813700.0,-0.279998779296875,0.279998779296875,0.0,27.43283056853319,54.900001525878906,57.15999984741211,10.176978453696124,-89.82302154630388,0.2547325681363972,0.43670097470307034,-0.021303048534216384,153530500.0,-1.0
KO,2021-11-22,55.470001220703125,56.02000045776367,55.08000183105469,55.09999847412109,16905600.0,0.3400001525878906,0.0,0.3400001525878906,38.93161285681048,54.900001525878906,57.15999984741211,25.221244166125125,-74.77875583387488,0.19668599691900823,0.3886979791462579,-0.01805630071617581,170436100.0,1.0
KO,2021-11-23,55.880001068115234,56.11000061035156,55.5,55.65999984741211,13835900.0,0.4099998474121094,0.0,0.4099998474121094,49.96352646003664,54.900001525878906,57.15999984741211,43.362843808286,-56.637156191714,0.1816730178857071,0.3472929868941478,-0.014809593344671579,184272000.0,1.0
KO,2021-11-24,55.43000030517578,55.84000015258789,55.02999877929688,55.709999084472656,12598900.0,-0.4500007629394531,0.4500007629394531,0.0,40.6611916627443,54.900001525878906,57.15999984741211,23.451290837124123,-76.54870916287588,0.13194286869234872,0.304222963253788,-0.02308779229007618,171673100.0,-1.0
KO,2021-11-26,53.72999954223633,54.75,53.58000183105469,54.59000015258789,14754300.0,-1.7000007629394531,1.7000007629394531,0.0,22.44535475368943,53.58000183105469,56.9900016784668,4.398760055531255,-95.60123994446874,-0.0441357147960133,0.23455122764382774,-0.05087442213502824,156918800.0,-1.0
KO,2021-11-29,54.58000183105469,54.72999954223633,53.93000030517578,54.04999923706055,22712500.0,0.8500022888183594,0.0,0.8500022888183594,38.373214641015885,53.58000183105469,56.9900016784668,29.325514508715074,-70.67448549128493,-0.1137796008067582,0.16488506195371055,-0.03602962096986695,179631300.0,1.0
KO,2021-11-30,52.45000076293945,53.630001068115234,52.43999862670898,53.59999847412109,30485200.0,-2.1300010681152344,2.1300010681152344,0.0,24.07620362919475,52.43999862670898,56.9900016784668,0.21982702245906613,-99.78017297754094,-0.3369618771983127,0.06451567412330587,-0.06705799316801442,149146100.0,-1.0
KO,2021-12-01,52.29999923706055,53.52000045776367,52.27999877929688,52.97999954223633,18719600.0,-0.15000152587890625,0.15000152587890625,0.0,23.368721010019783,52.27999877929688,56.9900016784668,0.4246379077004311,-99.57536209229957,-0.5199456980852446,-0.052376600318404264,-0.06456806689686756,130426500.0,-1.0
KO,2021-12-02,53.06999969482422,53.34000015258789,52.5099983215332,52.59999847412109,17074200.0,0.7700004577636719,0.0,0.7700004577636719,34.72905012485538,52.27999877929688,56.9900016784668,16.77283289287498,-83.22716710712503,-0.5959592464339636,-0.16109312954151617,-0.0422306471581263,147500700.0,1.0
KO,2021-12-03,53.540000915527344,53.61000061035156,52.97999954223633,53.33000183105469,21064400.0,0.470001220703125,0.0,0.470001220703125,40.8996939385203,52.27999877929688,56.93999862670898,27.0386733366568,-72.9613266633432,-0.6112294880854776,-0.2511204012503085,-0.02884092366737645,168565100.0,1.0
KO,2021-12-06,54.90999984741211,55.25,54.13999938964844,54.310001373291016,26624100.0,1.3699989318847656,0.0,1.3699989318847656,55.157918704584155,52.27999877929688,56.93999862670898,56.43779300928053,-43.56220699071946,-0.5069401118472712,-0.30228434336970106,-0.010095571677795512,195189200.0,1.0
KO,2021-12-07,55.209999084472656,55.41999816894531,54.84999847412109,55.02000045776367,23832700.0,0.2999992370605469,0.0,0.2999992370605469,57.73430829619265,52.27999877929688,56.11000061035156,76.50127687716875,-23.498723122831244,-0.39552325304098446,-0.32093212530395776,-0.011990013794485721,219021900.0,1.0
KO,2021-12-08,55.0,55.34999847412109,54.36000061035156,55.119998931884766,18026300.0,-0.20999908447265625,0.20999908447265625,0.0,55.173925974037196,52.27999877929688,56.11000061035156,71.01827468197585,-28.981725318024143,-0.3204755183184318,-0.3208408039068526,-0.007757537485267307,200995600.0,-1.0
KO,2021-12-09,54.86000061035156,55.130001068115234,54.59000015258789,54.75,13846400.0,-0.1399993896484375,0.1399993896484375,0.0,53.353834813124166,52.27999877929688,56.11000061035156,67.3629398851806,-32.637060114819405,-0.26919333525641775,-0.31051131017676564,0.021031101391076,187149200.0,-1.0
KO,2021-12-10,56.27999877929688,56.31999969482422,55.06999969482422,55.25,23153600.0,1.4199981689453196,0.0,1.4199981689453196,66.3465171037744,52.27999877929688,56.31999969482422,99.00987855290832,-0.9901214470916865,-0.11267105034525571,-0.27094325821046367,0.03114688331276194,210302800.0,1.0
KO,2021-12-13,57.7599983215332,57.93000030517578,56.959999084472656,56.97999954223633,31362800.0,1.479999542236321,0.0,1.479999542236321,74.79081260945543,52.27999877929688,57.93000030517578,96.9911161463601,-3.008883853639899,0.12930701043703152,-0.1908932044809646,0.10123922748054048,241665600.0,1.0
KO,2021-12-14,57.79999923706055,58.16999816894531,57.400001525878906,57.400001525878906,24806600.0,0.04000091552734375,0.0,0.04000091552734375,74.98654528866672,52.27999877929688,58.16999816894531,93.71818386713193,-6.281816132868065,0.32060833320011284,-0.0885928969447491,0.10516252543465843,266472200.0,1.0
KO,2021-12-15,58.060001373291016,58.25,57.650001525878906,57.93000030517578,24923800.0,0.26000213623046875,0.0,0.26000213623046875,76.36296949440145,52.27999877929688,58.25,96.81744408945686,-3.182555910543135,0.4875755416748504,0.02664079077917083,0.09402678928135466,291396000.0,1.0
KO,2021-12-16,58.650001525878906,58.880001068115234,57.900001525878906,57.97999954223633,24696900.0,0.5900001525878906,0.0,0.5900001525878906,79.33969306962975,52.27999877929688,58.880001068115234,96.5151596594748,-3.484840340525195,0.659899428581582,0.1532925183396531,0.09544266946154623,316092900.0,1.0
KO,2021-12-17,57.72999954223633,58.91999816894531,57.70000076293945,58.4900016784668,51874400.0,-0.9200019836425781,0.9200019836425781,0.0,64.68343199253553,52.27999877929688,58.91999816894531,82.07833228773849,-17.921667712261513,0.7140003283431469,0.26543408034035193,0.051356760201432206,264218500.0,-1.0
KO,2021-12-20,57.540000915527344,57.77999877929688,57.0,57.20000076293945,20879500.0,-0.18999862670898438,0.18999862670898438,0.0,61.9561700955092,52.27999877929688,58.91999816894531,79.21690692367616,-20.78309307632385,0.7330937317718167,0.3589660106266449,0.04220253341228508,243339000.0,-1.0
KO,2021-12-21,57.77000045776367,57.970001220703125,57.52999877929688,57.61000061035156,15864900.0,0.22999954223632812,0.0,0.22999954223632812,64.07204829951536,52.5099983215332,58.91999816894531,82.05931765121764,-17.94068234878236,0.7580461481718501,0.438782038135686,0.05036364468661225,259203900.0,1.0
KO,2021-12-22,58.18000030517578,58.18999862670898,57.4900016784668,57.709999084472656,12447400.0,0.4099998474121094,0.0,0.4099998474121094,67.7601590528058,52.97999954223633,58.91999816894531,87.54212062537931,-12.457879374620697,0.8016635999602002,0.5113583505005889,0.06051767513465478,271651300.0,1.0
KO,2021-12-23,58.220001220703125,58.61000061035156,57.93999862670898,58.52000045776367,11027300.0,0.04000091552734375,0.0,0.04000091552734375,68.12846490617983,54.13999938964844,58.91999816894531,85.3557086400521,-14.644291359947903,0.829892005850354,0.5750650815705419,0.03447054874706024,282678600.0,1.0
KO,2021-12-27,58.650001525878906,58.68999862670898,58.0,58.0,9860000.0,0.43000030517578125,0.0,0.43000030517578125,72.08408310527074,54.36000061035156,58.91999816894531,94.07901781531501,-5.920982184684986,0.8768528379893539,0.6354226328543043,0.015408643182281745,292538600.0,1.0
KO,2021-12-28,58.880001068115234,58.93999862670898,58.29999923706055,58.400001525878906,8979900.0,0.22999954223632812,0.0,0.22999954223632812,74.07025038180498,54.36000061035156,58.93999862670898,98.69000907032138,-1.309990929678621,0.9220004295481985,0.6927381921930832,0.01868515303305074,301518500.0,1.0
KO,2021-12-29,58.95000076293945,59.09999847412109,58.65999984741211,58.95000076293945,9996000.0,0.06999969482421875,0.0,0.06999969482421875,74.70231543708638,54.59000015258789,59.09999847412109,96.67410716173745,-3.3258928382625443,0.9524493680223571,0.744680427358938,0.0153289591559993,311514500.0,1.0
KO,2021-12-30,58.77999877929688,59.22999954223633,58.7599983215332,59.060001373291016,7703900.0,-0.17000198364257102,0.17000198364257102,0.0,69.92584669610386,55.06999969482422,59.22999954223633,89.18267357102461,-10.81732642897539,0.9518898383402288,0.7861223095551962,0.002216491901720019,303810600.0,-1.0
KO,2021-12-31,59.209999084472656,59.34999847412109,58.70000076293945,58.75,10021300.0,0.43000030517577414,0.0,0.43000030517577414,74.65540803243178,56.959999084472656,59.34999847412109,94.14228345602112,-5.857716543978881,0.9749057314586764,0.8238789939358923,0.025636576372281672,313831900.0,1.0
KO,2022-01-03,59.29999923706055,59.310001373291016,58.380001068115234,58.81999969482422,20187300.0,0.09000015258789062,0.0,0.09000015258789062,75.58276373534324,57.0,59.34999847412109,97.87237150955002,-2.1276284904499687,0.9890075888480752,0.8569047129183289,0.030587387791616516,334019200.0,1.0
KO,2022-01-04,60.290000915527344,60.540000915527344,59.59000015258789,59.72999954223633,26141600.0,0.9900016784667969,0.0,0.9900016784667969,83.32623037856993,57.0,60.540000915527344,92.93785493378162,-7.0621450662183864,1.067759803487128,0.8990757310320887,0.043621264285882644,360160800.0,1.0
KO,2022-01-05,60.790000915527344,61.20000076293945,60.04999923706055,60.09000015258789,22507300.0,0.5,0.0,0.5,85.92702886333586,57.0,61.20000076293945,90.23810064441125,-9.761899355588758,1.1571780934303746,0.950696203511746,0.04486078715471198,382668100.0,1.0
KO,2022-01-06,60.470001220703125,61.119998931884766,60.43999862670898,60.470001220703125,17902300.0,-0.31999969482421875,0.31999969482421875,0.0,77.05173400783005,57.0,61.20000076293945,82.61906167546923,-17.38093832453077,1.1885209023361298,0.9982611432766229,0.03864651241539141,364765800.0,-1.0
KO,2022-01-07,60.33000183105469,60.720001220703125,60.060001373291016,60.27999877929688,12307900.0,-0.1399993896484375,0.1399993896484375,0.0,73.2332933566186,57.0,61.20000076293945,79.28574347982071,-20.71425652017929,1.1883647938940243,1.0362818734001031,0.02864450573687516,352457900.0,-1.0
KO,2022-01-10,60.43000030517578,60.81999969482422,60.18000030517578,60.54999923706055,20954300.0,0.09999847412109375,0.0,0.09999847412109375,74.2836298008638,57.4900016784668,61.20000076293945,79.24526555851912,-20.754734441480885,1.1826769542083753,1.0655608895617577,0.02632471482579346,373412200.0,1.0
KO,2022-01-11,60.45000076293945,60.4900016784668,59.84000015258789,60.43000030517578,19369600.0,0.020000457763671875,0.0,0.020000457763671875,74.51442269893988,57.4900016784668,61.20000076293945,79.78436158814833,-20.215638411851682,1.1663383476109743,1.085716381171601,0.02544529229154846,392781800.0,1.0
KO,2022-01-12,60.540000915527344,60.68999862670898,60.18999862670898,60.52999877929688,15753800.0,0.09000015258789062,0.0,0.09000015258789062,75.64911657247293,57.93999862670898,61.20000076293945,79.75461917410692,-20.245380825893076,1.1474253392395326,1.0980581727851875,0.029942194160955893,408535600.0,1.0
KO,2022-01-13,60.900001525878906,61.040000915527344,60.38999938964844,60.540000915527344,14318000.0,0.3600006103515625,0.0,0.3600006103515625,79.80002350746311,58.0,61.20000076293945,90.62502607702586,-9.374973922974128,1.1482493802989566,1.1080964142879413,0.02854251760746007,422853600.0,1.0
KO,2022-01-14,61.38999938964844,61.45000076293945,60.36000061035156,60.93999862670898,19729600.0,0.48999786376953125,0.0,0.48999786376953125,84.06579456426167,58.29999923706055,61.45000076293945,98.09519542139668,-1.9048045786033128,1.1748976821000312,1.1214566678503592,0.03524452241951659,442583200.0,1.0
KO,2022-01-18,60.900001525878906,61.18999862670898,60.45000076293945,61.060001373291016,21976700.0,-0.48999786376953125,0.48999786376953125,0.0,67.59516442940634,58.380001068115234,61.45000076293945,82.08471362431068,-17.91528637568932,1.1432986852359122,1.1258250713274698,0.010117774109942967,420606500.0,-1.0
KO,2022-01-19,61.0,61.18000030517578,60.560001373291016,60.65999984741211,18654700.0,0.09999847412109375,0.0,0.09999847412109375,69.0242549767263,58.380001068115234,61.45000076293945,85.34199323543518,-14.658006764564814,1.113489677805802,1.1233579926231363,0.003454500432800822,439261200.0,1.0
KO,2022-01-20,60.75,61.43999862670898,60.720001220703125,61.0,23002400.0,-0.25,0.25,0.0,61.23423194498335,58.380001068115234,61.45000076293945,77.19866995037165,-22.801330049628348,1.0575026813776702,1.110186930374043,0.00463037495691343,416258800.0,-1.0
KO,2022-01-21,60.45000076293945,61.29999923706055,60.400001525878906,61.08000183105469,26643200.0,-0.2999992370605469,0.2999992370605469,0.0,52.958593562527724,58.380001068115234,61.45000076293945,67.42670685974586,-32.57329314025414,0.9776553498349543,1.0836806142662254,0.001989042404155761,389615600.0,-1.0
KO,2022-01-24,59.959999084472656,60.34999847412109,58.56999969482422,59.900001525878906,30185100.0,-0.4900016784667969,0.4900016784667969,0.0,42.20810091119727,58.56999969482422,61.45000076293945,48.26384979635087,-51.736150203649125,0.8648670747469964,1.0399179063623796,-0.007777614071315386,359430500.0,-1.0
KO,2022-01-25,59.81999969482422,60.04999923706055,58.68999862670898,59.36000061035156,19027100.0,-0.1399993896484375,0.1399993896484375,0.0,39.56062767351346,58.56999969482422,61.45000076293945,43.40276168085036,-56.597238319149646,0.7554761150476139,0.9830295480994264,-0.010421853766153677,340403400.0,-1.0
KO,2022-01-26,59.59999847412109,60.34999847412109,59.209999084472656,59.790000915527344,19190200.0,-0.2200012207031321,0.2200012207031321,0.0,35.520778952006424,58.56999969482422,61.45000076293945,35.763833239510994,-64.236166760489,0.6436115778639646,0.915145954052334,-0.015526964439889324,321213200.0,-1.0
KO,2022-01-27,59.650001525878906,60.93000030517578,59.5,59.880001068115234,18893800.0,0.050003051757819605,0.0,0.050003051757819605,37.20253639667908,58.56999969482422,61.45000076293945,37.50004967051889,-62.499950329481116,0.552622664505023,0.8426412961428719,-0.020525451045659282,340107000.0,1.0
KO,2022-01-28,60.84000015258789,60.88999938964844,58.93999862670898,59.38999938964844,19101500.0,1.1899986267089844,0.0,1.1899986267089844,63.40925638182817,58.56999969482422,61.45000076293945,78.8194311069903,-21.180568893009703,0.5699660254423762,0.7881062420027728,-0.008959101523517643,359208500.0,1.0
KO,2022-01-31,61.0099983215332,61.13999938964844,60.150001525878906,60.29999923706055,22045300.0,0.1699981689453125,0.0,0.1699981689453125,65.76428230574737,58.56999969482422,61.45000076293945,84.72214311732176,-15.277856882678234,0.5906198969026732,0.748608972982753,0.0018061870755052833,381253800.0,1.0
KO,2022-02-01,60.560001373291016,61.13999938964844,60.15999984741211,60.90999984741211,20841700.0,-0.4499969482421875,0.4499969482421875,0.0,54.960239320208245,58.56999969482422,61.45000076293945,69.09725487598926,-30.90274512401073,0.5641738015227631,0.7117219386907551,-0.0072130922411308696,360412100.0,-1.0
KO,2022-02-02,61.18000030517578,61.27000045776367,60.560001373291016,60.619998931884766,20225600.0,0.6199989318847656,0.0,0.6199989318847656,64.28735758107355,58.56999969482422,61.45000076293945,90.62498758237028,-9.375012417629723,0.5864831993741291,0.68667419082743,0.007078194323881126,380637700.0,1.0
KO,2022-02-03,61.61000061035156,61.77999877929688,60.59000015258789,60.93999862670898,19440500.0,0.43000030517578125,0.0,0.43000030517578125,69.36432716248991,58.56999969482422,61.77999877929688,94.7041053759912,-5.295894624008804,0.6315805217361756,0.6756554570091792,0.019189409971410276,400078200.0,1.0
KO,2022-02-04,60.959999084472656,61.68000030517578,60.56999969482422,61.4900016784668,17403700.0,-0.6500015258789062,0.6500015258789062,0.0,55.582312522349866,58.56999969482422,61.77999877929688,74.45483088170616,-25.545169118293842,0.6078637093366339,0.6620971074746702,0.01667778544477927,382674500.0,-1.0
KO,2022-02-07,61.59999847412109,61.720001220703125,60.86000061035156,61.380001068115234,17846400.0,0.6399993896484304,0.0,0.6399993896484304,63.7622632101561,58.56999969482422,61.77999877929688,94.39251225813462,-5.607487741865378,0.633409021740043,0.6563594903277449,0.029755914215607637,400520900.0,1.0
KO,2022-02-08,62.0,62.33000183105469,61.7400016784668,61.83000183105469,18771700.0,0.40000152587891336,0.0,0.40000152587891336,68.0107026965383,58.56999969482422,62.33000183105469,91.22336054347231,-8.776639456527693,0.6781137725749105,0.6607103467771781,0.0402684830087876,419292600.0,1.0
KO,2022-02-09,61.040000915527344,62.31999969482422,60.900001525878906,62.16999816894531,23595600.0,-0.9599990844726562,0.9599990844726562,0.0,51.34210344241855,58.56999969482422,62.33000183105469,65.69148450483026,-34.30851549516974,0.6288299464654941,0.6543342667148413,0.02330258766289206,395697000.0,-1.0
KO,2022-02-10,61.380001068115234,62.29999923706055,60.20000076293945,60.36000061035156,23561500.0,0.3400001525878906,0.0,0.3400001525878906,55.77183087994014,58.56999969482422,62.33000183105469,74.73403661701475,-25.26596338298524,0.6101736282391101,0.6455021390196951,0.008875754670825353,419258500.0,1.0
KO,2022-02-11,60.290000915527344,61.97999954223633,60.150001525878906,61.77000045776367,22781400.0,-1.0900001525878906,1.0900001525878906,0.0,41.72168418016861,58.68999862670898,62.33000183105469,43.956068140494025,-56.04393185950597,0.5016517299875218,0.6167320572132605,-0.011801301849105883,396477100.0,-1.0
KO,2022-02-14,60.68000030517578,60.790000915527344,59.27999877929688,60.15999984741211,23641300.0,0.3899993896484375,0.0,0.3899993896484375,47.21187533837258,58.93999862670898,62.33000183105469,51.327434624140245,-48.67256537585975,0.44202168431014144,0.5817899826326367,0.001981488262278841,420118400.0,1.0
KO,2022-02-15,60.90999984741211,61.77999877929688,60.630001068115234,60.959999084472656,13408700.0,0.22999954223632812,0.0,0.22999954223632812,50.39199310499634,58.93999862670898,62.33000183105469,58.11207547467063,-41.88792452532937,0.40861324522749953,0.5471546351516093,-0.004413214390599274,433527100.0,1.0
KO,2022-02-16,60.900001525878906,61.400001525878906,60.560001373291016,60.86000061035156,15484700.0,-0.009998321533203125,0.009998321533203125,0.0,50.2401810708104,58.93999862670898,62.33000183105469,57.817140015011304,-42.182859984988696,0.3769843941405284,0.5131205869493931,-0.011524088255784992,418042400.0,-1.0
KO,2022-02-17,62.119998931884766,62.27999877929688,60.40999984741211,60.54999923706055,21468700.0,1.2199974060058594,0.0,1.2199974060058594,65.06010499505388,59.27999877929688,62.33000183105469,93.11466593291141,-6.885334067088592,0.4452295671695765,0.4995423829934298,0.019028869173778773,439511100.0,1.0
KO,2022-02-18,62.540000915527344,62.81999969482422,61.9900016784668,62.119998931884766,21975000.0,0.4200019836425781,0.0,0.4200019836425781,68.75641497491938,59.27999877929688,62.81999969482422,92.09043200896559,-7.909567991034402,0.5271285980902292,0.5050596260127896,0.015259780270955092,461486100.0,1.0
KO,2022-02-22,62.27999877929688,62.63999938964844,61.720001220703125,62.43000030517578,21731400.0,-0.26000213623046164,0.26000213623046164,0.0,63.92586185081397,59.27999877929688,62.81999969482422,84.7457407946208,-15.254259205379197,0.5645464308479049,0.5169569869798127,0.004516109343497998,439754700.0,-1.0
KO,2022-02-23,61.59000015258789,62.33000183105469,61.34000015258789,62.2400016784668,19248500.0,-0.6899986267089915,0.6899986267089915,0.0,52.608208919893315,59.27999877929688,62.81999969482422,65.2542592053793,-34.7457407946207,0.5323861936434966,0.5200428283125496,0.009010472293761618,420506200.0,-1.0
KO,2022-02-24,60.5099983215332,60.619998931884766,59.220001220703125,59.970001220703125,27207400.0,-1.0800018310546875,1.0800018310546875,0.0,39.86240019422848,59.220001220703125,62.81999969482422,35.833267988954326,-64.16673201104567,0.41496835526965725,0.4990279337039711,-0.014174042545495591,393298800.0,-1.0
KO,2022-02-25,62.84999847412109,62.900001525878906,60.91999816894531,60.93999862670898,21487800.0,2.3400001525878835,0.0,2.3400001525878835,62.54728203357447,59.220001220703125,62.900001525878906,98.64122153230552,-1.3587784676944783,0.504912017053897,0.5002047503739563,0.04246139525160353,414786600.0,1.0
KO,2022-02-28,62.2400016784668,62.34000015258789,61.40999984741211,61.650001525878906,25879100.0,-0.6099967956542898,0.6099967956542898,0.0,56.173707169209905,59.220001220703125,62.900001525878906,82.06522302501321,-17.934776974986782,0.520966001803167,0.5043570006597984,0.0257086579671284,388907500.0,-1.0
KO,2022-03-01,61.970001220703125,62.75,61.5099983215332,62.13999938964844,15871100.0,-0.2700004577636719,0.2700004577636719,0.0,53.394894711981,59.220001220703125,62.900001525878906,74.72825467248546,-25.271745327514537,0.5060684775370987,0.5046992960352584,0.017402747922286466,373036400.0,-1.0
KO,2022-03-02,62.43000030517578,62.880001068115234,61.77999877929688,62.22999954223633,17319100.0,0.45999908447265625,0.0,0.45999908447265625,57.52533620354307,59.220001220703125,62.900001525878906,87.22822875742466,-12.771771242575337,0.5253245495597483,0.5088243467401564,0.025123132035501206,390355500.0,1.0
KO,2022-03-03,62.470001220703125,63.02000045776367,62.290000915527344,62.61000061035156,21262800.0,0.04000091552734375,0.0,0.04000091552734375,57.899712987045326,59.220001220703125,63.02000045776367,85.52633296089834,-14.47366703910166,0.5376155673447656,0.5145825908610783,0.005634293220161624,411618300.0,1.0
KO,2022-03-04,62.56999969482422,62.59000015258789,61.20000076293945,61.459999084472656,17163000.0,0.09999847412109375,0.0,0.09999847412109375,58.94354767897095,59.220001220703125,63.02000045776367,88.15787228190217,-11.842127718097831,0.5490956952549766,0.521485211739858,0.0004796734707022132,428781300.0,1.0
KO,2022-03-07,61.08000183105469,62.06999969482422,60.720001220703125,62.0099983215332,29151400.0,-1.4899978637695312,1.4899978637695312,0.0,41.32700210470216,59.220001220703125,63.02000045776367,48.947394310277495,-51.0526056897225,0.4329723682283273,0.5037826430375518,-0.019267774113076896,399629900.0,-1.0
KO,2022-03-08,58.65999984741211,61.540000915527344,58.59000015258789,61.45000076293945,30242100.0,-2.420001983642578,2.420001983642578,0.0,26.49003803419943,58.59000015258789,63.02000045776367,1.580128442484186,-98.41987155751582,0.14400980429734744,0.43182807528951095,-0.04757266273610605,369387800.0,-1.0
KO,2022-03-09,58.959999084472656,59.84000015258789,58.65999984741211,59.81999969482422,23022700.0,0.2999992370605469,0.0,0.2999992370605469,30.080590125859374,58.59000015258789,63.02000045776367,8.3521197832081,-91.6478802167919,-0.06009494117636649,0.33344347199633545,-0.025615588829209446,392410500.0,1.0
KO,2022-03-10,57.880001068115234,58.65999984741211,57.5,58.47999954223633,20887300.0,-1.0799980163574219,1.0799980163574219,0.0,25.0068838173204,57.5,63.02000045776367,6.8840767500440565,-93.11592324995594,-0.305474911819239,0.20565979523322053,-0.07907712850704818,371523200.0,-1.0
KO,2022-03-11,57.91999816894531,58.84999847412109,57.86000061035156,57.959999084472656,19855600.0,0.039997100830078125,0.0,0.039997100830078125,25.543538381917614,57.5,63.02000045776367,7.608661849920701,-92.3913381500793,-0.49105232907359664,0.06631737037185707,-0.06940879487501805,391378800.0,1.0
KO,2022-03-14,58.540000915527344,59.040000915527344,57.970001220703125,57.970001220703125,17799400.0,0.6200027465820312,0.0,0.6200027465820312,33.99209267194394,57.5,63.02000045776367,18.84059473336858,-81.15940526663142,-0.5813927949587168,-0.06322466269425774,-0.05534936642908883,409178200.0,1.0
KO,2022-03-15,59.619998931884766,59.88999938964844,58.97999954223633,59.08000183105469,18607200.0,1.0799980163574219,0.0,1.0799980163574219,46.250445695265164,57.5,63.02000045776367,38.4057745666138,-61.5942254333862,-0.5593931154224592,-0.16245835323989805,-0.04501043343832967,427785400.0,1.0
KO,2022-03-16,59.459999084472656,59.93999862670898,58.61000061035156,59.77999877929688,17347300.0,-0.15999984741210938,0.15999984741210938,0.0,44.82738290795436,57.5,63.02000045776367,35.507226846620846,-64.49277315337915,-0.548545569533708,-0.23967579649866008,-0.04818316115596499,410438100.0,-1.0
KO,2022-03-17,60.09000015258789,60.13999938964844,59.22999954223633,59.459999084472656,15586200.0,0.6300010681152344,0.0,0.6300010681152344,51.594073257082044,57.5,63.02000045776367,46.92028872833069,-53.079711271669304,-0.4835390529990775,-0.2884484477987436,-0.03963560099619867,426024300.0,1.0
KO,2022-03-18,60.09999847412109,60.29999923706055,59.709999084472656,60.29999923706055,30197800.0,0.00999832153319602,0.0,0.00999832153319602,51.70254352127017,57.5,63.02000045776367,47.10141772659252,-52.89858227340748,-0.42630001806477225,-0.3160187618519494,-0.01604458624026006,456222100.0,1.0
KO,2022-03-21,60.58000183105469,61.09999847412109,60.25,60.5,17440100.0,0.48000335693360086,0.0,0.48000335693360086,57.03570715663327,57.5,63.02000045776367,55.7971299934003,-44.2028700065997,-0.3383056343821593,-0.3204761363579914,0.032731026059272805,473662200.0,1.0
KO,2022-03-22,60.79999923706055,60.95000076293945,60.060001373291016,60.93000030517578,17559500.0,0.21999740600585938,0.0,0.21999740600585938,59.40621495934949,57.5,63.02000045776367,59.782589916622605,-40.21741008337739,-0.2479591801995582,-0.3059727451263048,0.03120760144435719,491221700.0,1.0
KO,2022-03-23,60.400001525878906,60.97999954223633,60.0,60.75,15529200.0,-0.3999977111816406,0.3999977111816406,0.0,53.24329536973895,57.5,62.59000015258789,56.97448799494571,-43.02551200505428,-0.20625782490483147,-0.2860297610820101,0.04353836232307673,475692500.0,-1.0
KO,2022-03-24,60.97999954223633,61.02000045776367,60.459999084472656,60.63999938964844,13151300.0,0.5799980163574219,0.0,0.5799980163574219,60.15852947728713,57.5,62.06999969482422,76.14879156726472,-23.85120843273528,-0.12496765834367807,-0.2538173405343437,0.05283151709303202,488843800.0,1.0
KO,2022-03-25,61.52999877929688,61.61000061035156,61.04999923706055,61.119998931884766,12259800.0,0.549999237060554,0.0,0.549999237060554,65.70786520753028,57.5,61.61000061035156,98.05348371839202,-1.946516281607977,-0.015980065538094834,-0.2062498855350939,0.05107614993180598,501103600.0,1.0
KO,2022-03-28,61.91999816894531,61.93999862670898,61.209999084472656,61.52999877929688,11485200.0,0.3899993896484304,0.0,0.3899993896484304,69.21603020991893,57.5,61.93999862670898,99.54953910022965,-0.45046089977035736,0.10070224555428098,-0.14485945931721894,0.03857764639828787,512588800.0,1.0
KO,2022-03-29,62.15999984741211,62.52999877929688,61.7400016784668,62.209999084472656,14720600.0,0.24000167846679688,0.0,0.24000167846679688,71.30077956415965,57.5,62.52999877929688,92.64415463861219,-7.355845361387801,0.21011783975656328,-0.07386399950246247,0.04540869163323835,527309400.0,1.0
KO,2022-03-30,62.209999084472656,62.209999084472656,61.560001373291016,62.0099983215332,13641000.0,0.049999237060546875,0.0,0.049999237060546875,71.7604889824682,57.86000061035156,62.52999877929688,93.14775545412056,-6.852244545879451,0.2974363459794631,0.00039606959392266564,0.03528039484941603,540950400.0,1.0
KO,2022-03-31,62.0,62.63999938964844,62.0,62.220001220703125,16822900.0,-0.20999908447265625,0.20999908447265625,0.0,66.59118606471776,57.970001220703125,62.63999938964844,86.29551090824138,-13.704489091758617,0.3457066293478519,0.06945818154470854,0.031614002897139004,524127500.0,-1.0
KO,2022-04-01,62.869998931884766,62.95000076293945,62.09000015258789,62.33000183105469,12644900.0,0.8699989318847656,0.0,0.8699989318847656,75.1486606427301,58.61000061035156,62.95000076293945,98.15663990225937,-1.8433600977406268,0.44898717493476425,0.1453639802227197,0.037801205540013205,536772400.0,1.0
KO,2022-04-04,62.540000915527344,62.790000915527344,61.720001220703125,62.59999847412109,11505800.0,-0.3299980163574219,0.3299980163574219,0.0,67.5733487506385,58.61000061035156,62.95000076293945,90.55299923969746,-9.447000760302538,0.498463690259193,0.21598392223001442,0.028618449018107617,525266600.0,-1.0
KO,2022-04-05,62.470001220703125,63.2400016784668,62.369998931884766,62.400001525878906,15721200.0,-0.06999969482421875,0.06999969482421875,0.0,65.94629317748073,59.22999954223633,63.2400016784668,80.79800380137709,-19.201996198622904,0.5259628227325166,0.2779797023305149,0.034271517260431095,509545400.0,-1.0
KO,2022-04-06,63.09999847412109,63.2599983215332,62.29999923706055,62.77000045776367,19267400.0,0.6299972534179616,0.0,0.6299972534179616,72.75800504556689,59.709999084472656,63.2599983215332,95.49296107611002,-4.507038923889989,0.5917700399249455,0.340737769849401,0.034765479629372376,528812800.0,1.0
KO,2022-04-07,63.43999862670898,63.66999816894531,62.709999084472656,63.130001068115234,13960800.0,0.3400001525878906,0.0,0.3400001525878906,75.7754290006458,60.0,63.66999816894531,93.73297937359918,-6.267020626400822,0.6637071021485212,0.40533163630922514,0.031041766379081404,542773600.0,1.0
KO,2022-04-08,63.83000183105469,64.04000091552734,63.15999984741211,63.47999954223633,12703500.0,0.39000320434571023,0.0,0.39000320434571023,78.87269495466197,60.0,64.04000091552734,94.8020040375351,-5.197995962464899,0.7436158013631982,0.47298846932001976,0.030846313284732974,555477100.0,1.0
KO,2022-04-11,63.810001373291016,64.30000305175781,63.63999938964844,63.90999984741211,12720100.0,-0.020000457763671875,0.020000457763671875,0.0,78.28045810027825,60.0,64.30000305175781,88.60462021610688,-11.395379783893118,0.7961525998281545,0.5376212954216467,0.026544426157163237,542757000.0,-1.0
KO,2022-04-12,64.55999755859375,64.80999755859375,63.88999938964844,64.37999725341797,18089900.0,0.7499961853027344,0.0,0.7499961853027344,83.6065266694712,60.459999084472656,64.80999755859375,94.25287154725929,-5.747128452740707,0.8880697005879128,0.6077109764549,0.037775253314666024,560846900.0,1.0
KO,2022-04-13,64.7300033569336,64.87000274658203,64.2300033569336,64.44000244140625,11883000.0,0.17000579833984375,0.0,0.17000579833984375,84.59458392364998,61.04999923706055,64.87000274658203,96.33509787885052,-3.664902121149481,0.9635257867987832,0.6788739385236767,0.04403231220860637,572729900.0,1.0
KO,2022-04-14,65.0199966430664,65.56999969482422,64.81999969482422,64.95999908447266,16388400.0,0.2899932861328125,0.0,0.2899932861328125,86.22828056116128,61.209999084472656,65.56999969482422,87.38525287239665,-12.614747127603357,1.0347968197685518,0.7500585147726518,0.034197514676451934,589118300.0,1.0
KO,2022-04-18,64.44000244140625,65.18000030517578,64.18000030517578,64.7699966430664,11679400.0,-0.5799942016601562,0.5799942016601562,0.0,69.274862535236,61.560001373291016,65.56999969482422,71.82050557602429,-28.179494423975715,1.0325760480914141,0.8065620214364045,0.03038058039758007,577438900.0,-1.0
KO,2022-04-19,65.06999969482422,65.25,64.44000244140625,64.5,11993800.0,0.6299972534179688,0.0,0.6299972534179688,75.34922870307058,61.560001373291016,65.56999969482422,87.53116685074254,-12.468833149257467,1.0693250700056751,0.8591146311502587,0.041619952350175904,589432700.0,1.0
KO,2022-04-20,65.95999908447266,66.23999786376953,65.4000015258789,65.44000244140625,14827100.0,0.8899993896484375,0.0,0.8899993896484375,81.35708893589158,61.720001220703125,66.23999786376953,93.80533214053625,-6.194667859463747,1.156928100365434,0.9186773249932937,0.045324891909855225,604259800.0,1.0
KO,2022-04-21,66.20999908447266,67.0,65.72000122070312,65.9800033569336,15120400.0,0.25,0.0,0.25,82.7219319319481,61.720001220703125,67.0,85.03785798919169,-14.96214201080831,1.2323216073380507,0.9814061814622452,0.04366331207008378,619380200.0,1.0
KO,2022-04-22,65.25,66.33999633789062,65.18000030517578,66.08000183105469,14902200.0,-0.9599990844726562,0.9599990844726562,0.0,62.46109862980669,61.720001220703125,67.0,66.85605294338642,-33.143947056613584,1.200765919654657,1.0252781291007278,0.022246563186756108,604478000.0,-1.0
KO,2022-04-25,65.94000244140625,67.19999694824219,64.77999877929688,67.0,25082000.0,0.69000244140625,0.0,0.69000244140625,68.7988470109528,62.29999923706055,67.19999694824219,74.28581437985838,-25.71418562014161,1.2174017902177496,1.0637028613241322,0.03338036392844823,629560000.0,1.0
KO,2022-04-26,65.05000305175781,66.37000274658203,65.04000091552734,65.5199966430664,21982600.0,-0.8899993896484375,0.8899993896484375,0.0,54.98322017448652,62.29999923706055,67.19999694824219,56.12255304572579,-43.87744695427421,1.145564964958531,1.080075282051012,0.007589924282747074,607577400.0,-1.0
KO,2022-04-27,65.55999755859375,66.27999877929688,65.0,65.0,16971000.0,0.5099945068359375,0.0,0.5099945068359375,60.25969989136534,62.709999084472656,67.19999694824219,63.47438374343473,-36.52561625656527,1.1169110030929446,1.0874424262593985,0.0128224031919697,624548400.0,1.0
KO,2022-04-28,66.19000244140625,66.27999877929688,64.5,64.66000366210938,22010600.0,0.6300048828125,0.0,0.6300048828125,65.94863182761796,63.15999984741211,67.19999694824219,75.00011802908425,-24.999881970915744,1.1319897871192097,1.0963518984313607,0.017994553348913644,646559000.0,1.0
KO,2022-04-29,64.61000061035156,66.02999877929688,64.48999786376953,65.87000274658203,20137100.0,-1.5800018310546875,1.5800018310546875,0.0,46.6315654506502,63.63999938964844,67.19999694824219,27.24724398648996,-72.75275601351004,1.004863448627745,1.0780542084706377,0.0026380844584834584,626421900.0,-1.0
KO,2022-05-02,63.43999862670898,65.30999755859375,62.58000183105469,65.27999877929688,24970300.0,-1.1700019836425852,1.1700019836425852,0.0,37.297135946922495,62.58000183105469,67.19999694824219,18.614668930166044,-81.38533106983395,0.8004781140936359,1.0225389895952373,-0.02504996274411997,601451600.0,-1.0
KO,2022-05-03,63.08000183105469,63.93999862670898,62.66999816894531,63.720001220703125,21686300.0,-0.35999679565428977,0.35999679565428977,0.0,34.82241297137848,62.58000183105469,67.19999694824219,10.822522260681163,-89.17747773931883,0.6025072031776375,0.9385326323117172,-0.0436627849210498,579765300.0,-1.0
KO,2022-05-04,65.02999877929688,65.12000274658203,62.93999862670898,63.0,19780200.0,1.9499969482421875,0.0,1.9499969482421875,53.9283417403386,62.58000183105469,67.19999694824219,53.03029302190399,-46.96970697809602,0.5960909217984209,0.870044290209058,-0.017822086112254776,599545500.0,1.0
KO,2022-05-05,64.51000213623047,65.02999877929688,64.01000213623047,64.69000244140625,20155200.0,-0.5199966430664062,0.5199966430664062,0.0,49.46667516473703,62.58000183105469,67.19999694824219,41.774942531772666,-58.225057468227334,0.5427896480882453,0.8045933617848955,-0.01134096342941815,579390300.0,-1.0
KO,2022-05-06,64.73999786376953,65.30999755859375,64.06999969482422,64.19999694824219,18984000.0,0.2299957275390625,0.0,0.2299957275390625,51.513894990594906,62.58000183105469,67.19999694824219,46.75321029407879,-53.2467897059212,0.513190991417062,0.7463128877113289,-0.018198430894858286,598374300.0,1.0
KO,2022-05-09,64.61000061035156,65.36000061035156,64.04000091552734,64.47000122070312,20055300.0,-0.12999725341796875,0.12999725341796875,0.0,50.18788197171077,62.58000183105469,67.19999694824219,43.939413956192034,-56.06058604380796,0.4737826790354802,0.6918068459761592,-0.0067640648849187635,578319000.0,-1.0
KO,2022-05-10,64.01000213623047,65.31999969482422,63.84999847412109,64.5,21322200.0,-0.5999984741210938,0.5999984741210938,0.0,44.137350365062346,62.58000183105469,67.19999694824219,30.9524202710915,-69.0475797289085,0.38964486166680956,0.6313744491142893,-0.023642395974435293,556996800.0,-1.0
KO,2022-05-11,64.30999755859375,65.19999694824219,63.959999084472656,64.33000183105469,19648400.0,0.29999542236328125,0.0,0.29999542236328125,47.77002790256909,62.58000183105469,67.19999694824219,37.445834544349616,-62.55416545565038,0.3432157807639413,0.5737427154442197,-0.028403154758556592,576645200.0,1.0
KO,2022-05-12,64.51000213623047,64.52999877929688,63.209999084472656,64.16000366210938,22574700.0,0.20000457763671875,0.0,0.20000457763671875,50.25830701958543,62.58000183105469,67.19999694824219,41.774942531772666,-58.225057468227334,0.3188832104005854,0.5227708144354929,-0.001547724395239758,599219900.0,1.0
KO,2022-05-13,65.72000122070312,65.80000305175781,64.12000274658203,64.80999755859375,16167000.0,1.2099990844726562,0.0,1.2099990844726562,62.67212945224286,62.58000183105469,66.37000274658203,82.84956810390469,-17.150431896095323,0.39270937756188573,0.49675852706077145,0.035939512032622245,615386900.0,1.0
KO,2022-05-16,65.95999908447266,66.37999725341797,65.44000244140625,65.44000244140625,13223200.0,0.23999786376953125,0.0,0.23999786376953125,64.68894377030685,62.58000183105469,66.37999725341797,88.94740329228848,-11.05259670771152,0.46522019991125774,0.49045086163086876,0.045656264581782624,628610100.0,1.0
KO,2022-05-17,65.77999877929688,66.0999984741211,65.01000213623047,66.0999984741211,21300600.0,-0.18000030517578125,0.18000030517578125,0.0,61.799390759228686,62.58000183105469,66.37999725341797,84.21054744987181,-15.789452550128194,0.502370019858617,0.49283469327641843,0.011533138767930717,607309500.0,-1.0
KO,2022-05-18,61.20000076293945,65.5199966430664,60.959999084472656,65.41999816894531,31437300.0,-4.579998016357422,4.579998016357422,0.0,26.73659091223371,60.959999084472656,66.37999725341797,4.428076744415197,-95.5719232555848,0.16039502256056437,0.42634675913324765,-0.05130989402699204,575872200.0,-1.0
KO,2022-05-19,60.0,60.959999084472656,59.65999984741211,60.959999084472656,31493900.0,-1.2000007629394531,1.2000007629394531,0.0,22.822047276109856,59.65999984741211,66.37999725341797,5.059528033210586,-94.94047196678942,-0.20508852646917575,0.30005970201276294,-0.07321591010465844,544378300.0,-1.0
KO,2022-05-20,60.97999954223633,61.2400016784668,59.65999984741211,60.4900016784668,29133800.0,0.9799995422363281,0.0,0.9799995422363281,32.178945448616744,59.65999984741211,66.37999725341797,19.642860183911623,-80.35713981608838,-0.4109222435481996,0.1578633129005704,-0.05618326936733764,573512100.0,1.0
KO,2022-05-23,62.86000061035156,63.09999847412109,61.59000015258789,61.650001525878906,19406900.0,1.8800010681152344,0.0,1.8800010681152344,46.52857103408957,59.65999984741211,66.37999725341797,47.619077353802524,-52.38092264619748,-0.4175335065550527,0.042783949009445744,-0.01796596605998224,592919000.0,1.0
KO,2022-05-24,64.0199966430664,64.19000244140625,62.75,62.880001068115234,16154200.0,1.1599960327148438,0.0,1.1599960327148438,53.52871577669765,59.65999984741211,66.37999725341797,64.88092974199127,-35.11907025800874,-0.32541975836332426,-0.03085679246510828,-0.004509421964494997,609073200.0,1.0
KO,2022-05-25,64.06999969482422,64.47000122070312,63.59999847412109,64.0,15360500.0,0.0500030517578125,0.0,0.0500030517578125,53.82935049118326,59.65999984741211,66.37999725341797,65.6250230613298,-34.3749769386702,-0.2455535326214644,-0.07379614049637952,-0.006820685581083508,624433700.0,1.0
KO,2022-05-26,64.30000305175781,65.0999984741211,63.959999084472656,64.06999969482422,16159800.0,0.23000335693359375,0.0,0.23000335693359375,55.362006487011826,59.65999984741211,66.37999725341797,69.0476933845063,-30.952306615493697,-0.1618341018418974,-0.09140373276548311,-0.02160678853575526,640593500.0,1.0
KO,2022-05-27,64.68000030517578,64.83000183105469,64.13999938964844,64.26000213623047,17709000.0,0.37999725341796875,0.0,0.37999725341796875,58.01862706046867,59.65999984741211,66.37999725341797,74.70241660029734,-25.297583399702656,-0.0640845207380849,-0.08593989036000348,-0.019405682187133233,658302500.0,1.0
KO,2022-05-31,63.380001068115234,64.31999969482422,63.04999923706055,64.08000183105469,43159000.0,-1.2999992370605469,1.2999992370605469,0.0,46.98137138267332,59.65999984741211,66.37999725341797,55.35718239085108,-44.64281760914892,-0.09047342601201791,-0.08684659749040637,-0.03648521975857799,615143500.0,-1.0
KO,2022-06-01,63.06999969482422,63.68000030517578,62.130001068115234,63.41999816894531,15408300.0,-0.3100013732910156,0.3100013732910156,0.0,44.64452436029871,59.65999984741211,66.37999725341797,50.744064936163404,-49.255935063836596,-0.13484691233230706,-0.09644666045878651,0.03055553772177677,599735200.0,-1.0
KO,2022-06-02,63.72999954223633,63.7400016784668,62.11000061035156,63.18000030517578,14586000.0,0.6599998474121094,0.0,0.6599998474121094,50.67188573744503,59.65999984741211,66.37999725341797,60.56549502811921,-39.43450497188079,-0.1154261868657187,-0.10024256574017296,0.06216665903727203,614321200.0,1.0
KO,2022-06-03,62.970001220703125,63.630001068115234,62.810001373291016,63.56999969482422,13539900.0,-0.7599983215332031,0.7599983215332031,0.0,44.26761770803465,59.65999984741211,66.37999725341797,49.255991830186865,-50.74400816981313,-0.1595217673561251,-0.11209840606336341,0.03263367814702045,600781300.0,-1.0
KO,2022-06-06,62.869998931884766,63.77000045776367,62.65999984741211,63.33000183105469,15112800.0,-0.10000228881835938,0.10000228881835938,0.0,43.434168462033455,59.65999984741211,66.0999984741211,49.84471690971545,-50.15528309028454,-0.20022906551096753,-0.12972453795288424,0.00015905697480311787,585668500.0,-1.0
KO,2022-06-07,63.25,63.369998931884766,62.220001220703125,62.380001068115234,17886300.0,0.3800010681152344,0.0,0.3800010681152344,47.747591969104526,59.65999984741211,65.5199966430664,61.26283473824067,-38.73716526175933,-0.1995269595945075,-0.1436850222812089,-0.012027439603900736,603554800.0,1.0
KO,2022-06-08,62.88999938964844,63.209999084472656,62.560001373291016,62.9900016784668,10211500.0,-0.3600006103515625,0.3600006103515625,0.0,44.07379853511198,59.65999984741211,65.0999984741211,59.37500657404337,-40.62499342595663,-0.22542106251312077,-0.16003223032759128,-0.01841736086774326,593343300.0,-1.0
KO,2022-06-09,61.79999923706055,63.34999847412109,61.77999877929688,62.869998931884766,13382200.0,-1.0900001525878906,1.0900001525878906,0.0,34.73651184263689,59.65999984741211,65.0999984741211,39.33823400508953,-60.66176599491047,-0.33009114321113486,-0.1940440129043,-0.03888030631483652,579961100.0,-1.0
KO,2022-06-10,61.40999984741211,61.88999938964844,60.459999084472656,61.0099983215332,14967600.0,-0.3899993896484375,0.3899993896484375,0.0,31.942700262765584,60.459999084472656,65.0999984741211,20.47415706689204,-79.52584293310795,-0.4394469566848045,-0.24312460166040095,-0.05055659310969429,564993500.0,-1.0
KO,2022-06-13,61.34000015258789,62.290000915527344,60.66999816894531,60.75,23064200.0,-0.06999969482421875,0.06999969482421875,0.0,31.419354998160372,60.459999084472656,65.0999984741211,18.965542755856056,-81.03445724414394,-0.5257006670369222,-0.2996398147357052,-0.03218682362177516,541929300.0,-1.0
KO,2022-06-14,59.22999954223633,60.88999938964844,58.65999984741211,60.72999954223633,24620000.0,-2.1100006103515625,2.1100006103515625,0.0,20.01439978466145,58.65999984741211,65.0999984741211,8.85092882567126,-91.14907117432874,-0.755606606548298,-0.39083317309822385,-0.06088473396493477,517309300.0,-1.0
KO,2022-06-15,59.66999816894531,60.63999938964844,58.970001220703125,60.0,19684700.0,0.4399986267089844,0.0,0.4399986267089844,26.43919703392413,58.65999984741211,65.0999984741211,15.683207094864551,-84.31679290513546,-0.892021835584174,-0.491070905595414,-0.06370628279387158,536994000.0,1.0
KO,2022-06-16,59.06999969482422,59.52000045776367,58.25,58.63999938964844,15053800.0,-0.5999984741210938,0.5999984741210938,0.0,23.47261825203313,58.25,64.83000183105469,12.46199797322524,-87.53800202677476,-1.0365974991679678,-0.6001762243099249,-0.06193427743807434,521940200.0,-1.0
KO,2022-06-17,59.43000030517578,60.130001068115234,59.130001068115234,59.70000076293945,34781900.0,0.3600006103515625,0.0,0.3600006103515625,28.988763552226274,58.25,64.31999969482422,19.439874209251553,-80.56012579074844,-1.1093379561452679,-0.7020085706769935,-0.054716059887896296,556722100.0,1.0
KO,2022-06-21,60.70000076293945,60.880001068115234,59.0099983215332,59.4900016784668,17705000.0,1.2700004577636719,0.0,1.2700004577636719,45.097443620974815,58.25,63.77000045776367,44.38406811169045,-55.61593188830955,-1.0523757368484183,-0.7720820039112786,-0.04031619347131299,574427100.0,1.0
KO,2022-06-22,61.150001525878906,61.45000076293945,60.31999969482422,60.59999847412109,15207100.0,0.4500007629394531,0.0,0.4500007629394531,49.75720769485355,58.25,63.77000045776367,52.53625517005462,-47.46374482994537,-0.9598568348076029,-0.8096369700905436,-0.02766732200121358,589634200.0,1.0
KO,2022-06-23,61.880001068115234,61.90999984741211,61.22999954223633,61.29999923706055,17190900.0,0.7299995422363281,0.0,0.7299995422363281,56.64483241189617,58.25,63.77000045776367,65.76088346169927,-34.239116538300735,-0.8181983944000066,-0.8113492549524363,0.001294528026575037,606825100.0,1.0
KO,2022-06-24,63.040000915527344,63.060001373291016,62.11000061035156,62.11000061035156,18147100.0,1.1599998474121094,0.0,1.1599998474121094,65.35328549648719,58.25,63.77000045776367,86.77537170835537,-13.224628291644638,-0.6053526382255967,-0.7701499316070685,0.026542925780253412,624972200.0,1.0
KO,2022-06-27,62.90999984741211,63.290000915527344,62.630001068115234,62.97999954223633,12142100.0,-0.13000106811523438,0.13000106811523438,0.0,63.6987802129769,58.25,63.369998931884766,91.01564100711009,-8.98435899288991,-0.4420649926596809,-0.704532943817591,0.025595038978133866,612830100.0,-1.0
KO,2022-06-28,62.27999877929688,63.7599983215332,62.11000061035156,63.08000183105469,13150100.0,-0.6300010681152273,0.6300010681152273,0.0,55.79972637431731,58.25,63.7599983215332,73.13974604216396,-26.86025395783603,-0.35935179438604337,-0.6354967139312815,0.051494162766042795,599680000.0,-1.0
KO,2022-06-29,62.72999954223633,63.11000061035156,62.43000030517578,62.540000915527344,11795500.0,0.450000762939446,0.0,0.450000762939446,59.89824752829778,58.25,63.7599983215332,81.30673152346316,-18.693268476536836,-0.2545553326621359,-0.5593084376774524,0.05128207587047595,611475500.0,1.0
KO,2022-06-30,62.90999984741211,63.11000061035156,62.15999984741211,62.31999969482422,15514200.0,0.18000030517578125,0.0,0.18000030517578125,61.544035301686506,58.25,63.7599983215332,84.5735257159829,-15.426474284017106,-0.15518992853209568,-0.4784847358483811,0.06500762099926605,626989700.0,1.0
KO,2022-07-01,64.37999725341797,64.44999694824219,62.81999969482422,63.119998931884766,15143200.0,1.4699974060058594,0.0,1.4699974060058594,72.26849021681164,58.25,64.44999694824219,98.87097210839653,-1.129027891603478,0.041693755849799174,-0.37444903750874503,0.08329121525868621,642132900.0,1.0
KO,2022-07-05,63.27999877929688,64.18000030517578,62.41999816894531,64.18000030517578,15921200.0,-1.0999984741210866,1.0999984741210866,0.0,58.244024781164065,58.25,64.44999694824219,81.12905250256581,-18.870947497434194,0.10772304618095774,-0.27801462077080447,0.04250408540246098,626211700.0,-1.0
KO,2022-07-06,63.40999984741211,64.08999633789062,63.18999862670898,63.59999847412109,13450500.0,0.13000106811522727,0.0,0.13000106811522727,59.32052812995555,58.25,64.44999694824219,83.22584495586024,-16.77415504413976,0.16859823866976598,-0.18869204888269037,0.036958270893529876,639662200.0,1.0
KO,2022-07-07,62.90999984741211,63.58000183105469,62.70000076293945,63.2599983215332,14828400.0,-0.5,0.5,0.0,53.230386858327826,58.25,64.44999694824219,75.16132485731795,-24.838675142682053,0.1744850904639037,-0.11605662101337155,0.01664509957204241,624833800.0,-1.0
KO,2022-07-08,63.13999938964844,63.41999816894531,62.880001068115234,63.02999877929688,11311500.0,0.22999954223632812,0.0,0.22999954223632812,55.64722744489945,59.0099983215332,64.44999694824219,75.91915644680495,-24.080843553195056,0.19545640403698172,-0.05375401600330088,0.0015862701882745078,636145300.0,1.0
KO,2022-07-11,62.93999862670898,63.459999084472656,62.59000015258789,62.9900016784668,12702100.0,-0.20000076293946023,0.20000076293946023,0.0,52.904219130963085,59.0099983215332,64.44999694824219,72.24267090584344,-27.757329094156557,0.19370502014565716,-0.004262208773509259,0.00047685231870331357,623443200.0,-1.0
KO,2022-07-12,62.66999816894531,63.45000076293945,62.470001220703125,63.0,14731100.0,-0.27000045776366477,0.27000045776366477,0.0,49.131742849765295,60.31999969482422,64.44999694824219,56.90072728683402,-43.09927271316598,0.1685868906069672,0.030307611102586042,0.0062620327118259045,608712100.0,-1.0
KO,2022-07-13,62.380001068115234,63.0,61.97999954223633,62.33000183105469,13145300.0,-0.2899971008300781,0.2899971008300781,0.0,45.14242907834481,61.22999954223633,64.44999694824219,35.714361872899396,-64.2856381271006,0.12385255439954079,0.049016599761977,-0.00557944327554849,595566800.0,-1.0
KO,2022-07-14,62.18000030517578,62.25,61.29999923706055,61.33000183105469,14433000.0,-0.20000076293945312,0.20000076293945312,0.0,42.402653654976284,61.29999923706055,64.44999694824219,27.93656214388564,-72.06343785611435,0.07143838335411345,0.0535009564804043,-0.011603871308328406,581133800.0,-1.0
KO,2022-07-15,62.5,62.970001220703125,62.06999969482422,62.75,21968400.0,0.31999969482421875,0.0,0.31999969482421875,48.20596181271269,61.29999923706055,64.44999694824219,38.095289995918876,-61.90471000408112,0.0550860781807998,0.05381798082048341,-0.0292015739922723,603102200.0,1.0
KO,2022-07-18,61.650001525878906,62.560001373291016,61.5099983215332,62.52000045776367,10780800.0,-0.8499984741210938,0.8499984741210938,0.0,36.831936320029854,61.29999923706055,64.44999694824219,11.111191845503438,-88.88880815449657,-0.02615946458492857,0.03782249173940101,-0.02575849059515556,592321400.0,-1.0
KO,2022-07-19,62.52999877929688,62.650001525878906,61.93000030517578,62.09000015258789,10998200.0,0.8799972534179759,0.0,0.8799972534179759,50.72133530228161,61.29999923706055,64.44999694824219,39.047632887800816,-60.95236711219919,-0.01931605520184121,0.026394782351152567,-0.013877954111856772,603319600.0,1.0
KO,2022-07-20,61.5,62.58000183105469,61.150001525878906,62.400001525878906,11010500.0,-1.029998779296882,1.029998779296882,0.0,39.10804473343524,61.150001525878906,64.44999694824219,10.60602907959319,-89.3939709204068,-0.09589942847578214,0.0019359401857656174,-0.022412968539692546,592309100.0,-1.0
KO,2022-07-21,61.36000061035156,61.880001068115234,60.790000915527344,61.2599983215332,11959600.0,-0.1399993896484375,0.1399993896484375,0.0,37.75239810850659,60.790000915527344,64.44999694824219,15.573779034984772,-84.42622096501523,-0.16597581835210207,-0.03164641152180793,-0.028191301813485614,580349500.0,-1.0
KO,2022-07-22,61.59000015258789,61.869998931884766,61.31999969482422,61.380001068115234,11644700.0,0.22999954223632812,0.0,0.22999954223632812,41.59046781345763,60.790000915527344,64.18000030517578,23.59880180224786,-76.40119819775214,-0.20063996866537792,-0.06544512295052193,-0.021448975271318282,591994200.0,1.0
KO,2022-07-25,62.18999862670898,62.29999923706055,61.310001373291016,61.54999923706055,14941700.0,0.5999984741210866,0.0,0.5999984741210866,50.73390443861582,60.790000915527344,64.08999633789062,42.42423191541974,-57.57576808458026,-0.17764886948048542,-0.08788587225651463,-0.007659159985011543,606935900.0,1.0
KO,2022-07-26,63.209999084472656,63.79999923706055,62.52999877929688,62.75,20118000.0,1.020000457763679,0.0,1.020000457763679,62.30771408880529,60.790000915527344,63.79999923706055,80.39865509667918,-19.601344903320815,-0.07624385360826125,-0.08555746852686397,0.01330551462240459,627053900.0,1.0
KO,2022-07-27,63.0099983215332,63.18999862670898,61.790000915527344,62.880001068115234,12142900.0,-0.20000076293945312,0.20000076293945312,0.0,59.163162228062696,60.790000915527344,63.79999923706055,73.75410777222822,-26.245892227771773,-0.011881080340479855,-0.07082219088958715,0.013348311551686143,614911000.0,-1.0
KO,2022-07-28,64.05999755859375,64.25,62.88999938964844,62.91999816894531,10837000.0,1.0499992370605469,0.0,1.0499992370605469,68.72463121167627,60.790000915527344,64.25,94.5085985063141,-5.491401493685903,0.12244161369854112,-0.03216942997196148,0.02495996093749997,625748000.0,1.0
KO,2022-07-29,64.16999816894531,64.29000091552734,63.630001068115234,63.709999084472656,13734200.0,0.1100006103515625,0.0,0.1100006103515625,69.58544265935762,60.790000915527344,64.29000091552734,96.57135009765625,-3.42864990234375,0.23505982308822126,0.021276420640075084,0.040875856945576716,639482200.0,1.0
KO,2022-08-01,64.5199966430664,65.04000091552734,64.02999877929688,64.08999633789062,12831500.0,0.34999847412109375,0.0,0.34999847412109375,72.37670139586733,60.790000915527344,65.04000091552734,87.76460535386029,-12.235394646139707,0.3485348246984685,0.0867281014517538,0.031824690590404936,652313700.0,1.0
KO,2022-08-02,63.63999938964844,64.5999984741211,63.43000030517578,64.58999633789062,15241900.0,-0.8799972534179688,0.8799972534179688,0.0,57.15852314153069,60.790000915527344,65.04000091552734,67.05878762637867,-32.941212373621326,0.36326862255695147,0.14203620567279338,0.034796738043064046,637071800.0,-1.0
KO,2022-08-03,63.91999816894531,64.0999984741211,63.310001373291016,63.54999923706055,11317000.0,0.279998779296875,0.0,0.279998779296875,60.22865407366267,60.790000915527344,65.04000091552734,73.64699419806985,-26.353005801930145,0.39300846797337385,0.1922306581329095,0.04172095067029513,648388800.0,1.0
KO,2022-08-04,63.66999816894531,63.72999954223633,62.91999816894531,63.63999938964844,11795600.0,-0.25,0.25,0.0,56.087775843744936,60.790000915527344,65.04000091552734,67.76464125689338,-32.235358743106616,0.39188716773867327,0.23216196005406226,0.03377168389680585,636593200.0,-1.0
KO,2022-08-05,63.380001068115234,63.630001068115234,62.66999816894531,63.630001068115234,10445400.0,-0.2899971008300781,0.2899971008300781,0.0,51.36140543376537,60.790000915527344,65.04000091552734,60.94118006089154,-39.05881993910846,0.3634090336681979,0.2584113747768894,0.019134948829138354,626147800.0,-1.0
KO,2022-08-08,62.970001220703125,63.810001373291016,62.75,63.5,9165200.0,-0.4099998474121094,0.4099998474121094,0.0,45.154206092545856,60.790000915527344,65.04000091552734,51.29412482766544,-48.70587517233456,0.30424915124200425,0.2675789300699124,-0.0037968338434684057,616982600.0,-1.0
KO,2022-08-09,63.04999923706055,63.310001373291016,62.84999847412109,63.18000030517578,7910900.0,0.07999801635742188,0.0,0.07999801635742188,46.606943131723845,60.790000915527344,65.04000091552734,53.1764310948989,-46.823568905101105,0.26081319735550323,0.2662257835270306,0.0006348344166464681,624893500.0,1.0
KO,2022-08-10,63.650001525878906,63.790000915527344,63.09999847412109,63.630001068115234,8857300.0,0.6000022888183594,0.0,0.6000022888183594,56.563703717430016,61.310001373291016,65.04000091552734,62.73459624032392,-37.26540375967608,0.271673379631018,0.26731530274782805,-0.00640018807899323,633750800.0,1.0
KO,2022-08-11,63.220001220703125,63.9900016784668,63.08000183105469,63.68999862670898,8507800.0,-0.43000030517578125,0.43000030517578125,0.0,49.006656802875376,61.310001373291016,65.04000091552734,51.206436509827704,-48.793563490172296,0.24278405787124058,0.26240905377251056,-0.014804378609160285,625243000.0,-1.0
KO,2022-08-12,63.70000076293945,63.7599983215332,63.09000015258789,63.43000030517578,9489300.0,0.4799995422363281,0.0,0.4799995422363281,56.493347846122326,61.790000915527344,65.04000091552734,58.76922607421875,-41.23077392578125,0.25567376575498457,0.2610619961690054,-0.01270917425280238,634732300.0,1.0
KO,2022-08-15,64.5,64.69000244140625,63.56999969482422,63.63999938964844,9863300.0,0.7999992370605469,0.0,0.7999992370605469,66.07246335181276,61.790000915527344,65.04000091552734,83.38458721454327,-16.615412785456734,0.3266764815461656,0.27418489324443746,0.013513523233808389,644595600.0,1.0
KO,2022-08-16,65.02999877929688,65.2300033569336,64.33000183105469,64.56999969482422,9569600.0,0.529998779296875,0.0,0.529998779296875,70.96009182892652,62.66999816894531,65.2300033569336,92.18733701887973,-7.812662981120266,0.4208616859242369,0.3035202517803974,0.01736546686715701,654165200.0,1.0
KO,2022-08-17,64.87999725341797,65.22000122070312,64.76000213623047,64.83000183105469,8144000.0,-0.15000152587890625,0.15000152587890625,0.0,67.77176124790793,62.66999816894531,65.2300033569336,86.3279142886945,-13.672085711305487,0.4778914344588898,0.3383944883160959,0.019004226782950218,646021200.0,-1.0
KO,2022-08-18,65.22000122070312,65.3499984741211,64.70999908447266,64.95999908447266,6532000.0,0.34000396728515625,0.0,0.34000396728515625,71.16074458629402,62.66999816894531,65.3499984741211,95.14935676809775,-4.850643231902253,0.54424962874144,0.37956551640116476,0.029031242057102835,652553200.0,1.0
KO,2022-08-19,65.16999816894531,65.47000122070312,64.95999908447266,65.20999908447266,8921100.0,-0.0500030517578125,0.0500030517578125,0.0,69.91321016256674,62.66999816894531,65.47000122070312,89.2856169721146,-10.714383027885406,0.5860485445919181,0.4208621220393155,0.034937222575737836,643632100.0,-1.0
KO,2022-08-22,64.19999694824219,64.91999816894531,63.9900016784668,64.83999633789062,9087900.0,-0.970001220703125,0.970001220703125,0.0,50.21035961317829,62.66999816894531,65.47000122070312,54.64275399044147,-45.35724600955853,0.5347393522865858,0.44363756808876964,0.018239456385364727,634544200.0,-1.0
KO,2022-08-23,64.2699966430664,64.37000274658203,63.68000030517578,63.81999969482422,8443800.0,0.06999969482421875,0.0,0.06999969482421875,51.35194159043434,62.66999816894531,65.47000122070312,57.14274036653752,-42.85725963346248,0.49402996813265077,0.45371604809754584,0.009740692888049907,642988000.0,1.0
KO,2022-08-24,64.36000061035156,64.58000183105469,64.05000305175781,64.23999786376953,6844700.0,0.09000396728515625,0.0,0.09000396728515625,52.95230950893936,62.66999816894531,65.47000122070312,60.35716426613479,-39.64283573386521,0.4636849839990873,0.4557098352778542,0.01803225826694721,649832700.0,1.0
KO,2022-08-25,64.66999816894531,64.70999908447266,63.900001525878906,64.36000061035156,7913900.0,0.30999755859375,0.0,0.30999755859375,58.39201664968853,62.75,65.47000122070312,70.5881362968282,-29.411863703171807,0.4593554143919505,0.4564389511006735,0.015227588608918818,657746600.0,1.0
KO,2022-08-26,63.11000061035156,64.80000305175781,62.97999954223633,64.7300033569336,10089500.0,-1.55999755859375,1.55999755859375,0.0,34.936979773700315,62.84999847412109,65.47000122070312,9.923735254463582,-90.07626474553642,0.32628423222626424,0.43040800732579165,-0.021550378134084336,647657100.0,-1.0
KO,2022-08-29,62.72999954223633,63.02999877929688,62.40999984741211,62.68999862670898,9115900.0,-0.3800010681152344,0.3800010681152344,0.0,31.392757751595553,62.40999984741211,65.47000122070312,10.457501673604176,-89.54249832639583,0.18799436917301193,0.3819252796952357,-0.035368280489538995,638541200.0,-1.0
KO,2022-08-30,62.150001525878906,62.90999984741211,61.9900016784668,62.90999984741211,8456800.0,-0.5799980163574219,0.5799980163574219,0.0,26.634297876896284,61.9900016784668,65.47000122070312,4.597697369502807,-95.40230263049719,0.03123757636861768,0.31178773902991214,-0.042077617803771394,630084400.0,-1.0
KO,2022-08-31,61.709999084472656,62.52999877929688,61.70000076293945,62.380001068115234,14633600.0,-0.44000244140625,0.44000244140625,0.0,23.514355916756926,61.70000076293945,65.47000122070312,0.2652074355220114,-99.734792564478,-0.12703346832101658,0.2240234975597264,-0.05381787903303914,615450800.0,-1.0
KO,2022-09-01,62.0,62.040000915527344,61.290000915527344,61.58000183105469,14939700.0,0.29000091552734375,0.0,0.29000091552734375,29.770636055593812,61.290000915527344,65.47000122070312,16.98562279035046,-83.01437720964954,-0.2264533480406783,0.13392812843964544,-0.0486419864663411,630390500.0,1.0
KO,2022-09-02,61.150001525878906,62.77000045776367,60.900001525878906,62.38999938964844,11809800.0,-0.8499984741210938,0.8499984741210938,0.0,23.31966317790382,60.900001525878906,65.47000122070312,5.470459883906317,-94.52954011609368,-0.36957189734589235,0.033228123282537846,-0.0475077191175286,618580700.0,-1.0
KO,2022-09-06,61.18000030517578,61.970001220703125,60.9900016784668,61.290000915527344,12181800.0,0.029998779296875,0.0,0.029998779296875,23.990379706654892,60.900001525878906,65.47000122070312,6.126888358745173,-93.87311164125482,-0.4750971043237868,-0.06843692223872713,-0.04807836470027238,630762500.0,1.0
KO,2022-09-07,62.310001373291016,62.4900016784668,61.31999969482422,61.31999969482422,13290700.0,1.1300010681152344,0.0,1.1300010681152344,44.92736091946082,60.900001525878906,65.47000122070312,30.85339040632789,-69.14660959367211,-0.4622168011739305,-0.14719289802576782,-0.03185206988221856,644053200.0,1.0
KO,2022-09-08,62.119998931884766,62.29999923706055,61.34000015258789,62.08000183105469,17193500.0,-0.19000244140625,0.19000244140625,0.0,42.64820273429084,60.900001525878906,65.47000122070312,26.695787472099287,-73.30421252790072,-0.4620148575513312,-0.2101572899308805,-0.0394309464861724,626859700.0,-1.0
KO,2022-09-09,62.31999969482422,62.880001068115234,61.86000061035156,62.16999816894531,11855900.0,0.20000076293945312,0.0,0.20000076293945312,45.976821595250215,60.900001525878906,64.91999816894531,35.32336703301709,-64.67663296698292,-0.4406370362159322,-0.2562532391878909,-0.012517840403851399,638715600.0,1.0
KO,2022-09-12,62.5,62.810001373291016,62.27000045776367,62.43000030517578,13026900.0,0.18000030517578125,0.0,0.18000030517578125,49.04775139127439,60.900001525878906,64.80000305175781,41.02558584923931,-58.97441415076069,-0.4045075275064747,-0.28590409685160767,-0.0036664999826991895,651742500.0,1.0
KO,2022-09-13,60.470001220703125,62.220001220703125,60.27999877929688,62.20000076293945,18532800.0,-2.029998779296875,2.029998779296875,0.0,28.19309736007773,60.27999877929688,64.80000305175781,4.20358986304222,-95.79641013695777,-0.533528384529788,-0.3354289543872438,-0.027031379950590018,633209700.0,-1.0
KO,2022-09-14,60.790000915527344,61.08000183105469,60.43999862670898,60.63999938964844,12881600.0,0.31999969482421875,0.0,0.31999969482421875,33.34776092803051,60.27999877929688,64.80000305175781,11.28322243715025,-88.71677756284974,-0.603005964838097,-0.3889443564774145,-0.014908413265181886,646091300.0,1.0
KO,2022-09-15,59.52999877929688,60.400001525878906,59.36000061035156,60.400001525878906,11451900.0,-1.2600021362304616,1.2600021362304616,0.0,25.14649042550697,59.36000061035156,64.80000305175781,3.1249649384601157,-96.87503506153988,-0.7510810945813517,-0.46137170409820205,-0.03983872936617927,634639400.0,-1.0
KO,2022-09-16,59.540000915527344,59.79999923706055,59.11000061035156,59.65999984741211,20493500.0,0.010002136230461645,0.0,0.010002136230461645,25.314726383007624,59.11000061035156,63.02999877929688,10.969400664069017,-89.03059933593099,-0.8577371529477915,-0.54064479386812,-0.02632870924247166,655132900.0,1.0
KO,2022-09-19,59.9900016784668,60.09999847412109,59.22999954223633,59.38999938964844,12596200.0,0.4500007629394531,0.0,0.4500007629394531,33.11812010436235,59.11000061035156,62.90999984741211,23.157927494636834,-76.84207250536316,-0.8956273127103884,-0.6116412976365737,-0.019450778371576938,667729100.0,1.0
KO,2022-09-20,59.900001525878906,60.02999877929688,59.31999969482422,59.68000030517578,11984600.0,-0.09000015258789062,0.09000015258789062,0.0,32.33838905667879,59.11000061035156,62.880001068115234,20.95492890194408,-79.04507109805591,-0.9222862556059326,-0.6737702892304456,-0.03867757654143056,655744500.0,-1.0
KO,2022-09-21,59.400001525878906,60.70000076293945,59.38999938964844,60.13999938964844,14165300.0,-0.5,0.5,0.0,28.09780046969061,59.11000061035156,62.880001068115234,7.692331042828824,-92.30766895717117,-0.9725485469844273,-0.733525940781242,-0.043786179214013954,641579200.0,-1.0
KO,2022-09-22,59.2599983215332,59.72999954223633,59.20000076293945,59.54999923706055,11657600.0,-0.14000320434570312,0.14000320434570312,0.0,26.955775833453814,59.11000061035156,62.880001068115234,3.97871864637963,-96.02128135362037,-1.0120130075622882,-0.7892233541374514,-0.04910143434331815,629921600.0,-1.0
KO,2022-09-23,58.59999847412109,59.09999847412109,58.0,58.959999084472656,14824000.0,-0.6599998474121165,0.6599998474121165,0.0,22.075287461443025,58.0,62.880001068115234,12.295048008110774,-87.70495199188922,-1.0840491054431922,-0.8481885043985997,-0.06240002441406256,615097600.0,-1.0
KO,2022-09-26,57.869998931884766,58.56999969482422,57.68999862670898,58.4900016784668,18670100.0,-0.729999542236321,0.729999542236321,0.0,17.931831285683145,57.68999862670898,62.880001068115234,3.468212341091238,-96.53178765890877,-1.1863673894263727,-0.9158242814041543,-0.042996564186081,596427500.0,-1.0
KO,2022-09-27,56.380001068115234,58.369998931884766,56.310001373291016,58.08000183105469,23829300.0,-1.4899978637695312,1.4899978637695312,0.0,12.434993600299919,56.310001373291016,62.880001068115234,1.0654444151552065,-98.9345555848448,-1.3718716592930704,-1.0070337569819376,-0.07254482284907615,572598200.0,-1.0
KO,2022-09-28,56.97999954223633,57.25,55.90999984741211,56.65999984741211,21480100.0,0.5999984741210938,0.0,0.5999984741210938,23.351954630652102,55.90999984741211,62.880001068115234,15.351499389210701,-84.6485006107893,-1.4537127712611024,-1.0963695598377707,-0.04283553316563116,594078300.0,1.0
KO,2022-09-29,56.56999969482422,57.290000915527344,56.0,57.09000015258789,14570700.0,-0.4099998474121094,0.4099998474121094,0.0,21.26191285871397,55.90999984741211,62.810001373291016,9.565213064616534,-90.43478693538346,-1.533973313807273,-1.1838903106316712,-0.04988245171371142,579507600.0,-1.0
KO,2022-09-30,56.02000045776367,57.130001068115234,56.0,56.869998931884766,16124600.0,-0.5499992370605469,0.5499992370605469,0.0,18.67480726527677,55.90999984741211,62.220001220703125,1.7432739526361003,-98.2567260473639,-1.6232489109088704,-1.2717620306871111,-0.06617771477956369,563383000.0,-1.0
KO,2022-10-03,56.650001525878906,56.84999847412109,56.060001373291016,56.36000061035156,16277600.0,0.6300010681152344,0.0,0.6300010681152344,29.9415739882658,55.90999984741211,61.08000183105469,14.313373201946453,-85.68662679805354,-1.6244391207438582,-1.3422974486984607,-0.054257093776464815,579660600.0,1.0
KO,2022-10-04,56.77999877929688,57.810001373291016,56.459999084472656,56.95000076293945,18861400.0,0.12999725341797586,0.0,0.12999725341797586,32.17865343174192,55.90999984741211,60.70000076293945,18.16281347806365,-81.83718652193635,-1.5964893433248832,-1.3931358276237453,-0.044107789213449156,598522000.0,1.0
KO,2022-10-05,56.2400016784668,56.650001525878906,55.5099983215332,56.5,14324900.0,-0.5399971008300852,0.5399971008300852,0.0,27.9074833667202,55.5099983215332,60.70000076293945,14.065568661578446,-85.93443133842156,-1.5994744506175493,-1.4344035522225063,-0.05096180777259718,584197100.0,-1.0
KO,2022-10-06,55.02999877929688,56.09999847412109,54.869998931884766,56.0,17192800.0,-1.2100028991699148,1.2100028991699148,0.0,20.777174113182184,54.869998931884766,60.70000076293945,2.744421906693834,-97.25557809330616,-1.6801100286226003,-1.4835448475025252,-0.060921498085034664,567004300.0,-1.0
KO,2022-10-07,54.5099983215332,55.09000015258789,54.25,54.9900016784668,11479800.0,-0.520000457763679,0.520000457763679,0.0,18.440846383236817,54.25,60.70000076293945,4.0309812523915785,-95.96901874760843,-1.7656210162416244,-1.5399600812503453,-0.05806118321008458,555524500.0,-1.0
KO,2022-10-10,54.38999938964844,54.959999084472656,54.02000045776367,54.59999847412109,10239100.0,-0.11999893188476562,0.11999893188476562,0.0,17.90475691564386,54.02000045776367,60.70000076293945,5.538905912894704,-94.4610940871053,-1.8220683314069817,-1.5963817312816728,-0.035296233429697677,545285400.0,-1.0
KO,2022-10-11,54.47999954223633,55.220001220703125,54.2400016784668,54.459999084472656,14303900.0,0.09000015258789062,0.0,0.09000015258789062,19.919397275571583,54.02000045776367,59.72999954223633,8.056027289453397,-91.9439727105466,-1.8383496250605091,-1.6447753100374405,-0.04387504422752542,559589300.0,1.0
KO,2022-10-12,55.13999938964844,56.040000915527344,55.040000915527344,55.22999954223633,18377400.0,0.6599998474121094,0.0,0.6599998474121094,33.68879522099017,54.02000045776367,59.09999847412109,22.04723167761894,-77.95276832238106,-1.7775062106073278,-1.6713214901514184,-0.025278421652645267,577966700.0,1.0
KO,2022-10-13,55.869998931884766,56.08000183105469,54.2599983215332,54.47999954223633,16220700.0,0.7299995422363281,0.0,0.7299995422363281,45.621558702030654,54.02000045776367,58.56999969482422,40.65931394125365,-59.34068605874635,-1.6513468060498653,-1.667326553331108,-0.0026776423536803984,594187400.0,1.0
KO,2022-10-14,54.97999954223633,56.470001220703125,54.93999862670898,56.290000915527344,15997900.0,-0.8899993896484375,0.8899993896484375,0.0,36.40565393484071,54.02000045776367,58.369998931884766,22.06895221191133,-77.93104778808868,-1.6046823030089925,-1.654797703266685,-0.029479292827197634,578189500.0,-1.0
KO,2022-10-17,55.68999862670898,56.220001220703125,55.56999969482422,55.630001068115234,13721400.0,0.7099990844726491,0.0,0.7099990844726491,46.376635343126964,54.02000045776367,57.810001373291016,44.06326558137363,-55.93673441862638,-1.4931967135118143,-1.6224775053157108,-0.019196903417076916,591910900.0,1.0
KO,2022-10-18,56.43999862670898,56.77999877929688,56.09999847412109,56.310001373291016,11823100.0,0.75,0.0,0.75,54.98013208408228,54.02000045776367,57.810001373291016,63.85217900689042,-36.147820993109576,-1.3290049073415275,-1.5637829857208743,0.0035561333974631903,603734000.0,1.0
KO,2022-10-19,55.959999084472656,56.540000915527344,55.72999954223633,56.310001373291016,10182300.0,-0.479999542236321,0.479999542236321,0.0,49.15607524642992,54.02000045776367,57.810001373291016,51.18728649275409,-48.81271350724591,-1.223509810066382,-1.4957283505899759,0.016899878717163475,593551700.0,-1.0
KO,2022-10-20,55.08000183105469,55.91999816894531,54.959999084472656,55.77000045776367,16905100.0,-0.8799972534179688,0.8799972534179688,0.0,40.157480678714094,54.02000045776367,57.810001373291016,27.968367209313094,-72.0316327906869,-1.1971130354360895,-1.4360052875591987,0.010456861623059588,576646600.0,-1.0
KO,2022-10-21,55.959999084472656,56.11000061035156,54.9900016784668,55.0,15034100.0,0.8799972534179688,0.0,0.8799972534179688,50.593392991083405,54.02000045776367,57.810001373291016,51.18728649275409,-48.81271350724591,-1.092590276858381,-1.3673222854190352,0.028865595007214084,591680700.0,1.0
KO,2022-10-24,57.56999969482422,57.72999954223633,56.56999969482422,56.63999938964844,17416700.0,1.6100006103515625,0.0,1.6100006103515625,63.8877588256635,54.02000045776367,57.72999954223633,95.68733458502047,-4.312665414979528,-0.8698149583223511,-1.2678208199996985,0.05671806495138321,609097400.0,1.0
KO,2022-10-25,58.95000076293945,59.11000061035156,57.75,59.040000915527344,28829900.0,1.3800010681152344,0.0,1.3800010681152344,71.47811435607008,54.02000045776367,59.11000061035156,96.85658462444718,-3.1434153755528125,-0.5752779146245643,-1.1293122389246717,0.06909687006645626,637927300.0,1.0
KO,2022-10-26,59.38999938964844,59.77999877929688,58.86000061035156,59.0099983215332,15831400.0,0.4399986267089844,0.0,0.4399986267089844,73.52530569630592,54.02000045776367,59.77999877929688,93.22917529002623,-6.7708247099737635,-0.30285979433043053,-0.9640217500058235,0.06300341014960753,653758700.0,1.0
KO,2022-10-27,59.52999877929688,59.84000015258789,59.380001068115234,59.77000045776367,16026100.0,0.1399993896484446,0.0,0.1399993896484446,74.20503786594756,54.02000045776367,59.84000015258789,94.67351564353696,-5.326484356463037,-0.07480735795331839,-0.7861788715953225,0.0827573531273893,669784800.0,1.0
KO,2022-10-28,60.7599983215332,60.90999984741211,59.470001220703125,59.56999969482422,12888900.0,1.229999542236321,0.0,1.229999542236321,79.53228598317651,54.2400016784668,60.90999984741211,97.751100943666,-2.248899056334001,0.20283833041742838,-0.5883754311927724,0.0910396807299012,682673700.0,1.0
KO,2022-10-31,59.84999847412109,60.56999969482422,59.66999816894531,60.5099983215332,14016400.0,-0.9099998474121165,0.9099998474121165,0.0,67.61224700080481,54.2599983215332,60.90999984741211,84.06013338243669,-15.939866617563315,0.3454628752970663,-0.40160776989480457,0.060418141927423896,668657300.0,-1.0
KO,2022-11-01,59.63999938964844,60.290000915527344,59.369998931884766,60.02999877929688,10659500.0,-0.20999908447264914,0.20999908447264914,0.0,65.01753765170918,54.2599983215332,60.90999984741211,80.90225313751608,-19.097746862483923,0.43651678975710695,-0.23398285796442225,0.06576126457080078,657997800.0,-1.0
KO,2022-11-02,58.810001373291016,60.22999954223633,58.77000045776367,59.63999938964844,14549200.0,-0.8299980163574219,0.8299980163574219,0.0,55.33345105334992,54.93999862670898,60.90999984741211,64.82415335463263,-35.17584664536737,0.43667010844507814,-0.09985226468252215,0.067719669902649,643448600.0,-1.0
KO,2022-11-03,58.77999877929688,59.0,58.09999847412109,58.11000061035156,9194000.0,-0.03000259399413352,0.03000259399413352,0.0,54.99182112802257,54.959999084472656,60.90999984741211,64.20166731099792,-35.79833268900208,0.42942056307065,0.0060023008681123115,0.05039313332667117,634254600.0,-1.0
KO,2022-11-04,59.2599983215332,59.59000015258789,58.560001373291016,59.29999923706055,9725900.0,0.479999542236321,0.0,0.479999542236321,59.59666859957383,54.959999084472656,60.90999984741211,72.26888547382701,-27.73111452617299,0.457137599971972,0.09622936068888428,0.029355543436991205,643980500.0,1.0
KO,2022-11-07,59.4900016784668,59.77000045776367,59.2400016784668,59.2599983215332,8849700.0,0.23000335693359375,0.0,0.23000335693359375,61.75981093772048,54.959999084472656,60.90999984741211,76.13448761569911,-23.86551238430089,0.4919915280121998,0.17538179415354743,0.009160320755531304,652830200.0,1.0
KO,2022-11-08,59.59999847412109,59.790000915527344,58.93999862670898,59.75,10081600.0,0.10999679565428977,0.0,0.10999679565428977,62.857140362485936,54.959999084472656,60.90999984741211,77.98317301989978,-22.016826980100223,0.5224666686883594,0.24479876906050987,0.0035359334337567994,662911800.0,1.0
KO,2022-11-09,58.77000045776367,59.63999938964844,58.75,59.59000015258789,10115200.0,-0.8299980163574148,0.8299980163574148,0.0,50.29215083578521,54.9900016784668,60.90999984741211,63.85135048057467,-36.14864951942532,0.47417849932421063,0.29067471511325005,-0.012766644332563248,652796600.0,-1.0
KO,2022-11-10,60.880001068115234,61.040000915527344,59.68000030517578,60.25,16804800.0,2.1100006103515625,0.0,2.1100006103515625,68.66537694194346,56.56999969482422,61.040000915527344,96.42058604657514,-3.5794139534248632,0.5992612814250791,0.3523920283756159,0.0019750288001489924,669601400.0,1.0
KO,2022-11-11,61.31999969482422,61.45000076293945,60.209999084472656,61.369998931884766,18972100.0,0.4399986267089844,0.0,0.4399986267089844,71.22454763842363,57.75,61.45000076293945,96.48645834299894,-3.5135416570010505,0.7255310292880139,0.42701982855809556,0.02456142453100907,688573500.0,1.0
KO,2022-11-14,60.72999954223633,61.720001220703125,60.709999084472656,61.31999969482422,16361000.0,-0.5900001525878906,0.5900001525878906,0.0,63.23403921764904,58.09999847412109,61.720001220703125,72.65190808483379,-27.3480919151662,0.7691266198085103,0.49544118680817856,0.018276327359873834,672212500.0,-1.0
KO,2022-11-15,60.630001068115234,61.45000076293945,60.0,61.130001068115234,13295800.0,-0.09999847412109375,0.09999847412109375,0.0,61.87647789946699,58.09999847412109,61.720001220703125,69.88952139284824,-30.11047860715175,0.7865406472686587,0.5536610789002746,0.030947111925264892,658916700.0,-1.0
KO,2022-11-16,60.52000045776367,61.02999877929688,60.290000915527344,60.790000915527344,14199500.0,-0.1100006103515625,0.1100006103515625,0.0,60.235102894409586,58.09999847412109,61.720001220703125,66.8508328046856,-33.14916719531439,0.7824457124328248,0.5994180056067847,0.02960193457982241,644717200.0,-1.0
KO,2022-11-17,60.709999084472656,60.7400016784668,60.130001068115234,60.18999862670898,11212600.0,0.18999862670898438,0.0,0.18999862670898438,62.23179826748316,58.09999847412109,61.720001220703125,72.09940967077718,-27.900590329222823,0.7854772555048015,0.6366298555863881,0.024468457711929625,655929800.0,1.0
KO,2022-11-18,61.13999938964844,61.369998931884766,60.79999923706055,60.9900016784668,10415600.0,0.43000030517578125,0.0,0.43000030517578125,66.60998937368808,58.09999847412109,61.720001220703125,83.97786212725065,-16.02213787274935,0.8132031069797279,0.671944505865056,0.027735714651675236,666345400.0,1.0
KO,2022-11-21,62.08000183105469,62.209999084472656,61.20000076293945,61.40999984741211,15399400.0,0.94000244140625,0.0,0.94000244140625,74.16432592325579,58.09999847412109,62.209999084472656,96.83705026489403,-3.162949735105971,0.9006443180539705,0.717684468302839,0.04161079564474224,681744800.0,1.0
KO,2022-11-22,62.34999847412109,62.5,62.04999923706055,62.470001220703125,12319600.0,0.26999664306639914,0.0,0.26999664306639914,75.96641254841552,58.09999847412109,62.5,96.5908755940954,-3.4091244059046115,0.9804268302450225,0.7702329406912758,0.060915398816956845,694064400.0,1.0
KO,2022-11-23,62.630001068115234,62.790000915527344,62.29999923706055,62.4900016784668,8990400.0,0.28000259399414773,0.0,0.28000259399414773,77.81785809133534,58.560001373291016,62.790000915527344,96.21749728777701,-3.7825027122229944,1.054097930425641,0.827005938638149,0.02874507176900387,703054800.0,1.0
KO,2022-11-25,62.68999862670898,62.810001373291016,62.380001068115234,62.72999954223633,5165500.0,0.059997558593742895,0.0,0.059997558593742895,78.23245046820355,58.75,62.810001373291016,97.0442683253389,-2.955731674661104,1.1045910713618028,0.8825229651828799,0.022341796130184832,708220300.0,1.0
KO,2022-11-28,62.70000076293945,63.09999847412109,62.560001373291016,62.68999862670898,12267500.0,0.010002136230475855,0.0,0.010002136230475855,78.31042914938314,58.75,63.09999847412109,90.80464709214749,-9.195352907852518,1.1323611832890137,0.9324906088041068,0.03243868327930799,720487800.0,1.0
KO,2022-11-29,62.47999954223633,62.56999969482422,61.97999954223633,62.52000045776367,10969600.0,-0.220001220703125,0.220001220703125,0.0,71.78401923750621,58.75,63.09999847412109,85.747145991585,-14.252854008414998,1.1236640376113485,0.9707252945655552,0.030512921681177252,709518200.0,-1.0
KO,2022-11-30,63.61000061035156,63.68000030517578,61.75,62.0099983215332,30433900.0,1.1300010681152344,0.0,1.1300010681152344,81.11278714833176,59.68000030517578,63.68000030517578,98.25000762939453,-1.7499923706054688,1.1941872817578556,1.0154176920040154,0.0510575037874359,739952100.0,1.0
KO,2022-12-01,63.790000915527344,64.11000061035156,63.43000030517578,63.61000061035156,12001400.0,0.18000030517578125,0.0,0.18000030517578125,82.1947668115817,60.0,64.11000061035156,92.21412050357709,-7.785879496422909,1.2501905625503866,1.0623722661132897,0.05073302384289513,751953500.0,1.0
KO,2022-12-02,64.3499984741211,64.5199966430664,63.400001525878906,63.61000061035156,13643500.0,0.55999755859375,0.0,0.55999755859375,85.23174228535379,60.0,64.5199966430664,96.2389757699027,-3.7610242300973087,1.3244927608648283,1.1147963650635975,0.052502438935518425,765597000.0,1.0
KO,2022-12-05,63.470001220703125,63.79999923706055,63.2599983215332,63.40999984741211,9185100.0,-0.8799972534179688,0.8799972534179688,0.0,65.09871349656717,60.0,64.5199966430664,76.76999552701095,-23.230004472989055,1.2974135882075828,1.1513198096923947,0.022390453425423562,756411900.0,-1.0
KO,2022-12-06,63.43999862670898,63.880001068115234,63.22999954223633,63.52000045776367,10099500.0,-0.03000259399414773,0.03000259399414773,0.0,64.49935247210536,60.130001068115234,64.5199966430664,75.39865364512488,-24.601346354875115,1.2590190028360553,1.1728596483211269,0.017481959571182815,746312400.0,-1.0
KO,2022-12-07,63.540000915527344,63.720001220703125,63.25,63.45000076293945,12307600.0,0.10000228881836648,0.0,0.10000228881836648,65.71341043697504,60.130001068115234,64.5199966430664,77.67661240638124,-22.32338759361876,1.222567370637762,1.182801192784454,0.01452977537749689,758620000.0,1.0
KO,2022-12-08,63.810001373291016,63.84999847412109,63.34999847412109,63.59999847412109,9946200.0,0.2700004577636719,0.0,0.2700004577636719,69.01454682156677,60.79999923706055,64.5199966430664,80.91409234240008,-19.08590765759992,1.2016145059092693,1.1865638554094171,0.017865732511036736,768566200.0,1.0
KO,2022-12-09,63.13999938964844,63.84000015258789,63.09000015258789,63.61000061035156,13914900.0,-0.6700019836425781,0.6700019836425781,0.0,54.100380201402416,61.20000076293945,64.5199966430664,58.43376608752903,-41.56623391247097,1.1180573795105175,1.1728625602296372,0.007017521871691246,754651300.0,-1.0
KO,2022-12-12,63.970001220703125,64.01000213623047,63.0099983215332,63.29999923706055,11647900.0,0.8300018310546875,0.0,0.8300018310546875,64.93251086224043,61.75,64.5199966430664,80.14454552715875,-19.85545447284125,1.1060619720798428,1.1595024425996783,0.023847658280784056,766299200.0,1.0
KO,2022-12-13,63.9900016784668,64.69999694824219,63.79999923706055,64.58999633789062,17521600.0,0.020000457763671875,0.0,0.020000457763671875,65.161111733767,61.75,64.69999694824219,75.93233883857219,-24.06766116142781,1.0856546441186623,1.144732882903475,0.005973920208599992,783820800.0,1.0
1.0,1.0,1.0,1.0,1.0,1.0,1.0,1.0,1.0,1.0,1.0,1.0,1.0,1.0,1.0,1.0,1.0,1.0,1.0,1.0
KO,2022-12-15,63.11000061035156,63.88999938964844,62.4900016784668,63.59000015258789,12212300.0,-0.8800010681152344,0.8800010681152344,0.0,47.15439703637017,61.75,64.69999694824219,46.101763297143236,-53.898236702856764,0.9528254315302505,1.0923611496297345,-0.019269586529488514,771608500.0,-1.0
KO,2022-12-16,62.75,63.13999938964844,62.33000183105469,62.75,33631500.0,-0.3600006103515625,0.3600006103515625,0.0,41.713277607132085,61.75,64.69999694824219,33.89834015238115,-66.10165984761885,0.8314005375447664,1.0401690272127408,-0.011343961034433803,737977000.0,-1.0
KO,2022-12-19,62.84000015258789,63.40999984741211,62.470001220703125,62.83000183105469,10919700.0,0.09000015258789062,0.0,0.09000015258789062,43.59087863018215,61.75,64.69999694824219,36.94919593857167,-63.05080406142832,0.733971922947255,0.9789296063596437,-0.009457731511811285,748896700.0,1.0
KO,2022-12-20,62.790000915527344,63.150001525878906,62.75,62.81999969482422,10286500.0,-0.049999237060546875,0.049999237060546875,0.0,42.70897552624546,62.33000183105469,64.69999694824219,19.409284058717486,-80.59071594128251,0.645286067266909,0.9122008985410968,-0.011803588120766317,738610200.0,-1.0
KO,2022-12-21,63.79999923706055,64.05000305175781,63.06999969482422,63.06999969482422,10411300.0,1.0099983215332031,0.0,1.0099983215332031,61.06764216853078,62.33000183105469,64.69999694824219,62.025334792686074,-37.97466520731393,0.6490188263032834,0.8595644840935343,-0.00015674872300908138,749021500.0,1.0
KO,2022-12-22,63.34000015258789,63.59000015258789,62.650001525878906,63.41999816894531,9666700.0,-0.45999908447265625,0.45999908447265625,0.0,52.26609842756796,62.33000183105469,64.69999694824219,42.61605073396858,-57.38394926603142,0.6078520430114125,0.80922199587711,0.003167576257091964,739354800.0,-1.0
KO,2022-12-23,63.81999969482422,63.869998931884766,63.20000076293945,63.5,6463300.0,0.4799995422363281,0.0,0.4799995422363281,59.3245830868211,62.33000183105469,64.69999694824219,62.86923770280711,-37.130762297192895,0.6069623381832301,0.7687700643383341,-0.0023448729563312343,745818100.0,1.0
KO,2022-12-27,64.20999908447266,64.29000091552734,63.709999084472656,63.93000030517578,7320700.0,0.3899993896484375,0.0,0.3899993896484375,64.27686257941542,62.33000183105469,64.69999694824219,79.32494205511202,-20.67505794488797,0.6304593886951224,0.7411079292096918,0.0034379965656399225,753138800.0,1.0
KO,2022-12-28,63.56999969482422,64.6500015258789,63.4900016784668,64.45999908447266,7159400.0,-0.6399993896484375,0.6399993896484375,0.0,52.23489622504516,62.33000183105469,64.69999694824219,52.32069276332732,-47.67930723667268,0.590629954010879,0.7110123341699294,-0.006563556377963242,745979400.0,-1.0
KO,2022-12-29,63.95000076293945,64.1500015258789,63.70000076293945,63.79999923706055,7169300.0,0.3800010681152344,0.0,0.3800010681152344,57.66818505453981,62.33000183105469,64.69999694824219,68.35452613958279,-31.645473860417205,0.5830072062986744,0.6854113085956784,0.01331009577664477,753148700.0,1.0
KO,2022-12-30,63.61000061035156,63.91999816894531,63.16999816894531,63.91999816894531,7650200.0,-0.3400001525878906,0.3400001525878906,0.0,51.60768266808875,62.33000183105469,64.69999694824219,54.008498583569406,-45.991501416430594,0.5432684920009194,0.6569827452767267,0.013705189009586727,745498500.0,-1.0
KO,2023-01-03,62.95000076293945,63.560001373291016,62.18000030517578,63.560001373291016,12180500.0,-0.6599998474121094,0.6599998474121094,0.0,41.77446102404274,62.18000030517578,64.69999694824219,30.555614424418938,-69.44438557558105,0.4532935172789223,0.6162448996771659,0.0017504871114650822,733318000.0,-1.0
KO,2023-01-04,62.91999816894531,63.33000183105469,62.5099983215332,63.150001525878906,13387900.0,-0.030002593994140625,0.030002593994140625,0.0,41.3610934952026,62.18000030517578,64.6500015258789,29.959412876681863,-70.04058712331813,0.3752411960552706,0.5680441589527868,0.0020703496022058676,719930100.0,-1.0
KO,2023-01-05,62.20000076293945,62.79999923706055,62.08000183105469,62.59999847412109,9814700.0,-0.7199974060058594,0.7199974060058594,0.0,32.46561730130058,62.08000183105469,64.6500015258789,4.6692196939335915,-95.33078030606642,0.25237714907837727,0.5049107569779049,-0.025078346289253206,710115400.0,-1.0
KO,2023-01-06,63.400001525878906,63.66999816894531,62.58000183105469,62.90999984741211,9990000.0,1.2000007629394531,0.0,1.2000007629394531,52.22509687663393,62.08000183105469,64.6500015258789,51.36186192872304,-48.63813807127696,0.24896660733292464,0.45372192704890885,0.0009472903875351601,720105400.0,1.0
KO,2023-01-09,62.61000061035156,63.720001220703125,62.58000183105469,63.29999923706055,9442600.0,-0.7900009155273438,0.7900009155273438,0.0,42.728603930651715,62.08000183105469,64.6500015258789,20.62252304403972,-79.37747695596028,0.18043728811896642,0.3990649992629204,-0.01895955954651607,710662800.0,-1.0
KO,2023-01-10,62.130001068115234,62.72999954223633,61.91999816894531,62.59999847412109,10134600.0,-0.4799995422363281,0.4799995422363281,0.0,37.89740812213638,61.91999816894531,64.6500015258789,7.69240443007375,-92.30759556992625,0.08639939889123838,0.336531879188584,-0.03239367771398094,700528200.0,-1.0
KO,2023-01-11,62.0099983215332,62.560001373291016,61.40999984741211,62.380001068115234,10823000.0,-0.12000274658203125,0.12000274658203125,0.0,36.70037889598297,61.40999984741211,64.6500015258789,18.51846183008829,-81.4815381699117,0.002165512744554121,0.269658605899778,-0.024539899021236433,689705200.0,-1.0
KO,2023-01-12,61.209999084472656,62.18000030517578,60.970001220703125,62.11000061035156,13907300.0,-0.7999992370605469,0.7999992370605469,0.0,29.526507075419588,60.970001220703125,64.6500015258789,6.521680539862547,-93.47831946013744,-0.12767197836374322,0.19019248904707375,-0.042845999152117176,675797900.0,-1.0
KO,2023-01-13,61.43000030517578,61.459999084472656,60.59000015258789,60.70000076293945,13986400.0,0.220001220703125,0.0,0.220001220703125,33.64233835005973,60.59000015258789,64.6500015258789,20.68965193248176,-79.31034806751825,-0.21039160218607122,0.11007567080044475,-0.034271345452888125,689784300.0,1.0
KO,2023-01-17,61.68000030517578,62.380001068115234,61.560001373291016,61.72999954223633,18327800.0,0.25,0.0,0.25,38.36232569444438,60.59000015258789,64.6500015258789,26.847285317648605,-73.15271468235139,-0.2528597792299365,0.03748858079436848,-0.020174748885966043,708112100.0,1.0
KO,2023-01-18,59.810001373291016,61.59000015258789,59.68000030517578,61.5099983215332,19679400.0,-1.8699989318847656,1.8699989318847656,0.0,23.76992329377879,59.68000030517578,64.6500015258789,2.6157150137851,-97.3842849862149,-0.43242467855448297,-0.05649407107540184,-0.04942779539350439,688432700.0,-1.0
KO,2023-01-19,59.720001220703125,60.63999938964844,59.709999084472656,59.72999954223633,14894500.0,-0.09000015258789062,0.09000015258789062,0.0,23.278199693639763,59.68000030517578,64.1500015258789,0.8948748233462823,-99.10512517665371,-0.5753610115245564,-0.1602674591652328,-0.039871374788052805,673538200.0,-1.0
KO,2023-01-20,60.08000183105469,60.09000015258789,59.400001525878906,59.720001220703125,14237700.0,0.3600006103515625,0.0,0.3600006103515625,29.964971183997278,59.400001525878906,63.91999816894531,15.044265712429002,-84.95573428757099,-0.6520733489343158,-0.2586286371190495,-0.05236592452555455,687775900.0,1.0
KO,2023-01-23,60.22999954223633,60.56999969482422,60.04999923706055,60.27999877929688,12613400.0,0.14999771118164062,0.0,0.14999771118164062,32.78151006375819,59.400001525878906,63.720001220703125,19.212918402560085,-80.78708159743991,-0.6927789428911808,-0.3454586982734758,-0.038013113638617924,700389300.0,1.0
KO,2023-01-24,60.54999923706055,61.84999847412109,59.79999923706055,60.08000183105469,10103300.0,0.31999969482421875,0.0,0.31999969482421875,38.83640081204366,59.400001525878906,63.720001220703125,26.620319268990922,-73.37968073100907,-0.6912488320977275,-0.41461672503832625,-0.0254305778833398,710492600.0,1.0
KO,2023-01-25,60.93000030517578,60.93999862670898,59.88999938964844,60.20000076293945,11265800.0,0.3800010681152344,0.0,0.3800010681152344,45.556101585237016,59.400001525878906,63.720001220703125,35.41664091157142,-64.58335908842857,-0.6518590722577855,-0.46206519448221817,-0.017416514200781497,721758400.0,1.0
KO,2023-01-26,60.810001373291016,61.09999847412109,60.56999969482422,60.810001373291016,11884800.0,-0.11999893188476562,0.11999893188476562,0.0,43.802634560667784,59.400001525878906,63.720001220703125,32.63888766245579,-67.36111233754421,-0.6231421202570928,-0.4942805796371932,-0.006534842626441217,709873600.0,-1.0
KO,2023-01-27,60.4900016784668,60.959999084472656,60.369998931884766,60.84000015258789,14087000.0,-0.31999969482421875,0.31999969482421875,0.0,39.16430536129404,59.400001525878906,63.720001220703125,25.231486796024942,-74.76851320397505,-0.6190687902680949,-0.5192382217633735,-0.01530194729023604,695786600.0,-1.0
KO,2023-01-30,60.63999938964844,61.16999816894531,60.459999084472656,60.540000915527344,15632000.0,0.14999771118164062,0.0,0.14999771118164062,42.459764609112234,59.400001525878906,62.72999954223633,37.23719526793968,-62.76280473206032,-0.5968568904927949,-0.5347619555092579,-0.016861233955604793,711418600.0,1.0
KO,2023-01-31,61.31999969482422,61.34000015258789,60.5099983215332,60.97999954223633,14344400.0,0.6800003051757812,0.0,0.6800003051757812,55.16418656485167,59.400001525878906,62.560001373291016,60.759438660027165,-39.24056133997284,-0.518407578398481,-0.5314910800871026,0.025246585635550822,725763000.0,1.0
KO,2023-02-01,61.33000183105469,61.58000183105469,60.619998931884766,61.13999938964844,12535400.0,0.01000213623046875,0.0,0.01000213623046875,55.331571171798274,59.400001525878906,62.380001068115234,64.7651208606368,-35.2348791393632,-0.450238772261784,-0.5152406185220388,0.026959152334937064,738298400.0,1.0
KO,2023-02-02,60.27999877929688,61.02000045776367,59.90999984741211,60.79999923706055,16947200.0,-1.0500030517578054,1.0500030517578054,0.0,38.10174127650244,59.400001525878906,62.380001068115234,29.530113711278815,-70.46988628872118,-0.4754601644913521,-0.5072845277159015,0.003328843910567647,721351200.0,-1.0
KO,2023-02-03,59.83000183105469,60.41999816894531,59.22999954223633,60.34999847412109,15404400.0,-0.4499969482421946,0.4499969482421946,0.0,33.01757166506603,59.22999954223633,62.380001068115234,19.04768248170763,-80.95231751829238,-0.5256993575282394,-0.510967493678369,-0.006641170749157044,705946800.0,-1.0
KO,2023-02-06,60.16999816894531,60.34000015258789,59.720001220703125,59.790000915527344,11330900.0,0.339996337890625,0.0,0.339996337890625,39.99758877730275,59.22999954223633,61.84999847412109,35.877824806316774,-64.12217519368323,-0.5319474577963064,-0.5151634865019565,-0.00627582283903072,717277700.0,1.0
KO,2023-02-07,60.06999969482422,60.2400016784668,59.540000915527344,59.66999816894531,14922700.0,-0.09999847412109375,0.09999847412109375,0.0,38.63142317109884,59.22999954223633,61.84999847412109,32.061087596841745,-67.93891240315824,-0.5387577000126242,-0.51988232920409,-0.014114567635715392,702355000.0,-1.0
KO,2023-02-08,59.720001220703125,59.91999816894531,59.59000015258789,59.91999816894531,11012000.0,-0.34999847412109375,0.34999847412109375,0.0,33.94855895437553,59.22999954223633,61.84999847412109,18.702361764487534,-81.29763823551247,-0.565873777177373,-0.5290806187987467,-0.017924685544681518,691343000.0,-1.0
KO,2023-02-09,59.619998931884766,60.31999969482422,59.59999847412109,60.150001525878906,12515300.0,-0.10000228881835938,0.10000228881835938,0.0,32.64399360937102,59.22999954223633,61.84999847412109,14.885478955820878,-85.11452104417913,-0.5886472535263962,-0.5409939457442766,-0.014382587575489048,678827700.0,-1.0
1.0,1.0,1.0,1.0,1.0,1.0,1.0,1.0,1.0,1.0,1.0,1.0,1.0,1.0,1.0,1.0,1.0,1.0,1.0,1.0
KO,2023-02-13,60.59999847412109,60.7599983215332,59.72999954223633,59.900001525878906,16191800.0,0.979999542236321,0.0,0.979999542236321,55.136898050650416,58.880001068115234,61.58000183105469,63.703589629112365,-36.296410370887635,-0.5234931761867472,-0.5468997989044059,-0.01174170294009158,695019500.0,1.0
KO,2023-02-14,59.59000015258789,60.900001525878906,59.560001373291016,60.209999084472656,20505700.0,-1.009998321533196,1.009998321533196,0.0,39.46493790634762,58.880001068115234,61.58000183105469,26.29625495733898,-73.70374504266101,-0.5383270622707599,-0.5451852515776767,-0.02837113364613897,674513800.0,-1.0
1.0,1.0,1.0,1.0,1.0,1.0,1.0,1.0,1.0,1.0,1.0,1.0,1.0,1.0,1.0,1.0,1.0,1.0,1.0,1.0
KO,2023-02-16,59.220001220703125,59.81999969482422,58.95000076293945,59.22999954223633,16538300.0,-0.3699989318847656,0.3699989318847656,0.0,34.66002526806173,58.880001068115234,61.58000183105469,12.592594685704356,-87.40740531429564,-0.571431637646576,-0.5502151719719895,-0.010195563959266685,657975500.0,-1.0
KO,2023-02-17,60.119998931884766,60.22999954223633,59.380001068115234,59.5,16814700.0,0.8999977111816406,0.0,0.8999977111816406,51.30111982051275,58.880001068115234,61.58000183105469,45.92583382900836,-54.07416617099163,-0.5147624445945382,-0.5431246264964993,-0.0008309662386919436,674790200.0,1.0
KO,2023-02-21,59.79999923706055,60.22999954223633,59.720001220703125,59.9900016784668,14278300.0,-0.31999969482421875,0.31999969482421875,0.0,46.44794944704936,58.880001068115234,61.58000183105469,34.07399662893885,-65.92600337106114,-0.4900243066668679,-0.532504562530573,-0.004494763761201392,660511900.0,-1.0
KO,2023-02-22,59.97999954223633,60.36000061035156,59.75,59.84999847412109,12409600.0,0.18000030517578125,0.0,0.18000030517578125,49.545847973485245,58.880001068115234,61.02000045776367,51.40181251648877,-48.59818748351123,-0.45069925338567884,-0.5161435007015942,0.004353622173789651,672921500.0,1.0
KO,2023-02-23,60.09000015258789,60.41999816894531,59.810001373291016,60.0099983215332,12222800.0,0.1100006103515625,0.0,0.1100006103515625,51.523247219403174,58.880001068115234,60.900001525878906,59.90093120138387,-40.09906879861613,-0.4059778751642682,-0.494110375594129,0.007883281266745756,685144300.0,1.0
KO,2023-02-24,59.84000015258789,59.90999984741211,59.38999938964844,59.68000030517578,9736200.0,-0.25,0.25,0.0,46.72142222649557,58.880001068115234,60.900001525878906,47.52469638227035,-52.47530361772965,-0.38625624977525774,-0.4725395504303548,0.0036900574412030984,675408100.0,-1.0
KO,2023-02-27,59.81999969482422,60.29999923706055,59.7400016784668,60.18000030517578,8849800.0,-0.020000457763671875,0.020000457763671875,0.0,46.32290534290098,58.880001068115234,60.900001525878906,46.53457493517848,-53.46542506482152,-0.3679985313601648,-0.4516313466163169,-0.012871267309189194,666558300.0,-1.0
KO,2023-02-28,59.5099983215332,59.70000076293945,59.13999938964844,59.70000076293945,16082200.0,-0.3100013732910156,0.3100013732910156,0.0,40.19178850775556,58.880001068115234,60.900001525878906,31.18797577478939,-68.8120242252106,-0.37422978994294454,-0.4361510352816424,-0.001342537856181103,650476100.0,-1.0
KO,2023-03-01,58.86000061035156,59.18000030517578,58.369998931884766,59.130001068115234,13275800.0,-0.6499977111816406,0.6499977111816406,0.0,30.44339586430557,58.369998931884766,60.900001525878906,19.36763541784462,-80.63236458215538,-0.4266987724602629,-0.4342605827173665,-0.012250369866874777,637200300.0,-1.0
KO,2023-03-02,59.720001220703125,59.77999877929688,58.79999923706055,58.84000015258789,11758300.0,0.8600006103515625,0.0,0.8600006103515625,49.239138947341445,58.369998931884766,60.900001525878906,53.35971955218817,-46.640280447811826,-0.39434024827958325,-0.42627651582980985,0.008443093375438915,648958600.0,1.0
KO,2023-03-03,59.43999862670898,59.68000030517578,59.209999084472656,59.54999923706055,13101800.0,-0.28000259399414773,0.28000259399414773,0.0,44.701267687685714,58.369998931884766,60.900001525878906,42.29243469410805,-57.70756530589195,-0.3868306114961868,-0.4183873349630852,-0.011310717186575836,635856800.0,-1.0
KO,2023-03-06,60.36000061035156,60.380001068115234,59.220001220703125,59.2599983215332,16282700.0,0.9200019836425852,0.0,0.9200019836425852,59.01960225138343,58.369998931884766,60.900001525878906,78.65611217912473,-21.343887820875267,-0.30314819524715375,-0.39533950701989895,0.009364571579191017,652139500.0,1.0
KO,2023-03-07,60.0099983215332,60.56999969482422,59.75,60.4900016784668,13961200.0,-0.3500022888183594,0.3500022888183594,0.0,52.996072703234994,58.369998931884766,60.56999969482422,74.54540095055287,-25.45459904944713,-0.2620507788296109,-0.3686817613818414,0.0005001463742217993,638178300.0,-1.0
KO,2023-03-08,60.040000915527344,60.33000183105469,59.72999954223633,60.040000915527344,10851600.0,0.030002593994140625,0.0,0.030002593994140625,53.465818254509806,58.369998931884766,60.56999969482422,75.90915475007672,-24.090845249923273,-0.22447224531970278,-0.3398398581694137,-0.0008320725067995083,649029900.0,1.0
KO,2023-03-09,59.459999084472656,60.540000915527344,59.27999877929688,60.540000915527344,13900900.0,-0.5800018310546875,0.5800018310546875,0.0,43.719837757753034,58.369998931884766,60.56999969482422,49.5454442993704,-50.4545557006296,-0.23874023840524927,-0.31961993421658086,-0.006350285213005624,635129000.0,-1.0
KO,2023-03-10,59.209999084472656,60.13999938964844,58.9900016784668,59.70000076293945,13745800.0,-0.25,0.25,0.0,40.08573101926457,58.369998931884766,60.56999969482422,38.18181187653563,-61.81818812346437,-0.2671411989320447,-0.30912418715967366,-0.010197268697150097,621383200.0,-1.0
KO,2023-03-13,59.810001373291016,60.869998931884766,59.25,59.290000915527344,21956000.0,0.6000022888183594,0.0,0.6000022888183594,51.296598865003034,58.369998931884766,60.869998931884766,57.60009765625001,-42.39990234375,-0.23848488913781551,-0.29499632755530203,0.005041220974951077,643339200.0,1.0
KO,2023-03-14,60.02999877929688,60.459999084472656,59.34999847412109,60.0,19496900.0,0.21999740600586648,0.0,0.21999740600586648,54.86927644343102,58.369998931884766,60.869998931884766,66.39999389648466,-33.60000610351534,-0.19576593723432012,-0.27515024949110567,0.0198776445262141,662836100.0,1.0
KO,2023-03-15,60.43000030517578,60.47999954223633,59.2400016784668,59.43000030517578,21089900.0,0.40000152587889914,0.0,0.40000152587889914,60.888386221517806,58.369998931884766,60.869998931884766,82.40005493164062,-17.599945068359375,-0.1281567684394176,-0.24575155328076806,0.01188879889417227,683926000.0,1.0
KO,2023-03-16,60.29999923706055,60.34000015258789,59.70000076293945,60.09000015258789,15658300.0,-0.13000106811523438,0.13000106811523438,0.0,57.98815617864156,58.369998931884766,60.869998931884766,77.20001220703125,-22.79998779296875,-0.08409660153022713,-0.2134205629306599,0.01446838206966472,668267700.0,-1.0
KO,2023-03-17,60.02000045776367,60.34999847412109,59.63999938964844,60.310001373291016,27351200.0,-0.279998779296875,0.279998779296875,0.0,51.85043050065777,58.369998931884766,60.869998931884766,66.00006103515625,-33.99993896484375,-0.07095424686972507,-0.18492729971847294,-0.005632871920971838,640916500.0,-1.0
KO,2023-03-20,60.59999847412109,60.59999847412109,59.970001220703125,60.15999984741211,12904100.0,0.5799980163574148,0.0,0.5799980163574148,61.5719615515041,58.369998931884766,60.869998931884766,89.19998168945284,-10.80001831054716,-0.013581286820929961,-0.15065809713896436,0.009831697535245043,653820600.0,1.0
KO,2023-03-21,60.31999969482422,60.75,59.880001068115234,60.56999969482422,13716500.0,-0.2799987792968679,0.2799987792968679,0.0,55.34729365633866,58.79999923706055,60.869998931884766,73.42998463063773,-26.570015369362267,0.009187725544855141,-0.11868893260220045,0.004663537225637615,640104100.0,-1.0
KO,2023-03-22,60.04999923706055,60.869998931884766,60.02999877929688,60.400001525878906,10494200.0,-0.2700004577636719,0.2700004577636719,0.0,49.75110674315772,58.9900016784668,60.869998931884766,56.38293123389404,-43.61706876610596,0.005383493866865763,-0.0938744473083872,0.009922639785945764,629609900.0,-1.0
KO,2023-03-23,59.91999816894531,60.38999938964844,59.720001220703125,60.09000015258789,15479000.0,-0.13000106811523438,0.13000106811523438,0.0,47.10508193236302,58.9900016784668,60.869998931884766,49.46797069983565,-50.53202930016436,-0.008028835461168171,-0.0767053249389434,0.011991202422748426,614130900.0,-1.0
KO,2023-03-24,60.900001525878906,61.02000045776367,59.90999984741211,60.25,12975600.0,0.9800033569335938,0.0,0.9800033569335938,63.835378497170076,58.9900016784668,61.02000045776367,94.08871901261294,-5.911280987387062,0.05973133197694125,-0.04941799355576647,0.018224379327211437,627106500.0,1.0
KO,2023-03-27,61.34999847412109,61.47999954223633,60.95000076293945,61.13999938964844,12777400.0,0.4499969482421804,0.0,0.4499969482421804,69.0259747680802,58.9900016784668,61.47999954223633,94.77906909050769,-5.220930909492302,0.1480362757614131,-0.009927139692330549,0.02198900086067379,639883900.0,1.0
KO,2023-03-28,61.41999816894531,61.7400016784668,61.27000045776367,61.38999938964844,10925700.0,0.06999969482422586,0.0,0.06999969482422586,69.8038664867233,58.9900016784668,61.7400016784668,88.3635087446733,-11.636491255326705,0.22111805893167968,0.03628190003247152,0.016382555994869596,650809600.0,1.0
KO,2023-03-29,61.86000061035156,61.95000076293945,61.59000015258789,61.720001220703125,9441000.0,0.44000244140625,0.0,0.44000244140625,74.45658977763698,58.9900016784668,61.95000076293945,96.95945336402275,-3.040546635977246,0.3109559121951335,0.09121670246500393,0.02587066986780706,660250600.0,1.0
KO,2023-03-30,61.84999847412109,62.09000015258789,61.65999984741211,61.880001068115234,9870700.0,-0.010002136230475855,0.010002136230475855,0.0,74.15688549054671,59.2400016784668,62.09000015258789,91.57888396621624,-8.421116033783761,0.37700014633819734,0.14837339123964263,0.030489803438858543,650379900.0,-1.0
KO,2023-03-31,62.02999877929688,62.25,61.869998931884766,62.060001373291016,14440900.0,0.18000030517579546,0.0,0.18000030517579546,76.15031483670748,59.2400016784668,62.25,92.69098526968428,-7.309014730315725,0.43880690516701293,0.2064600940251167,0.023597365366048173,664820800.0,1.0
KO,2023-04-03,62.400001525878906,62.52000045776367,61.86000061035156,62.29999923706055,12300700.0,0.37000274658202414,0.0,0.37000274658202414,79.83882832863628,59.2400016784668,62.52000045776367,96.3414946175532,-3.6585053824468035,0.5117462440888119,0.26751732403785583,0.03448278915082881,677121500.0,1.0
KO,2023-04-04,62.209999084472656,62.7400016784668,62.08000183105469,62.38999938964844,11433400.0,-0.19000244140625,0.19000244140625,0.0,73.13679206232173,59.63999938964844,62.7400016784668,82.90315475230943,-17.096845247690574,0.5479036938545292,0.3235945980011905,0.035970022895171594,665688100.0,-1.0
KO,2023-04-05,62.79999923706055,63.02000045776367,62.5,62.52999877929688,12789600.0,0.5900001525878906,0.0,0.5900001525878906,79.34821457808243,59.63999938964844,63.02000045776367,93.49109020176131,-6.508909798238694,0.617053802636903,0.382286438928333,0.048064104741709635,678477700.0,1.0
KO,2023-04-06,62.84000015258789,63.040000915527344,62.380001068115234,62.86000061035156,9644200.0,0.04000091552734375,0.0,0.04000091552734375,79.71513429455266,59.720001220703125,63.040000915527344,93.97588008061422,-6.024119919385788,0.6673902423502156,0.4393071996127096,0.03185547747292916,688121900.0,1.0
KO,2023-04-10,62.68999862670898,62.68999862670898,62.02000045776367,62.4900016784668,7952600.0,-0.15000152587891336,0.15000152587891336,0.0,74.02447684069821,59.720001220703125,63.040000915527344,89.457761415942,-10.542238584057994,0.6872561033962228,0.4888969803694122,0.021841893820961245,680169300.0,-1.0
KO,2023-04-11,62.58000183105469,62.709999084472656,62.400001525878906,62.650001525878906,9913000.0,-0.10999679565428977,0.10999679565428977,0.0,69.80791391480834,59.720001220703125,63.040000915527344,86.14460461578412,-13.855395384215885,0.6862138728997778,0.5283603588754854,0.018886416422849717,670256300.0,-1.0
KO,2023-04-12,62.68999862670898,63.02999877929688,62.310001373291016,62.47999954223633,9593700.0,0.10999679565428977,0.0,0.10999679565428977,71.66991135398536,59.720001220703125,63.040000915527344,89.457761415942,-10.542238584057994,0.6863518825869548,0.5599586636177792,0.01341736191671683,679850000.0,1.0
KO,2023-04-13,63.150001525878906,63.15999984741211,62.47999954223633,62.7599983215332,9871400.0,0.460002899169929,0.0,0.460002899169929,78.16710402306313,59.90999984741211,63.15999984741211,99.69235933743991,-0.30764066256009615,0.7153337239270741,0.5910336756796383,0.021018643230876766,689721400.0,1.0
KO,2023-04-14,63.04999923706055,63.150001525878906,62.77999877929688,63.04999923706055,8946000.0,-0.10000228881835938,0.10000228881835938,0.0,73.91496490283365,60.95000076293945,63.15999984741211,95.02259475470278,-4.977405245297219,0.7219109529467573,0.6172091311330621,0.016443663998653824,680775400.0,-1.0
KO,2023-04-17,63.459999084472656,63.52999877929688,63.13999938964844,63.31999969482422,9452400.0,0.4099998474121094,0.0,0.4099998474121094,79.25377221506088,61.27000045776367,63.52999877929688,96.90266607026781,-3.0973339297321782,0.7515436876936761,0.6440760424451849,0.016987139946689656,690227800.0,1.0
KO,2023-04-18,63.560001373291016,63.59999847412109,63.18999862670898,63.5099983215332,9035700.0,0.10000228881835938,0.0,0.10000228881835938,80.38368371365354,61.59000015258789,63.59999847412109,98.01009282437799,-1.9899071756220095,0.7741730078974953,0.6700954355356471,0.021700728318372775,699263500.0,1.0
KO,2023-04-19,63.68000030517578,63.83000183105469,63.43000030517578,63.72999954223633,9769500.0,0.11999893188476562,0.0,0.11999893188476562,81.7591964012287,61.65999984741211,63.83000183105469,93.08749360555363,-6.9125063944463685,0.7926526122201025,0.6946068708725383,0.014012756031944518,709033000.0,1.0
KO,2023-04-20,63.959999084472656,64.0,63.43999862670898,63.630001068115234,10706400.0,0.279998779296875,0.0,0.279998779296875,84.65596267749045,61.86000061035156,64.0,98.1307978067267,-1.8692021932732963,0.8204339414512916,0.719772284988289,0.01782302560733906,719739400.0,1.0
KO,2023-04-21,64.05000305175781,64.2699966430664,63.79999923706055,64.0,12931100.0,0.09000396728515625,0.0,0.09000396728515625,85.50946986902132,61.86000061035156,64.2699966430664,90.87162018848751,-9.128379811512492,0.8400300692483214,0.7438238418402956,0.02169412114916547,732670500.0,1.0
KO,2023-04-24,63.95000076293945,64.98999786376953,63.619998931884766,64.75,15532300.0,-0.10000228881835938,0.10000228881835938,0.0,79.81750904349182,62.02000045776367,64.98999786376953,64.9832320147142,-35.01676798528579,0.8378327780240369,0.7626256290770439,0.021891960559274448,717138200.0,-1.0
KO,2023-04-25,63.84999847412109,64.16999816894531,63.630001068115234,64.16999816894531,12818900.0,-0.10000228881836648,0.10000228881836648,0.0,74.12431132480084,62.02000045776367,64.98999786376953,61.61614864231314,-38.38385135768686,0.8185859111132388,0.773817685484283,0.018503746575580404,704319300.0,-1.0
KO,2023-04-26,63.54999923706055,63.77000045776367,63.38999938964844,63.560001373291016,13179600.0,-0.29999923706053977,0.29999923706053977,0.0,59.44700948821575,62.02000045776367,64.98999786376953,51.51515540730599,-48.48484459269402,0.7702462795388314,0.7731034042951928,0.006334088701767104,691139700.0,-1.0
KO,2023-04-27,63.68000030517578,63.7599983215332,63.11000061035156,63.52999877929688,13795800.0,0.13000106811523438,0.0,0.13000106811523438,63.100291255218906,62.02000045776367,64.98999786376953,55.89229957087829,-44.10770042912171,0.7339660690149259,0.7652759372391394,0.009992086847558923,704935500.0,1.0
KO,2023-04-28,64.1500015258789,64.16000366210938,63.47999954223633,63.61000061035156,13686700.0,0.470001220703125,0.0,0.470001220703125,73.17951156522473,62.310001373291016,64.98999786376953,68.65681201915892,-31.343187980841087,0.7346700918341682,0.7591547681581453,0.010873029488824626,718622200.0,1.0
KO,2023-05-01,64.30000305175781,64.69000244140625,64.05999755859375,64.1500015258789,9091500.0,0.15000152587890625,0.0,0.15000152587890625,75.630776684323,62.310001373291016,64.98999786376953,74.25389120981573,-25.74610879018426,0.7388153016135561,0.7550868748492275,0.011642568635590989,727713700.0,1.0
KO,2023-05-02,64.01000213623047,64.13999938964844,63.27000045776367,64.13999938964844,10948400.0,-0.29000091552734375,0.29000091552734375,0.0,62.822506959882176,62.47999954223633,64.98999786376953,60.956319407399306,-39.0436805926007,0.710509449328967,0.7461713897451755,0.005182189533184722,716765300.0,-1.0
KO,2023-05-03,63.650001525878906,64.18000030517578,63.58000183105469,64.0199966430664,11084600.0,-0.3600006103515625,0.3600006103515625,0.0,50.55837565560908,62.77999877929688,64.98999786376953,39.3666564250919,-60.6333435749081,0.6515175283448613,0.7272406174651127,-0.004846741135570265,705680700.0,-1.0
KO,2023-05-04,63.720001220703125,63.93000030517578,63.5099983215332,63.7400016784668,11938300.0,0.06999969482421875,0.0,0.06999969482421875,52.63299429978011,63.11000061035156,64.98999786376953,32.446888379360026,-67.55311162063997,0.6034581068949194,0.7024841153510741,-0.005152253166764376,717619000.0,1.0
KO,2023-05-05,64.0199966430664,64.20999908447266,63.630001068115234,63.63999938964844,9037300.0,0.29999542236328125,0.0,0.29999542236328125,60.77257036397397,63.11000061035156,64.98999786376953,48.40411500923239,-51.5958849907676,0.5828589573218608,0.6785590837452316,0.0010945407238762694,726656300.0,1.0
KO,2023-05-08,63.91999816894531,64.05999755859375,63.61000061035156,63.810001373291016,7240700.0,-0.09999847412109375,0.09999847412109375,0.0,57.00496676474286,63.11000061035156,64.98999786376953,43.085039465941605,-56.9149605340584,0.5521006688965997,0.6532674007755053,0.0010963147454514655,719415600.0,-1.0
KO,2023-05-09,63.38999938964844,63.75,63.27999877929688,63.63999938964844,9067700.0,-0.529998779296875,0.529998779296875,0.0,41.33403541332881,63.11000061035156,64.98999786376953,14.893573848994581,-85.10642615100542,0.47943144435857477,0.6185002094921193,-0.002517700225538322,710347900.0,-1.0
KO,2023-05-10,63.5,63.63999938964844,62.9900016784668,63.31999969482422,10134000.0,0.1100006103515625,0.0,0.1100006103515625,44.95769080136178,62.9900016784668,64.98999786376953,25.49996471398299,-74.50003528601701,0.42580823798950007,0.5799618151915954,-0.0028266379446162393,720481900.0,1.0
KO,2023-05-11,63.86000061035156,63.93000030517578,63.0099983215332,63.58000183105469,9581500.0,0.3600006103515625,0.0,0.3600006103515625,55.367989156149186,62.9900016784668,64.98999786376953,43.5000295639602,-56.4999704360398,0.4076612362413172,0.5455016994015398,-0.004520668879646972,730063400.0,1.0
KO,2023-05-12,64.11000061035156,64.19000244140625,63.70000076293945,63.86000061035156,8739600.0,0.25,0.0,0.25,61.24173953513833,62.9900016784668,64.69000244140625,65.88226054370632,-34.11773945629369,0.4087408076780221,0.5181495210568363,-0.002954936740101055,738803000.0,1.0
KO,2023-05-15,63.93999862670898,64.25,63.709999084472656,64.22000122070312,8150000.0,-0.17000198364258523,0.17000198364258523,0.0,55.50981218759445,62.9900016784668,64.69000244140625,55.882148346777846,-44.117851653222154,0.39136719905236106,0.49279305665594125,-0.0010936339194693723,730653000.0,-1.0
KO,2023-05-16,63.220001220703125,63.900001525878906,63.15999984741211,63.900001525878906,9129600.0,-0.7199974060058523,0.7199974060058523,0.0,38.088747310376085,62.9900016784668,64.69000244140625,13.529378765609398,-86.47062123439059,0.3158596818545476,0.45740638169566256,-0.006755699840807594,721523400.0,-1.0
KO,2023-05-17,63.150001525878906,63.41999816894531,62.72999954223633,63.400001525878906,11583000.0,-0.06999969482421875,0.06999969482421875,0.0,36.79339494056282,62.72999954223633,64.69000244140625,21.428640938258436,-78.57135906174156,0.24751780888618669,0.4154286671337674,-0.00894538110333587,709940400.0,-1.0
KO,2023-05-18,62.79999923706055,63.040000915527344,62.56999969482422,63.0099983215332,13595100.0,-0.3500022888183594,0.3500022888183594,0.0,30.75839176267168,62.56999969482422,64.69000244140625,10.849020955616414,-89.15097904438358,0.16323248014327874,0.3649894297356697,-0.019056505310485528,696345300.0,-1.0
KO,2023-05-19,62.83000183105469,63.09999847412109,62.61000061035156,63.040000915527344,14242100.0,0.030002593994140625,0.0,0.030002593994140625,31.863796695732375,62.56999969482422,64.25,15.476314821458576,-84.52368517854141,0.09773013628848304,0.3115375710462324,-0.017052508903546593,710587400.0,1.0
KO,2023-05-22,61.5099983215332,62.869998931884766,61.43999862670898,62.790000915527344,15055400.0,-1.3200035095214844,1.3200035095214844,0.0,17.60007315957239,61.43999862670898,64.25,2.4910911250638814,-97.50890887493611,-0.06000252289049968,0.237229552258886,-0.029657691847560397,695532000.0,-1.0
KO,2023-05-23,61.400001525878906,61.66999816894531,61.16999816894531,61.5099983215332,13932700.0,-0.10999679565429688,0.10999679565429688,0.0,16.873798160061853,61.16999816894531,64.25,7.467637019385586,-92.53236298061441,-0.19167312534343495,0.15144901673842182,-0.03307084211214317,681599300.0,-1.0
KO,2023-05-24,60.880001068115234,61.43000030517578,60.720001220703125,61.380001068115234,11090100.0,-0.5200004577636719,0.5200004577636719,0.0,13.773505411243121,60.720001220703125,64.25,4.532575148481469,-95.46742485151853,-0.3341310626384981,0.0543330008630378,-0.04666457115180922,670509200.0,-1.0
KO,2023-05-25,60.40999984741211,60.72999954223633,60.150001525878906,60.470001220703125,14463600.0,-0.470001220703125,0.470001220703125,0.0,11.558672449420584,60.150001525878906,64.25,6.341424836479684,-93.65857516352033,-0.4794286201463933,-0.05241932333884846,-0.057713316607612586,656045600.0,-1.0
KO,2023-05-26,60.2599983215332,60.63999938964844,60.11000061035156,60.45000076293945,12570300.0,-0.15000152587890625,0.15000152587890625,0.0,10.912476244271105,60.11000061035156,64.25,3.623133654480519,-96.37686634551949,-0.5997680975216042,-0.16188907817539966,-0.05755396284351133,643475300.0,-1.0
KO,2023-05-30,59.77999877929688,60.20000076293945,59.52000045776367,60.09000015258789,15634200.0,-0.479999542236321,0.479999542236321,0.0,9.045345751756045,59.52000045776367,64.25,5.496793799059945,-94.50320620094006,-0.7255067615407356,-0.2746126148484669,-0.05441319795925159,627841100.0,-1.0
KO,2023-05-31,59.65999984741211,60.27999877929688,59.369998931884766,59.91999816894531,59432200.0,-0.11999893188477273,0.11999893188477273,0.0,8.61990573159268,59.369998931884766,64.25,5.942640410924102,-94.0573595890759,-0.8253246408907984,-0.38475502005693324,-0.05526526673220411,568408900.0,-1.0
KO,2023-06-01,60.0,60.16999816894531,59.77000045776367,59.93999862670898,13402700.0,0.3400001525878906,0.0,0.3400001525878906,20.79847694500465,59.369998931884766,64.25,12.909855127522643,-87.09014487247735,-0.8670016038117083,-0.4812043368078884,-0.0445859756540915,581811600.0,1.0
KO,2023-06-02,61.15999984741211,61.31999969482422,60.08000183105469,60.27000045776367,15256300.0,1.1599998474121094,0.0,1.1599998474121094,48.052726295996266,59.369998931884766,64.25,36.680338601210224,-63.319661398789776,-0.7972385344683062,-0.544411176339972,-0.026579690195348005,597067900.0,1.0
KO,2023-06-05,60.75,61.43999862670898,60.54999923706055,61.0,12915600.0,-0.4099998474121094,0.4099998474121094,0.0,42.13903144783838,59.369998931884766,63.900001525878906,30.46358229341489,-69.53641770658511,-0.7662020601669681,-0.5887693531053713,-0.012355687567416895,584152300.0,-1.0
KO,2023-06-06,60.310001373291016,60.9900016784668,60.119998931884766,60.95000076293945,10943500.0,-0.4399986267089844,0.4399986267089844,0.0,36.56664167074124,59.369998931884766,63.41999816894531,23.209941197137,-76.790058802863,-0.7682536922875229,-0.6246662209418017,-0.017752445040713494,573208800.0,-1.0
KO,2023-06-07,60.220001220703125,60.36000061035156,59.81999969482422,60.0099983215332,16817900.0,-0.09000015258789062,0.09000015258789062,0.0,35.459929621422745,59.369998931884766,63.09999847412109,22.788267912460398,-77.2117320875396,-0.7682855678899898,-0.6533900903314394,-0.010840995989367275,556390900.0,-1.0
KO,2023-06-08,60.369998931884766,60.40999984741211,59.97999954223633,60.130001068115234,15585900.0,0.14999771118164062,0.0,0.14999771118164062,39.00969508800242,59.369998931884766,63.09999847412109,26.80965476474161,-73.19034523525839,-0.7475895211835137,-0.6722299765018543,-0.0006621571863661968,571976800.0,1.0
KO,2023-06-09,60.470001220703125,60.66999816894531,60.16999816894531,60.27000045776367,12581500.0,0.10000228881835938,0.0,0.10000228881835938,41.48544814165713,59.369998931884766,62.869998931884766,31.428636823381694,-68.5713631766183,-0.7148777405113549,-0.6807595293037545,0.0034849469800743993,584558300.0,1.0
KO,2023-06-12,60.209999084472656,60.650001525878906,60.02000045776367,60.59000015258789,14208900.0,-0.26000213623046875,0.26000213623046875,0.0,36.98193871356544,59.369998931884766,61.66999816894531,36.52175787942567,-63.47824212057432,-0.7018430087950165,-0.684976225202007,0.007193046402749204,570349400.0,-1.0
KO,2023-06-13,60.45000076293945,60.66999816894531,60.040000915527344,60.209999084472656,13397800.0,0.24000167846679688,0.0,0.24000167846679688,43.513071590608405,59.369998931884766,61.43999862670898,52.174009192131955,-47.82599080786805,-0.6644869681846473,-0.6808783737985351,0.013241718363189214,583747200.0,1.0
KO,2023-06-14,60.86000061035156,61.08000183105469,60.59999847412109,60.72999954223633,14099700.0,0.4099998474121094,0.0,0.4099998474121094,53.09512866318442,59.369998931884766,61.43999862670898,71.98076802582962,-28.019231974170378,-0.5949403734036522,-0.6636907737195586,0.014333343505859464,597846900.0,1.0
KO,2023-06-15,61.22999954223633,61.29999923706055,60.34000015258789,60.61000061035156,15271400.0,0.3699989318847656,0.0,0.3699989318847656,60.13641256182518,59.369998931884766,61.43999862670898,89.85511519650332,-10.144884803496682,-0.5041567689843873,-0.6317839727725244,0.0011445339273850053,613118300.0,1.0
KO,2023-06-16,61.66999816894531,62.16999816894531,61.47999954223633,61.59999847412109,26735800.0,0.4399986267089844,0.0,0.4399986267089844,66.94516647283149,59.369998931884766,62.16999816894531,82.14285227717053,-17.85714772282947,-0.39218503155108664,-0.5838641845282369,0.015144002780992816,639854100.0,1.0
KO,2023-06-20,61.2599983215332,61.959999084472656,61.2400016784668,61.59000015258789,13971800.0,-0.4099998474121094,0.4099998474121094,0.0,56.55863667347175,59.369998931884766,62.16999816894531,67.49999659401938,-32.500003405980635,-0.3326950822837844,-0.5336303640793464,0.015751897307415774,625882300.0,-1.0
KO,2023-06-21,61.43000030517578,61.720001220703125,60.97999954223633,61.310001373291016,13948700.0,0.17000198364257812,0.0,0.17000198364257812,59.56039903471179,59.77000045776367,62.16999816894531,69.16672627136829,-30.833273728631717,-0.2687333389229991,-0.4806509590480769,0.02009297675099786,639831000.0,1.0
KO,2023-06-22,61.84999847412109,62.09999847412109,61.59000015258789,61.810001373291016,15193400.0,0.4199981689453054,0.0,0.4199981689453054,66.21520585879784,59.81999969482422,62.16999816894531,86.38298286793966,-13.617017132060338,-0.18205424630085076,-0.4209316164986317,0.02451548067619158,655024400.0,1.0
KO,2023-06-23,61.20000076293945,61.970001220703125,61.18000030517578,61.93999862670898,25103600.0,-0.6499977111816335,0.6499977111816335,0.0,51.176472043737824,59.81999969482422,62.16999816894531,58.72348783678929,-41.27651216321071,-0.16392025330026172,-0.3695293438589577,0.012072094054901283,629920800.0,-1.0
KO,2023-06-26,61.220001220703125,61.290000915527344,60.38999938964844,61.209999084472656,12856100.0,0.020000457763671875,0.0,0.020000457763671875,51.567016766908694,59.81999969482422,62.16999816894531,59.57457169849912,-40.42542830150088,-0.14624919373972034,-0.32487331383511026,0.016774657890518574,642776900.0,1.0
KO,2023-06-27,61.09000015258789,61.36000061035156,60.97999954223633,61.220001220703125,9068500.0,-0.13000106811523438,0.13000106811523438,0.0,48.648476104693344,59.81999969482422,62.16999816894531,54.04260776120954,-45.95739223879046,-0.141108144603308,-0.28812027998874984,0.010587251969743638,633708400.0,-1.0
KO,2023-06-28,60.52000045776367,61.040000915527344,60.400001525878906,60.880001068115234,11173200.0,-0.5699996948242188,0.5699996948242188,0.0,37.81954385232809,59.97999954223633,62.16999816894531,24.657591513599666,-75.34240848640033,-0.1809422482048788,-0.2666846736319756,-0.005586594629939268,622535200.0,-1.0
KO,2023-06-29,60.02000045776367,60.34999847412109,59.77000045776367,60.220001220703125,17142300.0,-0.5,0.5,0.0,30.86555781881964,59.77000045776367,62.16999816894531,10.416676600783603,-89.5833233992164,-0.24997532369664555,-0.2633428036449096,-0.01976153998887431,605392900.0,-1.0
KO,2023-06-30,60.220001220703125,60.34999847412109,59.869998931884766,60.0,19737000.0,0.20000076293945312,0.0,0.20000076293945312,36.27367343159364,59.77000045776367,62.16999816894531,18.75004967058468,-81.24995032941533,-0.2852578681500546,-0.2677258165459386,-0.02351219379429703,625129900.0,1.0
KO,2023-07-03,60.58000183105469,60.630001068115234,60.02999877929688,60.20000076293945,9694500.0,0.3600006103515625,0.0,0.3600006103515625,45.18020131709428,59.77000045776367,62.16999816894531,33.75008940705243,-66.24991059294757,-0.2809320879855193,-0.27036707083385475,-0.011100171549294546,634824400.0,1.0
KO,2023-07-05,61.02999877929688,61.09999847412109,60.15999984741211,60.27999877929688,14716600.0,0.4499969482421946,0.0,0.4499969482421946,54.37684041671662,59.77000045776367,62.16999816894531,52.49998013176642,-47.50001986823358,-0.2384442462534082,-0.26398250591776545,-0.006511501284254373,649541000.0,1.0
KO,2023-07-06,60.560001373291016,61.02000045776367,60.5,60.72999954223633,12603900.0,-0.4699974060058665,0.4699974060058665,0.0,45.23208465508292,59.77000045776367,62.16999816894531,32.91673620548522,-67.08326379451478,-0.23993140838108928,-0.2591722864104302,-0.020856865523930845,636937100.0,-1.0
KO,2023-07-07,59.7599983215332,60.5,59.72999954223633,60.310001373291016,14565500.0,-0.8000030517578125,0.8000030517578125,0.0,34.00154000703482,59.72999954223633,62.16999816894531,1.229458859873896,-98.7705411401261,-0.30218021009278573,-0.2677738711469013,-0.02352945136363893,622371600.0,-1.0
KO,2023-07-10,59.310001373291016,60.150001525878906,59.13999938964844,59.970001220703125,15480600.0,-0.4499969482421875,0.4499969482421875,0.0,29.282738255587176,59.13999938964844,62.09999847412109,5.743312034600359,-94.25668796539965,-0.38340418211879523,-0.2908999333412801,-0.031198951475456593,606891000.0,-1.0
KO,2023-07-11,59.52000045776367,59.560001373291016,58.84000015258789,59.459999084472656,15970100.0,0.20999908447265625,0.0,0.20999908447265625,34.19990993807053,58.84000015258789,62.09999847412109,20.858915806311618,-79.14108419368839,-0.42591985509155705,-0.3179039176913355,-0.025699782139511296,622861100.0,1.0
KO,2023-07-12,59.84000015258789,60.04999923706055,59.45000076293945,59.75,14241300.0,0.31999969482421875,0.0,0.31999969482421875,41.368018544118996,58.84000015258789,62.09999847412109,30.674862419244874,-69.32513758075513,-0.42884902657893065,-0.3400929394688546,-0.011235960013753599,637102400.0,1.0
KO,2023-07-13,60.34999847412109,60.459999084472656,59.97999954223633,60.119998931884766,11269800.0,0.509998321533196,0.0,0.509998321533196,51.15343299679228,58.84000015258789,61.970001220703125,48.24274141358229,-51.75725858641772,-0.38557316632189753,-0.3491889848394632,0.0054981341859474675,648372200.0,1.0
KO,2023-07-14,60.900001525878906,61.040000915527344,60.09000015258789,60.13999938964844,11631600.0,0.5500030517578196,0.0,0.5500030517578196,59.5532935358825,58.84000015258789,61.36000061035156,81.74607139234911,-18.253928607650888,-0.30339869428432564,-0.3400309267284357,0.011291934430283757,660003800.0,1.0
KO,2023-07-17,60.810001373291016,61.09999847412109,60.4900016784668,60.7599983215332,10014300.0,-0.09000015258789062,0.09000015258789062,0.0,57.680486646268186,58.84000015258789,61.36000061035156,78.17463741460453,-21.825362585395464,-0.24273894979710775,-0.3205725313421701,0.0037966248808929404,649989500.0,-1.0
KO,2023-07-18,60.56999969482422,61.25,60.40999984741211,60.959999084472656,11152900.0,-0.24000167846679688,0.24000167846679688,0.0,52.59160256343843,58.84000015258789,61.25,71.78421791578225,-28.215782084217757,-0.21159268616149518,-0.29877656230603516,-0.007537261898630576,638836600.0,-1.0
KO,2023-07-19,61.63999938964844,61.790000915527344,60.68000030517578,60.77000045776367,12936000.0,1.0699996948242188,0.0,1.0699996948242188,67.39110246770801,58.84000015258789,61.790000915527344,94.91520382762745,-5.084796172372547,-0.09942292918281481,-0.2589058356813911,0.01783352034126162,651772600.0,1.0
KO,2023-07-20,62.38999938964844,62.40999984741211,61.66999816894531,61.68000030517578,11563000.0,0.75,0.0,0.75,73.96441911372735,58.84000015258789,62.40999984741211,99.43976303996136,-0.5602369600386385,0.049421443711402446,-0.19724037980283235,0.04400938992609671,663335600.0,1.0
KO,2023-07-21,62.43999862670898,62.68000030517578,62.2400016784668,62.459999084472656,12813200.0,0.04999923706053977,0.0,0.04999923706053977,74.36196133164025,58.84000015258789,62.68000030517578,93.7499565382814,-6.250043461718607,0.16946274117226068,-0.12389975560781374,0.05277351510612993,676148800.0,1.0
KO,2023-07-24,62.459999084472656,62.810001373291016,62.400001525878906,62.41999816894531,10251100.0,0.02000045776367898,0.0,0.02000045776367898,74.54138315036502,58.84000015258789,62.810001373291016,91.18382415115805,-8.816175848841947,0.26317646953245344,-0.04648451057976029,0.049395137837662695,686399900.0,1.0
KO,2023-07-25,62.25,62.38999938964844,62.04999923706055,62.29999923706055,13422700.0,-0.20999908447265625,0.20999908447265625,0.0,68.71539154865454,58.84000015258789,62.810001373291016,85.89417629469057,-14.105823705309442,0.3168476805173128,0.026181927639654354,0.04027406151849555,672977200.0,-1.0
KO,2023-07-26,63.04999923706055,63.16999816894531,61.38999938964844,61.86000061035156,17145500.0,0.7999992370605469,0.0,0.7999992370605469,76.71499996093175,58.84000015258789,63.16999816894531,97.22866081158823,-2.771339188411772,0.41910457777219534,0.10476645766616259,0.04473903614259833,690122700.0,1.0
KO,2023-07-27,62.43999862670898,63.27000045776367,62.380001068115234,63.04999923706055,11517100.0,-0.6100006103515696,0.6100006103515696,0.0,62.62597050301797,58.84000015258789,63.27000045776367,81.26406830977045,-18.735931690229542,0.4457832425703785,0.1729698146470058,0.025287308082835747,678605600.0,-1.0
KO,2023-07-28,62.47999954223633,62.77000045776367,62.220001220703125,62.59000015258789,9721800.0,0.040000915527350855,0.0,0.040000915527350855,63.13820036198743,58.84000015258789,63.27000045776367,82.16702345134496,-17.83297654865504,0.46479613568713773,0.23133507885503227,0.027462557658793463,688327400.0,1.0
KO,2023-07-31,61.93000030517578,62.45000076293945,61.72999954223633,62.45000076293945,15577900.0,-0.5499992370605469,0.5499992370605469,0.0,51.86154132907641,59.45000076293945,63.27000045776367,64.92145917175127,-35.078540828248734,0.43052087194544697,0.27117223747311525,0.022453369938976175,672749500.0,-1.0
KO,2023-08-01,61.77000045776367,62.36000061035156,61.619998931884766,62.09000015258789,9281600.0,-0.15999984741210938,0.15999984741210938,0.0,48.92826196301365,59.97999954223633,63.27000045776367,54.40730752016919,-45.59269247983081,0.3859972914774019,0.2941372482739726,0.002109037465971575,663467900.0,-1.0
KO,2023-08-02,61.959999084472656,62.59000015258789,61.560001373291016,61.560001373291016,11059400.0,0.18999862670898438,0.0,0.18999862670898438,52.601518310397815,60.09000015258789,63.27000045776367,58.80499221465947,-41.19500778534053,0.3618719004609616,0.30768417871137044,-0.006892135107908426,674527300.0,1.0
KO,2023-08-03,61.63999938964844,62.119998931884766,61.52999877929688,61.869998931884766,8037400.0,-0.31999969482421875,0.31999969482421875,0.0,46.15094640935642,60.40999984741211,63.27000045776367,43.006967823168814,-56.99303217683119,0.31331930334857816,0.308811203638812,-0.012812287870844652,666489900.0,-1.0
KO,2023-08-04,60.709999084472656,61.88999938964844,60.619998931884766,61.68000030517578,9356600.0,-0.9300003051757812,0.9300003051757812,0.0,32.70271477813314,60.40999984741211,63.27000045776367,10.489481574749378,-89.51051842525062,0.1975208704020801,0.2865531369914656,-0.02801793188682644,657133300.0,-1.0
KO,2023-08-07,61.18999862670898,61.33000183105469,60.7400016784668,60.790000915527344,6982600.0,0.479999542236321,0.0,0.479999542236321,42.65427657032022,60.619998931884766,63.27000045776367,21.50941006100606,-78.49058993899393,0.1428352141078406,0.25780955241474063,-0.017028134510699178,664115900.0,1.0
KO,2023-08-08,60.91999816894531,61.34999847412109,60.619998931884766,61.18999862670898,7956100.0,-0.27000045776366477,0.27000045776366477,0.0,38.918967102537096,60.619998931884766,63.27000045776367,11.320719408304807,-88.6792805916952,0.0768240769148747,0.22161245731476742,-0.03378272948278205,656159800.0,-1.0
KO,2023-08-09,61.060001373291016,61.630001068115234,60.75,60.90999984741211,7904100.0,0.14000320434570312,0.0,0.14000320434570312,41.95994461287249,60.619998931884766,63.27000045776367,16.603856152887218,-83.39614384711278,0.03539880821389829,0.1843697274945936,-0.02210117366702924,664063900.0,1.0
KO,2023-08-10,60.91999816894531,61.72999954223633,60.790000915527344,61.34999847412109,7870300.0,-0.14000320434570312,0.14000320434570312,0.0,39.6804859308046,60.619998931884766,63.27000045776367,11.320719408304807,-88.6792805916952,-0.00862863864452379,0.14577005426677012,-0.024968011919341615,656193600.0,-1.0
KO,2023-08-11,61.16999816894531,61.20000076293945,60.68999862670898,60.84000015258789,8483400.0,0.25,0.0,0.25,45.75242100117178,60.619998931884766,63.27000045776367,20.7546762403517,-79.2453237596483,-0.023081725059014957,0.1119996984016131,-0.012271954343377467,664677000.0,1.0
KO,2023-08-14,60.880001068115234,61.47999954223633,60.75,61.31999969482422,7176300.0,-0.2899971008300781,0.2899971008300781,0.0,40.32002267716912,60.619998931884766,63.27000045776367,9.811395717752871,-90.18860428224713,-0.057276000520531056,0.07814455861718426,-0.014408278825527754,657500700.0,-1.0
KO,2023-08-15,60.470001220703125,60.900001525878906,60.369998931884766,60.68999862670898,7187400.0,-0.4099998474121094,0.4099998474121094,0.0,33.777528541559775,60.369998931884766,63.27000045776367,3.4483529724368536,-96.55164702756315,-0.11612020985777605,0.03929160492219219,-0.02404773863437526,650313300.0,-1.0
KO,2023-08-16,60.47999954223633,60.81999969482422,60.400001525878906,60.540000915527344,8372300.0,0.009998321533203125,0.0,0.009998321533203125,34.07851079868328,60.369998931884766,62.77000045776367,4.583355850629266,-95.41664414937074,-0.16010232873350105,-0.0005871818089464688,-0.018818946445462115,658685600.0,1.0
KO,2023-08-17,60.61000061035156,61.02000045776367,60.45000076293945,60.58000183105469,12873500.0,0.13000106811523438,0.0,0.13000106811523438,38.2865798155518,60.369998931884766,62.59000015258789,10.810880472884735,-89.18911952711527,-0.1823662702396618,-0.03694299949508955,-0.00164714998565485,671559100.0,1.0
KO,2023-08-18,60.95000076293945,61.09000015258789,60.369998931884766,60.540000915527344,11082300.0,0.3400001525878906,0.0,0.3400001525878906,48.2545765638146,60.369998931884766,62.59000015258789,26.12619424015396,-73.87380575984604,-0.17060876186580742,-0.06367615196923312,-0.003922174687952418,682641400.0,1.0
KO,2023-08-21,60.43000030517578,60.93000030517578,60.31999969482422,60.86000061035156,8648500.0,-0.5200004577636719,0.5200004577636719,0.0,37.55112697434045,60.31999969482422,62.59000015258789,4.845840888504991,-95.154159111495,-0.20093429738463442,-0.0911277810523134,-0.008043300697591182,673992900.0,-1.0
KO,2023-08-22,60.060001373291016,60.58000183105469,59.97999954223633,60.34000015258789,9412200.0,-0.3699989318847656,0.3699989318847656,0.0,31.76623048087896,59.97999954223633,62.119998931884766,3.7384043865465926,-96.26159561345341,-0.25191935485162276,-0.12328609581217528,-0.016377333401722205,664580700.0,-1.0
KO,2023-08-23,60.27000045776367,60.43999862670898,60.15999984741211,60.20000076293945,7749500.0,0.20999908447265625,0.0,0.20999908447265625,38.01930882528727,59.97999954223633,61.88999938964844,15.183295219644693,-84.8167047803553,-0.27224197313876175,-0.1530772712774926,-0.0106696935442947,672330200.0,1.0
KO,2023-08-24,60.11000061035156,60.880001068115234,60.09000015258789,60.27000045776367,8955100.0,-0.15999984741210938,0.15999984741210938,0.0,35.18466800365886,59.97999954223633,61.72999954223633,7.428632463727679,-92.57136753627232,-0.2978253003864708,-0.18202687709928828,-0.0173287165329995,663375100.0,-1.0
KO,2023-08-25,60.38999938964844,60.56999969482422,60.0099983215332,60.40999984741211,7629200.0,0.279998779296875,0.0,0.279998779296875,43.66574237446386,59.97999954223633,61.72999954223633,23.428562709263392,-76.57143729073661,-0.2921391122704051,-0.20404932413351168,-0.008048647665405917,671004300.0,1.0
KO,2023-08-28,60.560001373291016,60.72999954223633,60.369998931884766,60.54999923706055,6254300.0,0.17000198364257812,0.0,0.17000198364257812,48.39617412014891,59.97999954223633,61.72999954223633,33.14296177455357,-66.85703822544643,-0.27079348912797485,-0.21739815713240435,0.001488343819597615,677258600.0,1.0
KO,2023-08-29,60.5,60.630001068115234,60.150001525878906,60.560001373291016,8189600.0,-0.060001373291015625,0.060001373291015625,0.0,46.79591163034154,59.97999954223633,61.72999954223633,29.71431187220982,-70.28568812779018,-0.2557701789612139,-0.2250725614981663,0.00033069540203456427,669069000.0,-1.0
KO,2023-08-30,60.470001220703125,60.7400016784668,60.290000915527344,60.63999938964844,9447900.0,-0.029998779296875,0.029998779296875,0.0,45.919976091019414,59.97999954223633,61.47999954223633,32.666778564453125,-67.33322143554688,-0.24347808439884489,-0.22875366607830205,-0.0023098397663524617,659621100.0,-1.0
KO,2023-08-31,59.83000183105469,60.470001220703125,59.810001373291016,60.29999923706055,14663500.0,-0.6399993896484375,0.6399993896484375,0.0,31.435369858121845,59.810001373291016,61.47999954223633,1.1976335145506876,-98.80236648544931,-0.28212692932167016,-0.23942831872697568,-0.01837570004700939,644957600.0,-1.0
KO,2023-09-01,59.310001373291016,60.130001068115234,59.119998931884766,60.0,11257200.0,-0.5200004577636719,0.5200004577636719,0.0,24.260973879045054,59.119998931884766,61.09000015258789,9.64478800365591,-90.35521199634408,-0.35067375967459213,-0.261677406916499,-0.01853382303870088,633700400.0,-1.0
KO,2023-09-05,58.81999969482422,59.31999969482422,58.66999816894531,59.25,12474600.0,-0.4900016784667969,0.4900016784667969,0.0,19.437597947052808,58.66999816894531,61.09000015258789,6.19840507953322,-93.80159492046678,-0.4394707121116923,-0.2972360679555377,-0.02064604812044235,621225800.0,-1.0
KO,2023-09-06,58.77999877929688,58.83000183105469,58.41999816894531,58.619998931884766,13923500.0,-0.040000915527336645,0.040000915527336645,0.0,19.080285600276724,58.41999816894531,61.09000015258789,13.48315890988347,-86.51684109011654,-0.50722371697357,-0.3392335977591442,-0.024722111616889086,607302300.0,-1.0
KO,2023-09-07,58.33000183105469,59.15999984741211,58.29999923706055,58.95000076293945,17628600.0,-0.4499969482421946,0.4499969482421946,0.0,15.40456555259486,58.29999923706055,61.09000015258789,1.0753614390291257,-98.92463856097088,-0.5904234207339769,-0.3894715623541108,-0.029612356699765918,589673700.0,-1.0
1.0,1.0,1.0,1.0,1.0,1.0,1.0,1.0,1.0,1.0,1.0,1.0,1.0,1.0,1.0,1.0,1.0,1.0,1.0,1.0
KO,2023-09-11,58.880001068115234,58.9900016784668,58.22999954223633,58.400001525878906,14767400.0,0.5499992370605469,0.0,0.5499992370605469,35.59428534474071,58.0099983215332,60.880001068115234,30.313655539812373,-69.68634446018763,-0.6434099133183793,-0.48176456685694047,-0.0277410876334081,604441100.0,1.0
KO,2023-09-12,58.29999923706055,59.0,58.18999862670898,58.9900016784668,12292700.0,-0.5800018310546875,0.5800018310546875,0.0,27.58388839613623,58.0099983215332,60.880001068115234,10.104551846604124,-89.89544815339588,-0.6780599554441835,-0.5210236445743892,-0.03636364897420585,592148400.0,-1.0
KO,2023-09-13,58.43999862670898,58.68000030517578,58.34000015258789,58.400001525878906,12641400.0,0.1399993896484304,0.0,0.1399993896484304,31.85510661995039,58.0099983215332,60.880001068115234,14.982574692232397,-85.0174253077676,-0.6863122028876774,-0.5540813562370469,-0.033570407690005744,604789800.0,1.0
KO,2023-09-14,58.459999084472656,58.59000015258789,58.18999862670898,58.2400016784668,12311600.0,0.02000045776367898,0.0,0.02000045776367898,32.511266298172686,58.0099983215332,60.7400016784668,16.483524161116964,-83.51647583888303,-0.6833609391213713,-0.5799372728139118,-0.022898256805182537,617101400.0,1.0
KO,2023-09-15,57.93999862670898,58.63999938964844,57.75,58.40999984741211,55690500.0,-0.520000457763679,0.520000457763679,0.0,25.22481704574183,57.75,60.7400016784668,6.354465553557954,-93.64553444644204,-0.7147426243782533,-0.6068983431267801,-0.023099017279722855,561410900.0,-1.0
KO,2023-09-18,58.29999923706055,58.34999847412109,57.630001068115234,57.97999954223633,13617400.0,0.3600006103515696,0.0,0.3600006103515696,36.57914800620843,57.630001068115234,60.7400016784668,21.543345255793188,-78.45665474420682,-0.7024662023220785,-0.6260119149658399,-0.008840538260142639,575028300.0,1.0
KO,2023-09-19,58.18000030517578,58.38999938964844,57.91999816894531,58.2599983215332,11998900.0,-0.11999893188476562,0.11999893188476562,0.0,34.56073917679339,57.630001068115234,60.7400016784668,17.684859457258227,-82.31514054274177,-0.6944151744532405,-0.63969256686332,-0.01020752784248824,563029400.0,-1.0
KO,2023-09-20,58.43999862670898,58.83000183105469,58.08000183105469,58.29999923706055,14766600.0,0.259998321533196,0.0,0.259998321533196,42.4936476440038,57.630001068115234,60.470001220703125,28.52103926317221,-71.47896073682779,-0.6594532189983298,-0.643644697290322,0.001885767052997478,577796000.0,1.0
KO,2023-09-21,57.540000915527344,58.41999816894531,57.41999816894531,58.369998931884766,15941800.0,-0.8999977111816335,0.8999977111816335,0.0,28.630932082912082,57.41999816894531,60.130001068115234,4.428140893088648,-95.57185910691135,-0.6963409263686771,-0.654183943105993,-0.013543646335130943,561854200.0,-1.0
KO,2023-09-22,57.59999847412109,57.970001220703125,57.5,57.84999847412109,14644100.0,0.059997558593742895,0.0,0.059997558593742895,30.378004264545552,57.41999816894531,59.31999969482422,9.473692664141902,-90.5263073358581,-0.7125199126386121,-0.665851137012517,-0.021739174096029323,576498300.0,1.0
KO,2023-09-25,57.0,57.4900016784668,56.7400016784668,57.400001525878906,12358800.0,-0.5999984741210866,0.5999984741210866,0.0,23.68719159410763,56.7400016784668,59.15999984741211,10.74374042384156,-89.25625957615844,-0.7649389976786978,-0.6856687091457532,-0.02229844346608767,564139500.0,-1.0
KO,2023-09-26,56.52999877929688,56.900001525878906,56.400001525878906,56.72999954223633,11194700.0,-0.4700012207031179,0.4700012207031179,0.0,19.75455640794725,56.400001525878906,59.15999984741211,4.710048278064215,-95.28995172193578,-0.8347838027356573,-0.715491727863734,-0.03268309192839647,552944800.0,-1.0
KO,2023-09-27,55.95000076293945,56.52999877929688,55.68000030517578,56.41999816894531,13766300.0,-0.579998016357429,0.579998016357429,0.0,15.97749386421134,55.68000030517578,59.0,8.132544656091222,-91.86745534390877,-0.9262599583987026,-0.7576453739707278,-0.042935312364722145,539178500.0,-1.0
KO,2023-09-28,55.810001373291016,56.31999969482422,55.70000076293945,56.22999954223633,12484800.0,-0.1399993896484375,0.1399993896484375,0.0,15.169680790876555,55.68000030517578,59.0,3.915695182680354,-96.08430481731965,-0.9985416845636621,-0.8058246360893148,-0.03676212122718425,526693700.0,-1.0
KO,2023-09-29,55.97999954223633,56.27000045776367,55.619998931884766,56.13999938964844,12270000.0,0.1699981689453125,0.0,0.1699981689453125,20.781393443678084,55.619998931884766,59.0,10.650902265906888,-89.3490977340931,-1.030232166690837,-0.8507061422096193,-0.03979416338224284,538963700.0,1.0
KO,2023-10-02,55.47999954223633,56.0099983215332,55.08000183105469,55.90999984741211,11792500.0,-0.5,0.5,0.0,16.971318092857302,55.08000183105469,58.83000183105469,10.666605631510416,-89.33339436848958,-1.0832063943780454,-0.8972061926433046,-0.046407713110638404,527171200.0,-1.0
KO,2023-10-03,54.880001068115234,55.43000030517578,54.77999877929688,55.15999984741211,13604200.0,-0.5999984741210938,0.5999984741210938,0.0,13.535303834387719,54.77999877929688,58.83000183105469,2.4691904559170323,-97.53080954408297,-1.1602293126454555,-0.9498108166437348,-0.06091713966890322,513567000.0,-1.0
KO,2023-10-04,55.040000915527344,55.27999877929688,54.709999084472656,54.88999938964844,12100500.0,0.15999984741210938,0.0,0.15999984741210938,18.605796851310913,54.709999084472656,58.83000183105469,8.009747841271665,-91.99025215872834,-1.194589396820433,-0.9987665326790746,-0.04344803545745801,525667500.0,1.0
KO,2023-10-05,52.380001068115234,54.95000076293945,52.2400016784668,54.7400016784668,29878100.0,-2.6599998474121094,2.6599998474121094,0.0,8.75600214861781,52.2400016784668,58.83000183105469,2.124421645020141,-97.87557835497985,-1.4200898563314723,-1.0830311974095543,-0.09062495736612086,495789400.0,-1.0
KO,2023-10-06,53.13999938964844,53.290000915527344,51.54999923706055,52.040000915527344,30292000.0,0.7599983215332031,0.0,0.7599983215332031,22.314133744634717,51.54999923706055,58.83000183105469,21.84065365443152,-78.15934634556848,-1.5199539986029293,-1.1704157576482295,-0.06771930895353617,526081400.0,1.0
KO,2023-10-09,52.880001068115234,53.150001525878906,52.11000061035156,52.959999084472656,15704700.0,-0.2599983215332031,0.2599983215332031,0.0,21.077824433895444,51.54999923706055,58.83000183105469,18.269249411420716,-81.73075058857928,-1.6016143294666563,-1.256655472011915,-0.06456744719616725,510376700.0,-1.0
KO,2023-10-10,54.02999877929688,54.33000183105469,53.560001373291016,54.130001068115234,20909700.0,1.1499977111816477,0.0,1.1499977111816477,38.47482270984509,51.54999923706055,58.41999816894531,36.0989800264198,-63.9010199735802,-1.5556034968643004,-1.316445076982392,-0.034316388873301906,531286400.0,1.0
KO,2023-10-11,53.709999084472656,54.27999877929688,53.02000045776367,54.220001220703125,21138900.0,-0.31999969482422586,0.31999969482422586,0.0,35.93177538081926,51.54999923706055,57.970001220703125,33.644847040788136,-66.35515295921188,-1.5273544897474096,-1.3586269595353957,-0.03762770537797111,510147500.0,-1.0
KO,2023-10-12,52.810001373291016,53.83000183105469,52.43000030517578,53.7599983215332,19330400.0,-0.8999977111816406,0.8999977111816406,0.0,29.585769952385633,51.54999923706055,57.4900016784668,21.21214845716752,-78.78785154283248,-1.5596110168042543,-1.3988237709891675,-0.056627334670726115,490817100.0,-1.0
KO,2023-10-13,52.88999938964844,53.41999816894531,52.63999938964844,52.7400016784668,14494600.0,0.07999801635742188,0.0,0.07999801635742188,30.838540777891367,51.54999923706055,56.900001525878906,25.046721108671765,-74.95327889132824,-1.56072827154901,-1.4312046711011361,-0.046683492681288685,505311700.0,1.0
KO,2023-10-16,53.43000030517578,53.560001373291016,52.84000015258789,53.02000045776367,12816800.0,0.5400009155273438,0.0,0.5400009155273438,39.255944615758054,51.54999923706055,56.52999877929688,37.751028934251565,-62.248971065748435,-1.5007405403064027,-1.4451118449421896,-0.026421296186560972,518128500.0,1.0
KO,2023-10-17,54.06999969482422,54.09999847412109,53.209999084472656,53.310001373291016,16457200.0,0.6399993896484375,0.0,0.6399993896484375,47.92336566977731,51.54999923706055,56.31999969482422,52.83019320600083,-47.16980679399917,-1.385585066907261,-1.433206489335204,-0.01762356839695256,534585700.0,1.0
KO,2023-10-18,54.04999923706055,54.52999877929688,53.91999816894531,54.09999847412109,12809500.0,-0.020000457763671875,0.020000457763671875,0.0,47.67805697440287,51.54999923706055,56.27000045776367,52.96608799663789,-47.033912003362104,-1.2811688770639265,-1.4027989668809486,0.0318823622545108,521776200.0,-1.0
KO,2023-10-19,54.34999847412109,54.7599983215332,53.86000061035156,54.15999984741211,16202200.0,0.29999923706053977,0.0,0.29999923706053977,51.93612445193278,51.54999923706055,56.0099983215332,62.78026483926078,-37.21973516073922,-1.1608295427252742,-1.354405082049814,0.022770024433014013,537978400.0,1.0
KO,2023-10-20,54.56999969482422,55.02000045776367,54.43999862670898,54.52999877929688,15674600.0,0.2200012207031321,0.0,0.2200012207031321,55.032677683485936,51.54999923706055,55.43000030517578,77.83504191741577,-22.164958082584242,-1.0357678068457332,-1.290677627008998,0.03195912618330099,553653000.0,1.0
KO,2023-10-23,54.08000183105469,54.88999938964844,54.04999923706055,54.380001068115234,21212700.0,-0.48999786376953125,0.48999786376953125,0.0,47.21532431753052,51.54999923706055,55.27999877929688,67.82849609888338,-32.171503901116616,-0.9650694922910077,-1.2255560000654,0.0009254683118180562,532440300.0,-1.0
KO,2023-10-24,55.63999938964844,56.16999816894531,55.29999923706055,55.650001525878906,25290800.0,1.55999755859375,0.0,1.55999755859375,65.31466162084692,51.54999923706055,56.16999816894531,88.52816229806663,-11.471837701933358,-0.7742368822843417,-1.1352921765091883,0.035933724410241785,557731100.0,1.0
KO,2023-10-25,56.119998931884766,56.220001220703125,55.560001373291016,55.7599983215332,16701000.0,0.4799995422363281,0.0,0.4799995422363281,69.07888025351225,51.54999923706055,56.220001220703125,97.85862427535078,-2.1413757246492233,-0.5776103795390739,-1.0237558171151655,0.06267747533647672,574432100.0,1.0
KO,2023-10-26,55.77999877929688,56.630001068115234,55.720001220703125,56.369998931884766,16228400.0,-0.3400001525878835,0.3400001525878835,0.0,63.45089617305167,52.11000061035156,56.630001068115234,81.19464153242804,-18.805358467571963,-0.44409834107570134,-0.9078243219072727,0.05464169829833798,558203700.0,-1.0
KO,2023-10-27,55.2400016784668,56.13999938964844,55.09999847412109,55.54999923706055,13626500.0,-0.5399971008300852,0.5399971008300852,0.0,55.208165489075654,52.43000030517578,56.630001068115234,66.90478244876272,-33.095217551237276,-0.37751063418541975,-0.8017615843629021,0.03387612507866078,544577200.0,-1.0
KO,2023-10-30,56.150001525878906,56.27999877929688,55.41999816894531,55.43000030517578,15014300.0,0.9099998474121094,0.0,0.9099998474121094,64.24087479557471,52.43000030517578,56.630001068115234,88.57144154658698,-11.428558453413018,-0.24844608245007294,-0.6910984839803364,0.03846868582937679,559591500.0,1.0
KO,2023-10-31,56.4900016784668,56.720001220703125,56.150001525878906,56.56999969482422,16639400.0,0.3400001525878906,0.0,0.3400001525878906,67.10101536108924,52.43000030517578,56.720001220703125,94.63870645332821,-5.361293546671789,-0.11737331797861827,-0.5763534507799928,0.045143431560554115,576230900.0,1.0
KO,2023-11-01,56.43999862670898,56.880001068115234,56.2599983215332,56.79999923706055,14110800.0,-0.050003051757819605,0.050003051757819605,0.0,66.20247003241725,52.63999938964844,56.880001068115234,89.62258803714992,-10.377411962850069,-0.017332240906405616,-0.46454920880527534,0.03845446570864297,562120100.0,-1.0
KO,2023-11-02,57.09000015258789,57.150001525878906,56.36000061035156,56.5,13087200.0,0.6500015258789134,0.0,0.6500015258789134,71.85537990992715,52.84000015258789,57.150001525878906,98.60785721176697,-1.3921427882330346,0.11309701232178782,-0.3490199645798627,0.04617922799810259,575207300.0,1.0
KO,2023-11-03,56.7400016784668,57.59000015258789,56.70000076293945,57.400001525878906,13956500.0,-0.34999847412109375,0.34999847412109375,0.0,65.09128593136383,53.209999084472656,57.59000015258789,80.59364687582466,-19.406353124175332,0.1860762126439326,-0.24200072913510362,0.04918638604565739,561250800.0,-1.0
KO,2023-11-06,56.970001220703125,57.27999877929688,56.7400016784668,56.77999877929688,12673200.0,0.22999954223632812,0.0,0.22999954223632812,67.41696910458796,53.86000061035156,57.59000015258789,83.37804268166092,-16.621957318339085,0.25948066398476755,-0.14170445051112937,0.023903699598208927,573924000.0,1.0
KO,2023-11-07,57.18000030517578,57.400001525878906,56.72999954223633,56.91999816894531,10449300.0,0.20999908447265625,0.0,0.20999908447265625,69.55388265515495,53.86000061035156,57.59000015258789,89.00804563728462,-10.99195436271537,0.330786293124433,-0.04720630178401687,0.0188881217652479,584373300.0,1.0
KO,2023-11-08,57.09000015258789,57.470001220703125,56.91999816894531,57.31999969482422,13744000.0,-0.09000015258789062,0.09000015258789062,0.0,67.36899411442629,54.04999923706055,57.59000015258789,85.87570986756323,-14.124290132436773,0.3757033830630334,0.03737563518539321,0.023485145248465455,570629300.0,-1.0
KO,2023-11-09,56.65999984741211,57.13999938964844,56.369998931884766,57.02999877929688,12021100.0,-0.43000030517578125,0.43000030517578125,0.0,57.42458078913385,54.04999923706055,57.59000015258789,73.72881173288506,-26.271188267114947,0.3723112966127289,0.10436276747086036,0.025705976209244863,558608200.0,-1.0
KO,2023-11-10,56.720001220703125,56.93000030517578,56.060001373291016,56.869998931884766,11678900.0,0.060001373291015625,0.0,0.060001373291015625,58.41294631834783,55.09999847412109,57.59000015258789,65.06030741230425,-34.939692587695745,0.37019724958099687,0.1575296638928877,0.010151374520649181,570287100.0,1.0
KO,2023-11-13,56.93000030517578,57.09999847412109,56.59999847412109,56.619998931884766,12798200.0,0.20999908447265625,0.0,0.20999908447265625,61.977487123772804,55.09999847412109,57.59000015258789,73.49399989888768,-26.506000101112313,0.3810742365701216,0.2022385784283345,0.007788964659859454,583085300.0,1.0
KO,2023-11-14,57.09999847412109,57.2400016784668,56.810001373291016,57.02000045776367,12697100.0,0.1699981689453054,0.0,0.1699981689453054,64.79595298653328,55.09999847412109,57.59000015258789,80.32123099738158,-19.678769002618427,0.3988144736248245,0.24155375746763255,0.011693831741161231,595782400.0,1.0
KO,2023-11-15,57.209999084472656,57.34000015258789,56.75,57.29999923706055,10201900.0,0.1100006103515696,0.0,0.1100006103515696,66.6421126551012,55.09999847412109,57.59000015258789,84.73892321433226,-15.261076785667735,0.41694360292791544,0.27663172655968915,0.002101925583535502,605984300.0,1.0
KO,2023-11-16,57.150001525878906,57.52999877929688,56.810001373291016,57.25,16010400.0,-0.05999755859375,0.05999755859375,0.0,64.51294469193044,55.41999816894531,57.59000015258789,79.72358412454535,-20.276415875454642,0.421609712631664,0.30562732377408414,0.007225939994423891,589973900.0,-1.0
KO,2023-11-17,57.2599983215332,57.34000015258789,56.70000076293945,57.18999862670898,14475800.0,0.10999679565429688,0.0,0.10999679565429688,66.7595288849627,56.060001373291016,57.59000015258789,78.431235663708,-21.568764336292013,0.4292355006553805,0.33034895915034346,0.005090347456841782,604449700.0,1.0
KO,2023-11-20,57.400001525878906,57.58000183105469,56.959999084472656,57.04999923706055,13051000.0,0.14000320434570312,0.0,0.14000320434570312,69.58711716588739,56.060001373291016,57.59000015258789,87.58177919617034,-12.41822080382966,0.44148689503025196,0.3525765463263252,0.003847520453462039,617500700.0,1.0
KO,2023-11-21,58.02999877929688,58.040000915527344,57.33000183105469,57.459999084472656,13891600.0,0.6299972534179759,0.0,0.6299972534179759,78.9044028677462,56.060001373291016,58.040000915527344,99.49484148773263,-0.5051585122673636,0.49631056730567025,0.38132335052219424,0.016465206239211883,631392300.0,1.0
KO,2023-11-22,58.41999816894531,58.540000915527344,58.130001068115234,58.2599983215332,11320600.0,0.3899993896484304,0.0,0.3899993896484304,82.69191491870326,56.060001373291016,58.540000915527344,95.16117868014527,-4.838821319854734,0.5647186884357893,0.4180024181049133,0.031062448398746056,642712900.0,1.0
KO,2023-11-24,58.56999969482422,58.75,58.34000015258789,58.459999084472656,4816000.0,0.15000152587890625,0.0,0.15000152587890625,83.9692250961925,56.060001373291016,58.75,93.3085354249419,-6.691464575058107,0.623845187813707,0.45917097204667207,0.03261633346802251,647528900.0,1.0
KO,2023-11-27,58.459999084472656,58.68999862670898,58.27000045776367,58.540000915527344,16246500.0,-0.1100006103515625,0.1100006103515625,0.0,79.03398210673093,56.060001373291016,58.75,89.21929131680865,-10.780708683191358,0.6542850439043875,0.4981937864182152,0.026875088197703345,631282400.0,-1.0
KO,2023-11-28,58.58000183105469,58.83000183105469,58.36000061035156,58.400001525878906,13739600.0,0.12000274658203125,0.0,0.12000274658203125,80.47826047511808,56.060001373291016,58.83000183105469,90.97473073337198,-9.025269266628015,0.6802505628605573,0.5346051417066837,0.025919499062760476,645022000.0,1.0
KO,2023-11-29,58.22999954223633,58.66999816894531,58.09999847412109,58.58000183105469,11263600.0,-0.3500022888183594,0.3500022888183594,0.0,65.33247869945527,56.060001373291016,58.83000183105469,78.33927113128479,-21.660728868715218,0.664921364497566,0.5606683862648602,0.017829059152012938,633758400.0,-1.0
KO,2023-11-30,58.43999862670898,58.459999084472656,57.59999847412109,57.959999084472656,22727500.0,0.20999908447264914,0.0,0.20999908447264914,69.32862015241838,56.060001373291016,58.83000183105469,85.92046426372887,-14.079535736271136,0.662085921071423,0.5809518932261727,0.022572127145892074,656485900.0,1.0
KO,2023-12-01,58.63999938964844,58.68999862670898,58.2400016784668,58.27000045776367,15369600.0,0.20000076293946023,0.0,0.20000076293946023,72.77700778159283,56.59999847412109,58.83000183105469,91.47972397371116,-8.520276026288842,0.6682737579256468,0.5984162661660676,0.02410061314298484,671855500.0,1.0
KO,2023-12-04,58.56999969482422,58.959999084472656,58.43999862670898,58.59000015258789,14942200.0,-0.06999969482421875,0.06999969482421875,0.0,69.61614853208232,56.70000076293945,58.959999084472656,82.74337702233963,-17.256622977660374,0.659922101652505,0.6107174332633551,0.020383242819563607,656913300.0,-1.0
KO,2023-12-05,58.65999984741211,58.83000183105469,58.41999816894531,58.54999923706055,11891500.0,0.09000015258789062,0.0,0.09000015258789062,71.45535551071418,56.70000076293945,58.959999084472656,86.725687616572,-13.274312383427997,0.6530378007714077,0.6191815067649658,0.010856472193137234,668804800.0,1.0
KO,2023-12-06,58.59999847412109,58.72999954223633,58.209999084472656,58.560001373291016,14868500.0,-0.06000137329102273,0.06000137329102273,0.0,68.27612163938193,56.70000076293945,58.959999084472656,84.07075762307018,-15.92924237692982,0.6354156571886875,0.6224283368497101,0.0030811419174514576,653936300.0,-1.0
KO,2023-12-07,58.7400016784668,58.88999938964844,58.38999938964844,58.66999816894531,11587900.0,0.14000320434571023,0.0,0.14000320434571023,71.66973960835534,56.70000076293945,58.959999084472656,90.26559427457401,-9.734405725425988,0.6255362771535857,0.6230499249104853,0.0029025437003307175,665524200.0,1.0
KO,2023-12-08,58.61000061035156,58.75,58.369998931884766,58.7400016784668,11177600.0,-0.13000106811523438,0.13000106811523438,0.0,64.30011637798717,56.959999084472656,58.959999084472656,82.50007629394531,-17.499923706054688,0.6002969480211178,0.6184993295326118,0.0025658831376675906,654346600.0,-1.0
KO,2023-12-11,59.040000915527344,59.09000015258789,58.5,58.83000183105469,14524800.0,0.43000030517578125,0.0,0.43000030517578125,74.36173481851772,57.33000183105469,59.09000015258789,97.1591315486602,-2.8408684513398055,0.6079835726405136,0.6163961781541922,0.007852493514754366,668871400.0,1.0
KO,2023-12-12,59.41999816894531,59.41999816894531,58.900001525878906,59.20000076293945,12899000.0,0.37999725341796875,0.0,0.37999725341796875,80.08497016924485,57.59999847412109,59.41999816894531,100.0,-0.0,0.6373904403769117,0.6205950305987362,0.02043617784756857,681770400.0,1.0
KO,2023-12-13,59.93000030517578,60.02000045776367,59.2599983215332,59.45000076293945,16196800.0,0.5100021362304688,0.0,0.5100021362304688,85.20092748805973,57.59999847412109,60.02000045776367,96.28098847867793,-3.71901152132208,0.6938502314893142,0.6352460707768519,0.025496264775506372,697967200.0,1.0
KO,2023-12-14,59.040000915527344,60.040000915527344,58.77000045776367,59.970001220703125,22478300.0,-0.8899993896484375,0.8899993896484375,0.0,56.154349616140664,57.59999847412109,60.040000915527344,59.01643444980876,-40.983565550191244,0.6591808831126755,0.6400330332440167,0.006821308493218048,675488900.0,-1.0
KO,2023-12-15,58.59999847412109,59.16999816894531,57.79999923706055,58.83000183105469,65172300.0,-0.4400024414062571,0.4400024414062571,0.0,47.01173851081013,57.59999847412109,60.040000915527344,40.983565550191244,-59.01643444980876,0.5894063455189382,0.6299076956990011,0.0005121867757071907,610316600.0,-1.0
KO,2023-12-18,59.02000045776367,59.4900016784668,58.619998931884766,58.79999923706055,16717700.0,0.42000198364258523,0.0,0.42000198364258523,55.068836919260185,57.59999847412109,60.040000915527344,58.196744378017485,-41.803255621982515,0.5615272353241778,0.6162316036240365,0.006137071450528664,627034300.0,1.0
KO,2023-12-19,58.83000183105469,59.20000076293945,58.63999938964844,59.0,14612200.0,-0.18999862670898438,0.18999862670898438,0.0,51.01951460382044,57.59999847412109,60.040000915527344,50.40992320584351,-49.590076794156495,0.5181288712423822,0.5966110571477057,0.003924972063526155,612422100.0,-1.0
KO,2023-12-20,57.61000061035156,58.66999816894531,57.56999969482422,58.5,17701000.0,-1.220001220703125,1.220001220703125,0.0,33.02669385065593,57.56999969482422,60.040000915527344,1.619469463904024,-98.38053053609597,0.380900666720585,0.5534689790622815,-0.019237334624208513,594721100.0,-1.0
KO,2023-12-21,57.9900016784668,58.06999969482422,57.470001220703125,57.84999847412109,11725100.0,0.3800010681152344,0.0,0.3800010681152344,40.56043989710325,57.470001220703125,60.040000915527344,20.233483249469355,-79.76651675053064,0.2993584188483709,0.5026468670194995,-0.01057838125624011,606446200.0,1.0
KO,2023-12-22,58.31999969482422,58.459999084472656,58.02000045776367,58.119998931884766,9028500.0,0.3299980163574219,0.0,0.3299980163574219,46.581529693642956,57.470001220703125,60.040000915527344,33.07387451574119,-66.9261254842588,0.25838517844311326,0.4537945293042222,-0.012195142437976592,615474700.0,1.0
KO,2023-12-26,58.560001373291016,58.709999084472656,58.060001373291016,58.060001373291016,6422500.0,0.24000167846679688,0.0,0.24000167846679688,50.7666661177222,57.470001220703125,60.040000915527344,42.41246233542622,-57.58753766457377,0.24248450941705357,0.41153252532678847,-0.014473187851825942,621897200.0,1.0
KO,2023-12-27,58.709999084472656,58.77000045776367,58.400001525878906,58.63999938964844,8560100.0,0.14999771118164062,0.0,0.14999771118164062,53.39952037109501,57.470001220703125,60.040000915527344,48.24894984488875,-51.751050155111244,0.23922899344340465,0.37707181895011177,-0.020357103528960918,630457300.0,1.0
KO,2023-12-28,58.75,58.869998931884766,58.52999877929688,58.650001525878906,8400100.0,0.04000091552734375,0.0,0.04000091552734375,54.15392259918451,57.470001220703125,60.040000915527344,49.8054058868059,-50.1945941131941,0.2371430754042052,0.34908607024093047,-0.004911939549971711,638857400.0,1.0
KO,2023-12-29,58.93000030517578,58.97999954223633,58.630001068115234,58.7400016784668,9241600.0,0.18000030517578125,0.0,0.18000030517578125,57.70871825117273,57.470001220703125,60.040000915527344,56.8093096436152,-43.19069035638479,0.2471653226478594,0.3287019207223163,0.005631430710709484,648099000.0,1.0
KO,2024-01-02,59.81999969482422,59.880001068115234,58.66999816894531,58.79999923706055,16322600.0,0.8899993896484375,0.0,0.8899993896484375,70.6791283537112,57.470001220703125,60.040000915527344,91.43964020127355,-8.560359798726456,0.3231979141338215,0.32760111940461734,0.013554714179188299,664421600.0,1.0
KO,2024-01-03,59.959999084472656,60.20000076293945,59.7599983215332,59.93000030517578,14830600.0,0.1399993896484375,0.0,0.1399993896484375,72.22522874917951,57.470001220703125,60.20000076293945,91.2087282523793,-8.791271747620705,0.3902524836844137,0.34013139226057665,0.019207839847821928,679252200.0,1.0
KO,2024-01-04,59.7599983215332,60.2599983215332,59.65999984741211,60.04999923706055,12912900.0,-0.20000076293945312,0.20000076293945312,0.0,66.4495102799839,57.470001220703125,60.2599983215332,82.07883442419204,-17.921165575807958,0.42238631653162173,0.3565823771147857,0.03731986961297351,666339300.0,-1.0
KO,2024-01-05,59.66999816894531,59.95000076293945,59.09000015258789,59.79999923706055,10411400.0,-0.09000015258789062,0.09000015258789062,0.0,63.80040027151164,57.470001220703125,60.2599983215332,78.8530191514409,-21.146980848559096,0.43556937776921245,0.37237977724567106,0.028970450799320258,655927900.0,-1.0
KO,2024-01-08,60.11000061035156,60.18000030517578,59.41999816894531,59.68000030517578,11554600.0,0.44000244140625,0.0,0.44000244140625,70.44662523254937,57.470001220703125,60.2599983215332,94.62373236384319,-5.376267636156805,0.4760341432639166,0.3931106504493202,0.030692745625754858,667482500.0,1.0
KO,2024-01-09,60.0,60.13999938964844,59.619998931884766,59.9900016784668,10493700.0,-0.1100006103515625,0.1100006103515625,0.0,66.90333326317294,57.470001220703125,60.2599983215332,90.68105406074262,-9.318945939257379,0.4935374391275644,0.41319600818496904,0.02459013990675496,656988800.0,-1.0
KO,2024-01-10,60.20000076293945,60.40999984741211,59.97999954223633,60.220001220703125,12258000.0,0.20000076293945312,0.0,0.20000076293945312,70.0623302027515,57.470001220703125,60.40999984741211,92.85717066107178,-7.142829338928225,0.517580966102777,0.4340729997685307,0.025379010419042336,669246800.0,1.0
KO,2024-01-11,59.810001373291016,60.2599983215332,59.68999862670898,60.25,13754200.0,-0.3899993896484375,0.3899993896484375,0.0,57.67605612191561,57.470001220703125,60.40999984741211,79.59187910258557,-20.408120897414438,0.49940906622703096,0.4471402130602308,0.018042576566655644,655492600.0,-1.0
KO,2024-01-12,60.38999938964844,60.459999084472656,59.869998931884766,60.08000183105469,13216900.0,0.5799980163574219,0.0,0.5799980163574219,67.52719428491747,58.02000045776367,60.459999084472656,97.13115843353434,-2.8688415664656652,0.5257481993531528,0.46286181031881524,0.02477514130174585,668709500.0,1.0
KO,2024-01-16,59.9900016784668,60.43000030517578,59.84999847412109,60.38999938964844,11826900.0,-0.3999977111816406,0.3999977111816406,0.0,56.974574809680426,58.060001373291016,60.459999084472656,80.4167560737191,-19.583243926280904,0.508484190518935,0.47198628635883927,0.0028418920847519402,656882600.0,-1.0
1.0,1.0,1.0,1.0,1.0,1.0,1.0,1.0,1.0,1.0,1.0,1.0,1.0,1.0,1.0,1.0,1.0,1.0,1.0,1.0
KO,2024-01-18,60.15999984741211,60.22999954223633,59.52999877929688,59.68999862670898,10397700.0,0.1699981689453125,0.0,0.1699981689453125,60.46993290096054,58.52999877929688,60.459999084472656,84.45600053761522,-15.543999462384775,0.48201291856334905,0.4767399775490087,0.006693466149827021,667280300.0,1.0
KO,2024-01-19,59.83000183105469,60.27999877929688,59.63999938964844,60.2599983215332,14193100.0,-0.3299980163574219,0.3299980163574219,0.0,51.16062603086496,58.630001068115234,60.459999084472656,65.573883261799,-34.426116738201,0.44459290662938145,0.4703105633650833,0.002681475901111119,653087200.0,-1.0
KO,2024-01-22,59.56999969482422,60.06999969482422,59.43999862670898,59.7599983215332,14314300.0,-0.26000213623046875,0.26000213623046875,0.0,44.87947645610442,58.66999816894531,60.459999084472656,50.27938913728215,-49.72061086271785,0.3894677364789203,0.45414199798785077,-0.008983545334290799,638772900.0,-1.0
KO,2024-01-23,59.84999847412109,60.0,59.459999084472656,59.52999877929688,14481600.0,0.2799987792968679,0.0,0.2799987792968679,52.17542165881741,59.09000015258789,60.459999084472656,55.47437328930134,-44.52562671069866,0.36417620680092,0.43614883975046465,-0.0025000254313152226,653254500.0,1.0
KO,2024-01-24,58.90999984741211,59.810001373291016,58.88999938964844,59.79999923706055,16370500.0,-0.9399986267089773,0.9399986267089773,0.0,34.49094233854224,58.88999938964844,60.459999084472656,1.2739147548631324,-98.72608524513686,0.26522510413281,0.4019640926269337,-0.021428586365093483,636884000.0,-1.0
KO,2024-01-25,59.15999984741211,59.16999816894531,58.65999984741211,59.0099983215332,14899700.0,0.25,0.0,0.25,40.6627762339595,58.65999984741211,60.459999084472656,27.77778955153976,-72.22221044846025,0.2046198230779268,0.3624952387171324,-0.010867773130819103,651783700.0,1.0
KO,2024-01-26,59.369998931884766,59.4900016784668,59.130001068115234,59.25,13025100.0,0.20999908447265625,0.0,0.20999908447265625,45.62773453202299,58.65999984741211,60.459999084472656,39.44441030053469,-60.55558969946531,0.1715572669036618,0.3243076443544383,-0.016890221362355406,664808800.0,1.0
KO,2024-01-29,59.72999954223633,59.790000915527344,59.16999816894531,59.34000015258789,14547100.0,0.3600006103515625,0.0,0.3600006103515625,53.348917595531326,58.65999984741211,60.459999084472656,59.44445268607783,-40.55554731392217,0.17241648363956585,0.29392941221146385,-0.004334091164458043,679355900.0,1.0
KO,2024-01-30,59.900001525878906,60.02000045776367,59.45000076293945,59.84999847412109,22061500.0,0.17000198364257812,0.0,0.17000198364257812,56.69934022333009,58.65999984741211,60.459999084472656,68.88901133601351,-31.11098866398649,0.18468621073304092,0.2720807719157793,-0.0015002525432533664,701417400.0,1.0
KO,2024-01-31,59.4900016784668,60.45000076293945,59.290000915527344,60.09999847412109,22837000.0,-0.4099998474121094,0.4099998474121094,0.0,47.255151787591736,58.65999984741211,60.459999084472656,46.11123238085953,-53.88876761914047,0.15948801808414004,0.24956222114945142,-0.011136937676939351,678580400.0,-1.0
KO,2024-02-01,60.97999954223633,61.0099983215332,59.36000061035156,59.56999969482422,15870900.0,1.4899978637695312,0.0,1.4899978637695312,68.94533865111086,58.65999984741211,61.0099983215332,98.72345537125956,-1.2765446287404347,0.25678854553360253,0.2510074860262817,0.019221087681543958,694451300.0,1.0
KO,2024-02-02,60.540000915527344,60.869998931884766,60.22999954223633,60.81999969482422,17543500.0,-0.4399986267089844,0.4399986267089844,0.0,60.472058235714016,58.65999984741211,61.0099983215332,80.00009739658918,-19.99990260341083,0.2949951817689822,0.2598050251748218,0.016283384684781188,676907800.0,-1.0
KO,2024-02-05,60.040000915527344,60.380001068115234,59.880001068115234,60.380001068115234,12759600.0,-0.5,0.5,0.0,52.07973794155366,58.65999984741211,61.0099983215332,58.72348783678929,-41.27651216321071,0.2816813476882132,0.26418028967750007,0.0031746440476254634,664148200.0,-1.0
KO,2024-02-06,59.93999862670898,60.04999923706055,59.68000030517578,59.959999084472656,12775200.0,-0.10000228881836648,0.10000228881836648,0.0,50.463546108746065,58.65999984741211,61.0099983215332,54.46806852823984,-45.53193147176016,0.26006284669141166,0.26335680108028237,0.017484277405614534,651373000.0,-1.0
KO,2024-02-07,59.9900016784668,60.209999084472656,59.93999862670898,60.06999969482422,10259900.0,0.050003051757819605,0.0,0.050003051757819605,51.33486381198423,58.65999984741211,61.0099983215332,56.595859346339026,-43.404140653660974,0.24415044295446364,0.25951552945511863,0.014029780818043625,661632900.0,1.0
KO,2024-02-08,59.83000183105469,59.970001220703125,59.40999984741211,59.88999938964844,12874800.0,-0.15999984741210938,0.15999984741210938,0.0,48.20439605858733,58.65999984741211,61.0099983215332,49.78735078030901,-50.212649219690995,0.21613759814815836,0.2508399431937266,0.007748069857600681,648758100.0,-1.0
KO,2024-02-09,59.560001373291016,59.58000183105469,59.02999877929688,59.470001220703125,15235300.0,-0.2700004577636719,0.2700004577636719,0.0,43.0881912370679,58.65999984741211,61.0099983215332,38.29796213869924,-61.70203786130076,0.17018860802932778,0.23470967616084684,-0.002846110333972196,633522800.0,-1.0
KO,2024-02-12,59.70000076293945,59.7599983215332,58.959999084472656,59.65999984741211,13516800.0,0.1399993896484375,0.0,0.1399993896484375,46.48628918215844,58.65999984741211,61.0099983215332,44.25538684301942,-55.74461315698057,0.14341725815855,0.21645119256038747,-0.003338910815437024,647039600.0,1.0
KO,2024-02-13,59.34999847412109,60.65999984741211,58.790000915527344,59.5,24195700.0,-0.3500022888183665,0.3500022888183665,0.0,39.65605410155319,58.65999984741211,61.0099983215332,29.361662754570034,-70.63833724542997,0.0928877586314556,0.1917385057746011,-0.0023533904924462057,622843900.0,-1.0
KO,2024-02-14,59.290000915527344,59.59000015258789,59.040000915527344,59.16999816894531,15872500.0,-0.059997558593742895,0.059997558593742895,0.0,38.53612779484692,58.790000915527344,61.0099983215332,22.522548839351224,-77.47745116064877,0.047454439414643446,0.1628816925026096,-0.02771398227936106,606971400.0,-1.0
KO,2024-02-15,59.400001525878906,59.59000015258789,59.130001068115234,59.41999816894531,13695800.0,0.1100006103515625,0.0,0.1100006103515625,42.00117056333684,58.790000915527344,61.0099983215332,27.477537077354246,-72.52246292264576,0.020092720176926093,0.13432389803747288,-0.018830514905989193,620667200.0,1.0
KO,2024-02-16,59.38999938964844,59.619998931884766,58.959999084472656,59.34999847412109,13943300.0,-0.01000213623046875,0.01000213623046875,0.0,41.754206086106294,58.790000915527344,61.0099983215332,27.026989873857094,-72.97301012614291,-0.0023713923174639717,0.1069848399664855,-0.010826141172006642,606723900.0,-1.0
KO,2024-02-20,60.70000076293945,60.84000015258789,59.5099983215332,59.59999847412109,18339300.0,1.3100013732910156,0.0,1.3100013732910156,69.15906344158502,58.790000915527344,61.0099983215332,86.03612969298524,-13.963870307014755,0.08455707801148549,0.10249928757548549,0.012679381942658718,625063200.0,1.0
KO,2024-02-21,61.2400016784668,61.27999877929688,60.83000183105469,60.9900016784668,14378300.0,0.5400009155273438,0.0,0.5400009155273438,74.79875789157029,58.790000915527344,61.27999877929688,98.3936893516232,-1.6063106483768117,0.1947768120946165,0.1209547924793117,0.02083680555136036,639441500.0,1.0
KO,2024-02-22,61.150001525878906,61.25,60.5,60.9900016784668,12982800.0,-0.09000015258789062,0.09000015258789062,0.0,72.25773251267303,58.790000915527344,61.27999877929688,94.77922229133254,-5.220777708667454,0.27173212648784073,0.15111025928101754,0.022062504670341987,626458700.0,-1.0
KO,2024-02-23,61.20000076293945,61.619998931884766,61.0,61.09000015258789,13612900.0,0.049999237060546875,0.0,0.049999237060546875,72.8489793293665,58.790000915527344,61.619998931884766,85.15906489977314,-14.84093510022686,0.3329166324419077,0.1874715339131956,0.027535247680230412,640071600.0,1.0
KO,2024-02-26,60.709999084472656,61.27000045776367,60.65999984741211,61.2400016784668,10336100.0,-0.4900016784667969,0.4900016784667969,0.0,58.702048908679764,58.790000915527344,61.619998931884766,67.84450582112427,-32.15549417887573,0.33797083646052073,0.21757139442266066,0.016917894616848894,629735500.0,-1.0
KO,2024-02-27,60.34000015258789,60.77999877929688,60.119998931884766,60.540000915527344,9931100.0,-0.3699989318847656,0.3699989318847656,0.0,50.207201694464935,58.790000915527344,61.619998931884766,54.77032945258382,-45.22967054741618,0.3085635791001238,0.23576983135815333,0.016680736376067262,619804400.0,-1.0
KO,2024-02-28,60.400001525878906,60.4900016784668,60.060001373291016,60.369998931884766,8076500.0,0.060001373291015625,0.0,0.060001373291015625,51.519928021195426,58.790000915527344,61.619998931884766,56.890520807638026,-43.109479192361974,0.2867937453725986,0.24597461416104238,0.01872154820731109,627880900.0,1.0
KO,2024-02-29,60.02000045776367,60.63999938964844,59.900001525878906,60.34999847412109,18152700.0,-0.3800010681152344,0.3800010681152344,0.0,43.19769665800793,58.790000915527344,61.619998931884766,43.46291181572977,-56.537088184270225,0.23615582752706388,0.24401085683424667,0.01043769218784707,609728200.0,-1.0
KO,2024-03-01,59.52999877929688,59.900001525878906,59.34000015258789,59.900001525878906,10924800.0,-0.49000167846678977,0.49000167846678977,0.0,34.82731611746905,58.790000915527344,61.619998931884766,26.148352737081154,-73.85164726291885,0.15470255768460106,0.22614919700431757,0.0023572889558380883,598803400.0,-1.0
KO,2024-03-04,59.810001373291016,59.95000076293945,59.220001220703125,59.22999954223633,10150200.0,0.2800025939941335,0.0,0.2800025939941335,42.210534039029945,58.790000915527344,61.619998931884766,36.04244426561634,-63.957555734383654,0.11145929043224356,0.20321121568990275,-0.014662263236606576,608953600.0,1.0
KO,2024-03-05,59.52000045776367,60.11000061035156,59.41999816894531,59.90999984741211,12310000.0,-0.29000091552734375,0.29000091552734375,0.0,37.177340595242164,58.959999084472656,61.619998931884766,21.05268441409258,-78.94731558590742,0.05317507023026735,0.17320398659797567,-0.028086237321379937,596643600.0,-1.0
KO,2024-03-06,59.54999923706055,60.0,59.380001068115234,59.52000045776367,12378800.0,0.029998779296875,0.0,0.029998779296875,38.058904456572115,58.959999084472656,61.619998931884766,22.180458136563303,-77.8195418634367,0.009297876452059484,0.14042276456879244,-0.026165204397275987,609022400.0,1.0
KO,2024-03-07,59.43999862670898,59.77000045776367,59.2400016784668,59.68999862670898,13686900.0,-0.1100006103515696,0.1100006103515696,0.0,35.92593350002224,58.959999084472656,61.619998931884766,18.045096607930574,-81.95490339206943,-0.03395977848998655,0.10554625595703664,-0.028758204481857952,595335500.0,-1.0
KO,2024-03-08,59.52000045776367,59.790000915527344,58.970001220703125,59.29999923706055,13237500.0,0.0800018310546946,0.0,0.0800018310546946,38.80402284676015,58.970001220703125,61.619998931884766,20.754706116908338,-79.24529388309166,-0.061082185115559184,0.07222056774251746,-0.019601361302167164,608573000.0,1.0
KO,2024-03-11,60.2400016784668,60.290000915527344,59.58000183105469,59.77999877929688,14114300.0,0.720001220703125,0.0,0.720001220703125,58.26924726839893,58.970001220703125,61.619998931884766,47.92458696869498,-52.07541303130502,-0.02419984580466661,0.05293648503308065,-0.0016572501469708234,622687300.0,1.0
KO,2024-03-12,60.5,60.75,60.209999084472656,60.31999969482422,12684600.0,0.2599983215332031,0.0,0.2599983215332031,63.15270438430184,58.970001220703125,61.619998931884766,57.73585285908208,-42.26414714091792,0.025712962447876464,0.04749178051603981,0.0016556038343515933,635371900.0,1.0
KO,2024-03-13,61.119998931884766,61.209999084472656,60.79999923706055,60.880001068115234,13909500.0,0.6199989318847656,0.0,0.6199989318847656,72.12735650927854,58.970001220703125,61.619998931884766,81.1320591753625,-18.867940824637493,0.11398401803883473,0.060790228020598816,0.018327198695960778,649281400.0,1.0
KO,2024-03-14,60.5,60.79999923706055,60.400001525878906,60.58000183105469,13996600.0,-0.6199989318847656,0.6199989318847656,0.0,56.30398441323167,58.970001220703125,61.27000045776367,66.5217081224883,-33.47829187751169,0.13238468505475964,0.075109119427431,0.016294326232045186,635284800.0,-1.0
KO,2024-03-15,59.880001068115234,60.45000076293945,59.63999938964844,60.02000045776367,36848900.0,-0.6199989318847656,0.6199989318847656,0.0,44.930611868271995,58.970001220703125,61.209999084472656,40.625031931090156,-59.37496806890985,0.0958339004290778,0.07925407562776036,0.0011703677180565641,598435900.0,-1.0
KO,2024-03-18,60.130001068115234,60.400001525878906,59.79999923706055,59.88999938964844,15856700.0,0.25,0.0,0.25,49.66154681443544,58.970001220703125,61.209999084472656,51.78575686050115,-48.21424313949884,0.08604814152942453,0.0806128888080932,0.010248666089719416,614292600.0,1.0
KO,2024-03-19,60.22999954223633,60.34999847412109,60.060001373291016,60.2400016784668,15030600.0,0.09999847412109375,0.0,0.09999847412109375,51.58132433854107,58.970001220703125,61.209999084472656,56.24997871260656,-43.75002128739344,0.0853777170618173,0.08156585445883802,0.011418980921709121,629323200.0,1.0
KO,2024-03-20,60.75,60.810001373291016,60.15999984741211,60.18000030517578,15258800.0,0.5200004577636719,0.0,0.5200004577636719,60.59768093235171,58.970001220703125,61.209999084472656,79.46430700167915,-20.53569299832085,0.12536100828842933,0.09032488522475629,0.02203905456859112,644582000.0,1.0
KO,2024-03-21,60.470001220703125,60.9900016784668,60.31999969482422,60.560001373291016,13067100.0,-0.279998779296875,0.279998779296875,0.0,54.31379049166337,58.970001220703125,61.209999084472656,66.96434957646602,-33.03565042353398,0.1329222482709156,0.09884435783398816,0.01596103420082451,631514900.0,-1.0
KO,2024-03-22,60.4900016784668,60.790000915527344,60.43000030517578,60.52000045776367,11501400.0,0.020000457763671875,0.0,0.020000457763671875,54.70095306677909,58.970001220703125,61.209999084472656,67.8572280067166,-32.142771993283404,0.13892699134636644,0.10686088453646385,0.004150066285429244,643016300.0,1.0
KO,2024-03-25,60.400001525878906,60.709999084472656,60.119998931884766,60.47999954223633,13144700.0,-0.09000015258789062,0.09000015258789062,0.0,52.39551442488183,58.970001220703125,61.209999084472656,63.83936022016273,-36.16063977983726,0.13486884920364162,0.1124624774698994,-0.001652867340844577,629871600.0,-1.0
KO,2024-03-26,60.540000915527344,60.709999084472656,60.380001068115234,60.5,13277400.0,0.1399993896484375,0.0,0.1399993896484375,55.743377915662755,58.970001220703125,61.209999084472656,70.08933893276931,-29.9106610672307,0.14132046864549608,0.11823407570501873,-0.009489496506762118,643149000.0,1.0
KO,2024-03-27,61.02999877929688,61.43000030517578,60.70000076293945,60.790000915527344,12551200.0,0.48999786376953836,0.0,0.48999786376953836,65.53253257131564,58.970001220703125,61.43000030517578,83.73976931927817,-16.260230680721836,0.18385281524798813,0.13135782361361265,0.008760310401601412,655700200.0,1.0
KO,2024-03-28,61.18000030517578,61.2599983215332,61.0,61.13999938964844,13683500.0,0.15000152587889914,0.0,0.15000152587889914,68.03031539917343,59.58000183105469,61.43000030517578,86.48647534053934,-13.513524659460662,0.22704662373602957,0.15049558363809604,0.021710073711951994,669383700.0,1.0
KO,2024-04-01,60.68000030517578,61.29999923706055,60.630001068115234,61.18000030517578,11668700.0,-0.5,0.5,0.0,53.2019017450102,59.63999938964844,61.43000030517578,58.10058008942157,-41.89941991057843,0.21841446088493655,0.16407935908746415,0.00914683564428187,657715000.0,-1.0
KO,2024-04-02,60.150001525878906,60.72999954223633,60.11000061035156,60.45000076293945,13017300.0,-0.529998779296875,0.529998779296875,0.0,42.00402082011763,59.63999938964844,61.43000030517578,28.491724881616577,-71.50827511838342,0.16688321174562049,0.16464012961909544,-0.0013282088156305605,644697700.0,-1.0
KO,2024-04-03,59.83000183105469,60.38999938964844,59.77999877929688,60.04999923706055,13672900.0,-0.31999969482421875,0.31999969482421875,0.0,36.63249369321437,59.63999938964844,61.43000030517578,10.614656102020723,-89.38534389797927,0.09908088178729457,0.15152828005273528,-0.015144002780992816,631024800.0,-1.0
KO,2024-04-04,59.29999923706055,60.150001525878906,59.16999816894531,60.09000015258789,14320700.0,-0.5300025939941406,0.5300025939941406,0.0,29.438115674230247,59.16999816894531,61.43000030517578,5.75225421388616,-94.24774578611384,0.002550862136217802,0.12173279646943178,-0.01934846965476833,616704100.0,-1.0
KO,2024-04-05,59.5099983215332,59.68000030517578,58.90999984741211,59.25,10156200.0,0.20999908447265625,0.0,0.20999908447265625,35.25168129161102,58.90999984741211,61.43000030517578,23.809458933731754,-76.19054106626825,-0.05635507657419225,0.08611522186070697,-0.016201080008937274,626860300.0,1.0
KO,2024-04-08,59.27000045776367,59.470001220703125,59.06999969482422,59.400001525878906,10284500.0,-0.23999786376953125,0.23999786376953125,0.0,31.797082879439017,58.90999984741211,61.43000030517578,14.285735910978303,-85.7142640890217,-0.12100935869560203,0.044690305749445165,-0.018708626482916157,616575800.0,-1.0
KO,2024-04-09,59.720001220703125,59.7400016784668,59.130001068115234,59.47999954223633,10792100.0,0.4500007629394531,0.0,0.4500007629394531,43.72777417700364,58.90999984741211,61.43000030517578,32.14290579970118,-67.85709420029882,-0.13438790224631703,0.008874664150292718,-0.013544758546805813,627367900.0,1.0
KO,2024-04-10,58.91999816894531,59.38999938964844,58.68999862670898,59.31999969482422,11861900.0,-0.8000030517578125,0.8000030517578125,0.0,32.18045561208369,58.68999862670898,61.43000030517578,8.394138735164345,-91.60586126483565,-0.20715608833372556,-0.03433148634651095,-0.034573171432986216,615506000.0,-1.0
KO,2024-04-11,59.04999923706055,59.369998931884766,58.790000915527344,59.150001525878906,11109000.0,0.13000106811523438,0.0,0.13000106811523438,35.38004052741444,58.68999862670898,61.43000030517578,13.138700358498015,-86.86129964150199,-0.2514369912211123,-0.07775258732143124,-0.034815316402262875,626615000.0,1.0
KO,2024-04-12,58.27999877929688,59.0099983215332,58.130001068115234,58.95000076293945,12246700.0,-0.7700004577636648,0.7700004577636648,0.0,26.75388028181918,58.130001068115234,61.43000030517578,4.545386238187656,-95.45461376181234,-0.3446891654277593,-0.13113990294269687,-0.039551771816227044,614368300.0,-1.0
KO,2024-04-15,58.13999938964844,58.810001373291016,58.040000915527344,58.61000061035156,12425000.0,-0.1399993896484446,0.1399993896484446,0.0,25.45201960158998,58.040000915527344,61.43000030517578,2.949808027294783,-97.0501919727052,-0.4249899464969076,-0.18990991165353904,-0.03341649352021525,601943300.0,-1.0
KO,2024-04-16,58.060001373291016,58.380001068115234,57.93000030517578,58.25,11236800.0,-0.07999801635742188,0.07999801635742188,0.0,24.66081970507929,57.93000030517578,61.43000030517578,3.7143162318638394,-96.28568376813617,-0.48944208172777337,-0.24981634566838595,-0.02958382757135325,590706500.0,-1.0
KO,2024-04-17,58.5099983215332,58.560001373291016,58.09999847412109,58.27999877929688,13805100.0,0.4499969482421875,0.0,0.4499969482421875,37.30946965268982,57.93000030517578,61.29999923706055,17.210629085660923,-82.78937091433907,-0.4984638888810409,-0.29954585431091696,-0.013322106672703282,604511600.0,1.0
KO,2024-04-18,58.90999984741211,58.97999954223633,58.540000915527344,58.619998931884766,11125900.0,0.40000152587890625,0.0,0.40000152587890625,46.518734164426846,57.93000030517578,61.29999923706055,29.080114327758437,-70.91988567224156,-0.4679428025192536,-0.3332252439525843,-0.010082313746327065,615637500.0,1.0
KO,2024-04-19,60.16999816894531,60.36000061035156,59.0,59.09999847412109,21206200.0,1.2599983215332031,0.0,1.2599983215332031,65.13433845126889,57.93000030517578,60.72999954223633,79.99994550430993,-20.000054495690073,-0.33818490234120446,-0.33421717563030834,0.015184709030380272,636843700.0,1.0
KO,2024-04-22,60.54999923706055,60.630001068115234,59.720001220703125,60.13999938964844,15624500.0,0.3800010681152344,0.0,0.3800010681152344,68.90121695457431,57.93000030517578,60.630001068115234,97.03697005746062,-2.9630299425393725,-0.20235529531683483,-0.3078447995676137,0.013898158060815513,652468200.0,1.0
KO,2024-04-23,60.63999938964844,60.68000030517578,60.130001068115234,60.52999877929688,13689100.0,0.09000015258789062,0.0,0.09000015258789062,69.79307663705814,57.93000030517578,60.68000030517578,98.54542125355114,-1.4545787464488635,-0.08645054493099735,-0.2635659486402904,0.029192146540317987,666157300.0,1.0
KO,2024-04-24,61.54999923706055,61.650001525878906,59.84000015258789,60.31999969482422,19548300.0,0.9099998474121094,0.0,0.9099998474121094,77.36595906796671,57.93000030517578,61.650001525878906,97.3117673117468,-2.6882326882531973,0.0779357920016821,-0.1952656005118959,0.04233700308722388,685705600.0,1.0
KO,2024-04-25,61.7400016784668,62.59000015258789,61.369998931884766,61.869998931884766,19048500.0,0.19000244140625,0.0,0.19000244140625,78.65513979461743,57.93000030517578,62.59000015258789,81.75968879927898,-18.240311200721028,0.22099723886167055,-0.1120130326371826,0.05936861653468384,704754100.0,1.0
1.0,1.0,1.0,1.0,1.0,1.0,1.0,1.0,1.0,1.0,1.0,1.0,1.0,1.0,1.0,1.0,1.0,1.0,1.0,1.0
KO,2024-04-29,62.040000915527344,62.04999923706055,61.52999877929688,61.91999816894531,13409300.0,0.2999992370605469,0.0,0.2999992370605469,80.93751952357758,57.93000030517578,62.59000015258789,88.19744087832999,-11.802559121670019,0.43657123366351414,0.06851613480057347,0.06854976658797018,718163400.0,1.0
KO,2024-04-30,61.77000045776367,62.83000183105469,61.470001220703125,62.13999938964844,19349200.0,-0.2700004577636719,0.2700004577636719,0.0,72.84830597306332,57.93000030517578,62.83000183105469,78.36732564892651,-21.632674351073486,0.49311171938396114,0.15343525171725103,0.05571700956673431,698814200.0,-1.0
KO,2024-05-01,61.93000030517578,62.56999969482422,61.209999084472656,61.79999923706055,16729800.0,0.15999984741210938,0.0,0.15999984741210938,74.5850980283891,57.93000030517578,62.83000183105469,81.63262764050927,-18.36737235949073,0.5445538345495606,0.231658968283713,0.05126464888110749,715544000.0,1.0
KO,2024-05-02,61.9900016784668,62.400001525878906,61.720001220703125,62.18000030517578,10991300.0,0.060001373291015625,0.0,0.060001373291015625,75.26959518297737,57.93000030517578,62.83000183105469,82.85714508145544,-17.14285491854456,0.5834381786649203,0.3020148103599545,0.03024769095739832,726535300.0,1.0
KO,2024-05-03,62.16999816894531,62.33000183105469,61.63999938964844,61.9900016784668,11628700.0,0.17999649047851562,0.0,0.17999649047851562,77.37849281366661,57.93000030517578,62.83000183105469,86.53054170241322,-13.469458297586776,0.6216129468998446,0.36593443766793254,0.026754730838926655,738164000.0,1.0
KO,2024-05-06,62.34999847412109,62.380001068115234,61.900001525878906,62.29999923706055,9310700.0,0.18000030517577414,0.0,0.18000030517577414,79.40497889627412,58.09999847412109,62.83000183105469,89.85194468773527,-10.148055312264741,0.6587970438284216,0.42450695890003043,0.028199193629354635,747474700.0,1.0
KO,2024-05-07,62.619998931884766,62.81999969482422,62.25,62.7599983215332,9807000.0,0.270000457763679,0.0,0.270000457763679,82.1695268196163,58.540000915527344,62.83000183105469,95.10482856985341,-4.895171430146594,0.7019607227384768,0.47999771166771976,0.01738423571222314,757281700.0,1.0
KO,2024-05-08,62.84999847412109,62.970001220703125,62.47999954223633,62.84999847412109,10484400.0,0.22999954223632102,0.0,0.22999954223632102,84.24784584270998,59.0,62.970001220703125,96.97726172082172,-3.02273827917828,0.7461264093251643,0.5332234511992088,0.01797856763002681,767766100.0,1.0
KO,2024-05-09,62.880001068115234,63.150001525878906,62.75,62.810001373291016,9113700.0,0.03000259399414773,0.0,0.03000259399414773,84.51943712894582,59.720001220703125,63.150001525878906,92.12826723787026,-7.871732762129735,0.774619659484344,0.5815026928562358,0.018464518280796094,776879800.0,1.0
KO,2024-05-10,63.2599983215332,63.36000061035156,62.790000915527344,62.91999816894531,8371700.0,0.37999725341796875,0.0,0.37999725341796875,87.6350174135166,59.84000015258789,63.36000061035156,97.15902625530074,-2.840973744699251,0.8184290277223525,0.6288879598294592,0.019664690328857093,785251500.0,1.0
KO,2024-05-13,63.58000183105469,63.619998931884766,63.18000030517578,63.2400016784668,10137600.0,0.3200035095214844,0.0,0.3200035095214844,89.65755892934581,59.84000015258789,63.619998931884766,98.94187529770795,-1.0581247022920486,0.8689531257883445,0.6769009930212363,0.029302272298486365,795389100.0,1.0
KO,2024-05-14,63.09999847412109,63.7599983215332,62.79999923706055,63.58000183105469,10852200.0,-0.48000335693360086,0.48000335693360086,0.0,69.87568412839897,61.209999084472656,63.7599983215332,74.11764529887013,-25.882354701129877,0.8603440673007512,0.7135896078771393,0.018892268095912268,784536900.0,-1.0
KO,2024-05-15,63.130001068115234,63.38999938964844,63.0,63.060001373291016,9838900.0,0.03000259399414773,0.0,0.03000259399414773,70.34753394767839,61.209999084472656,63.7599983215332,75.29421796438717,-24.705782035612827,0.8461879569832291,0.7401092776983573,0.018390052569468462,794375800.0,1.0
KO,2024-05-16,63.31999969482422,63.72999954223633,63.06999969482422,63.2400016784668,10228000.0,0.18999862670898438,0.0,0.18999862670898438,73.39280060967899,61.209999084472656,63.7599983215332,82.74514673125225,-17.25485326874775,0.8406104053666965,0.7602095032320253,0.018497692773832952,804603800.0,1.0
KO,2024-05-17,63.02999877929688,63.369998931884766,62.93999862670898,63.34000015258789,11539000.0,-0.29000091552733664,0.29000091552733664,0.0,62.15157940439424,61.209999084472656,63.7599983215332,71.37255840602481,-28.62744159397519,0.8035269468174633,0.768872991949113,0.010906179981031272,793064800.0,-1.0
KO,2024-05-20,62.56999969482422,63.0099983215332,62.459999084472656,62.93000030517578,11000900.0,-0.45999908447266336,0.45999908447266336,0.0,48.54350514314509,61.209999084472656,63.7599983215332,53.333373225604255,-46.666626774395745,0.7286208691720404,0.7608225673936986,-0.0007984547734491976,782063900.0,-1.0
KO,2024-05-21,62.90999984741211,62.97999954223633,62.43999862670898,62.81999969482422,9796200.0,0.3400001525878906,0.0,0.3400001525878906,56.64010653797789,61.63999938964844,63.7599983215332,59.90571215215611,-40.09428784784389,0.6887529188679977,0.7464086376885585,0.0009546758114198362,791860100.0,1.0
KO,2024-05-22,63.0,63.02000045776367,62.65999984741211,62.709999084472656,7419400.0,0.09000015258789062,0.0,0.09000015258789062,58.6283844174676,61.63999938964844,63.7599983215332,64.15100450746294,-35.84899549253704,0.6568478085072513,0.7284964718522972,0.0019083799275825264,799279500.0,1.0
KO,2024-05-23,62.09000015258789,62.880001068115234,62.04999923706055,62.4900016784668,9834300.0,-0.9099998474121094,0.9099998474121094,0.0,38.19496739635784,61.900001525878906,63.7599983215332,10.214997528646169,-89.78500247135382,0.5517729016389552,0.6931517578096288,-0.018495071134819407,789445200.0,-1.0
KO,2024-05-24,62.0,62.41999816894531,61.970001220703125,62.220001220703125,8200700.0,-0.09000015258789062,0.09000015258789062,0.0,36.73396569783202,61.970001220703125,63.7599983215332,1.6759121723137773,-98.32408782768623,0.4559817470298384,0.6457177556536707,-0.02485061002755362,781244500.0,-1.0
KO,2024-05-28,61.81999969482422,62.130001068115234,61.400001525878906,61.790000915527344,12347000.0,-0.18000030517578125,0.18000030517578125,0.0,33.7544005901763,61.400001525878906,63.7599983215332,17.79655674612347,-82.20344325387653,0.361376325233401,0.5888494695696168,-0.020285242634701883,768897500.0,-1.0
KO,2024-05-29,61.70000076293945,61.880001068115234,61.06999969482422,61.470001220703125,11861800.0,-0.11999893188476562,0.11999893188476562,0.0,31.772041912689076,61.06999969482422,63.7599983215332,23.420126012703374,-76.57987398729664,0.27356445518290684,0.5257924666922749,-0.022651675605594557,757035700.0,-1.0
KO,2024-05-30,61.970001220703125,62.08000183105469,61.59999847412109,61.84999847412109,9436800.0,0.2700004577636719,0.0,0.2700004577636719,40.79853974025743,61.06999969482422,63.7599983215332,33.45732287529054,-66.54267712470947,0.22318693590302985,0.46527136053442586,-0.02132025395810988,766472500.0,1.0
KO,2024-05-31,62.93000030517578,63.02999877929688,61.68999862670898,61.9900016784668,19816600.0,0.9599990844726562,0.0,0.9599990844726562,61.626369602445216,61.06999969482422,63.7599983215332,69.14503940201399,-30.854960597986008,0.25775505219834827,0.42376809886721034,-0.0015865219111180773,786289100.0,1.0
1.0,1.0,1.0,1.0,1.0,1.0,1.0,1.0,1.0,1.0,1.0,1.0,1.0,1.0,1.0,1.0,1.0,1.0,1.0,1.0
KO,2024-06-04,63.93999862670898,63.970001220703125,62.93999862670898,63.20000076293945,11895600.0,1.009998321533196,0.0,1.009998321533196,74.29392904464942,61.06999969482422,63.970001220703125,98.9654283376608,-1.0345716623392056,0.3781758047343331,0.39195089697130053,0.016372576407488904,798184700.0,1.0
KO,2024-06-05,63.91999816894531,64.06999969482422,63.34999847412109,63.9900016784668,9632500.0,-0.02000045776366477,0.02000045776366477,0.0,73.73774680590445,61.06999969482422,64.06999969482422,94.99994913736978,-5.000050862630209,0.44769964441398,0.40310064645983645,0.014603145538814477,788552200.0,-1.0
KO,2024-06-06,64.1500015258789,64.36000061035156,63.84000015258789,63.91999816894531,8658500.0,0.23000335693359375,0.0,0.23000335693359375,76.11080033697513,61.06999969482422,64.36000061035156,93.61705088039479,-6.382949119605219,0.515415745064665,0.4255636661808022,0.03317766738973282,797210700.0,1.0
KO,2024-06-07,63.90999984741211,64.22000122070312,63.810001373291016,64.08999633789062,9523100.0,-0.24000167846679688,0.24000167846679688,0.0,68.64288958091281,61.06999969482422,64.36000061035156,86.32216906640818,-13.67783093359182,0.5434505533313541,0.44914104361091256,0.0308064491518083,787687600.0,-1.0
KO,2024-06-10,63.59000015258789,63.9900016784668,63.369998931884766,63.93999862670898,15687100.0,-0.31999969482421875,0.31999969482421875,0.0,59.640148884631685,61.06999969482422,64.36000061035156,76.59573727990131,-23.404262720098696,0.5336949368211918,0.4660518222529685,0.028631518384039545,772000500.0,-1.0
KO,2024-06-11,63.54999923706055,63.650001525878906,63.06999969482422,63.59000015258789,8396000.0,-0.04000091552734375,0.04000091552734375,0.0,58.53289437390278,61.06999969482422,64.36000061035156,75.37990431953472,-24.620095680465276,0.5167786977262026,0.4761971973476154,0.02998376744319775,763604500.0,-1.0
KO,2024-06-12,62.880001068115234,63.68999862670898,62.68999862670898,63.68999862670898,9569600.0,-0.6699981689453125,0.6699981689453125,0.0,43.07669514576166,61.06999969482422,64.36000061035156,55.01522400035248,-44.98477599964752,0.44418887073903335,0.469795532025899,0.014684522018503676,754034900.0,-1.0
KO,2024-06-13,62.9900016784668,63.040000915527344,62.45000076293945,62.86000061035156,9668900.0,0.1100006103515625,0.0,0.1100006103515625,45.78853022912358,61.06999969482422,64.36000061035156,58.35870666725413,-41.64129333274586,0.3910294951989073,0.4540423246605007,0.0009534621484195149,763703800.0,1.0
KO,2024-06-14,62.54999923706055,62.68999862670898,62.09000015258789,62.380001068115234,8179200.0,-0.44000244140625,0.44000244140625,0.0,37.53534677064135,61.06999969482422,64.36000061035156,44.98477599964752,-55.01522400035248,0.30982432535929405,0.4251987248002594,-0.0060384723704502985,755524600.0,-1.0
KO,2024-06-17,62.619998931884766,62.900001525878906,62.18000030517578,62.369998931884766,10532700.0,0.06999969482421875,0.0,0.06999969482421875,39.53590554912422,61.06999969482422,64.36000061035156,47.11242570618259,-52.88757429381741,0.2482553009938897,0.38981004003898545,-0.020644349752500957,766057300.0,1.0
KO,2024-06-18,62.630001068115234,62.81999969482422,62.43999862670898,62.52999877929688,10651700.0,0.01000213623046875,0.0,0.01000213623046875,39.853499245414575,61.59999847412109,64.36000061035156,37.318905680301135,-62.68109431969886,0.19798623236139434,0.35144527850346724,-0.02018143206795031,776709000.0,1.0
KO,2024-06-20,62.18000030517578,62.7400016784668,61.95000076293945,62.400001525878906,13306300.0,-0.4500007629394531,0.4500007629394531,0.0,31.314790148397293,61.68999862670898,64.36000061035156,18.35210915455249,-81.6478908454475,0.12044788431101239,0.3052457996649763,-0.030709293434831864,763402700.0,-1.0
KO,2024-06-21,62.77000045776367,63.09999847412109,62.18000030517578,62.18000030517578,28282200.0,0.5900001525878906,0.0,0.5900001525878906,48.12785084693096,61.95000076293945,64.36000061035156,34.02488575693254,-65.97511424306745,0.1053913800983608,0.2652749157516532,-0.01783757459505919,791684900.0,1.0
KO,2024-06-24,63.970001220703125,64.05999755859375,62.90999984741211,62.9900016784668,13212500.0,1.2000007629394531,0.0,1.2000007629394531,67.05403576344376,61.95000076293945,64.36000061035156,83.81745168709351,-16.1825483129065,0.1881204888830723,0.249844030377937,0.0059757991382827225,804897400.0,1.0
KO,2024-06-25,63.84000015258789,64.06999969482422,63.5099983215332,63.93999862670898,10546800.0,-0.13000106811523438,0.13000106811523438,0.0,64.12922267189732,61.95000076293945,64.36000061035156,78.4232161540568,-21.576783845943204,0.24042246339313778,0.24795971698097716,0.004563350417134515,794350600.0,-1.0
KO,2024-06-26,64.05000305175781,64.11000061035156,63.22999954223633,63.400001525878906,9402500.0,0.21000289916992188,0.0,0.21000289916992188,66.82629992731098,61.95000076293945,64.36000061035156,87.13702994933259,-12.862970050667414,0.2954123047420154,0.25745023453318483,0.018606901459419012,803753100.0,1.0
KO,2024-06-27,63.90999984741211,64.2699966430664,63.619998931884766,64.05000305175781,8494100.0,-0.14000320434570312,0.14000320434570312,0.0,63.17252789975863,61.95000076293945,64.2699966430664,84.48286918360401,-15.517130816395994,0.3239606449992607,0.27075231662640004,0.014605463477227021,795259000.0,-1.0
KO,2024-06-28,63.650001525878906,64.05999755859375,63.52000045776367,63.900001525878906,17358800.0,-0.2599983215332031,0.2599983215332031,0.0,56.54749721357192,61.95000076293945,64.2699966430664,73.27602507839053,-26.72397492160948,0.32189511220101963,0.28098087574132397,0.01758596806131707,777900200.0,-1.0
KO,2024-07-01,63.27999877929688,64.30000305175781,63.119998931884766,64.02999877929688,10033400.0,-0.37000274658202414,0.37000274658202414,0.0,48.24034197233526,61.95000076293945,64.30000305175781,56.59560514837565,-43.40439485162435,0.28709260829042904,0.28220322225114497,0.010539761396834768,767866800.0,-1.0
KO,2024-07-02,63.150001525878906,63.380001068115234,62.86000061035156,63.2599983215332,8878200.0,-0.12999725341797586,0.12999725341797586,0.0,45.528882810308936,61.95000076293945,64.30000305175781,51.063812518363285,-48.936187481636715,0.24618382736656486,0.274999343274229,0.00830273748835042,758988600.0,-1.0
KO,2024-07-03,63.33000183105469,63.66999816894531,62.93000030517578,63.18999862670898,9154200.0,0.18000030517578125,0.0,0.18000030517578125,50.01735838937929,61.95000076293945,64.30000305175781,58.72339251248704,-41.27660748751297,0.22568627318248957,0.2651367292558811,0.018494717276210437,768142800.0,1.0
KO,2024-07-05,63.7599983215332,63.790000915527344,63.0,63.33000183105469,11735500.0,0.4299964904785156,0.0,0.4299964904785156,59.268625598016165,61.95000076293945,64.30000305175781,77.02109769024364,-22.978902309756364,0.2413567268578376,0.2603807287762724,0.015771831393177616,779878300.0,1.0
KO,2024-07-08,62.959999084472656,63.59000015258789,62.84000015258789,63.59000015258789,11235100.0,-0.7999992370605469,0.7999992370605469,0.0,42.41553549031987,61.95000076293945,64.30000305175781,42.97861012046315,-57.02138987953684,0.18706604086239054,0.24571779119349602,-0.015788684023091637,768643200.0,-1.0
KO,2024-07-09,62.68999862670898,63.22999954223633,62.59000015258789,63.060001373291016,11657500.0,-0.270000457763679,0.270000457763679,0.0,38.186972982704695,61.95000076293945,64.30000305175781,31.489240129277228,-68.51075987072277,0.12086029832796896,0.22074629262039058,-0.018013808319709,756985700.0,-1.0
KO,2024-07-10,62.83000183105469,62.86000061035156,62.290000915527344,62.720001220703125,11930400.0,0.14000320434571023,0.0,0.14000320434571023,41.66640174286867,61.95000076293945,64.30000305175781,37.44681749045109,-62.55318250954891,0.07878072377355494,0.19235317885102346,-0.01904763719866276,768916100.0,1.0
KO,2024-07-11,63.09999847412109,63.459999084472656,62.400001525878906,62.63999938964844,11431600.0,0.26999664306639914,0.0,0.26999664306639914,48.159678567665715,62.18000030517578,64.30000305175781,43.39608382246533,-56.60391617753467,0.06645280385419738,0.16717310385165826,-0.012674094433186345,780347700.0,1.0
KO,2024-07-12,63.70000076293945,64.11000061035156,63.38999938964844,63.459999084472656,9201500.0,0.6000022888183665,0.0,0.6000022888183665,59.67058499974735,62.290000915527344,64.30000305175781,70.14917158528023,-29.850828414719782,0.10390031067377237,0.1545185452160811,0.0007855339491267266,789549200.0,1.0
KO,2024-07-15,63.40999984741211,63.93999862670898,63.34999847412109,63.790000915527344,8207500.0,-0.29000091552734375,0.29000091552734375,0.0,53.095600361689094,62.290000915527344,64.30000305175781,55.72128067411892,-44.278719325881085,0.10892150012653445,0.14539913619817177,0.0020543784864572867,781341700.0,-1.0
KO,2024-07-16,64.2699966430664,64.30999755859375,63.38999938964844,63.43000030517578,9025100.0,0.8599967956542969,0.0,0.8599967956542969,65.93808121298835,62.290000915527344,64.30999755859375,98.01975336619266,-1.9802466338073386,0.180217942796979,0.15236289751793322,0.01773547252771679,790366800.0,1.0
KO,2024-07-17,65.20999908447266,65.38999938964844,64.41000366210938,64.47000122070312,12508200.0,0.94000244140625,0.0,0.94000244140625,74.68108237927528,62.290000915527344,65.38999938964844,94.19353568466467,-5.806464315335337,0.30900916308917914,0.18369215063218242,0.029685728707749437,802875000.0,1.0
KO,2024-07-18,65.19000244140625,65.80999755859375,64.72000122070312,64.80000305175781,11128200.0,-0.01999664306640625,0.01999664306640625,0.0,74.21350831904816,62.290000915527344,65.80999755859375,82.3864855550715,-17.61351444492851,0.40479731956250475,0.22791318441824693,0.022427919659936624,791746800.0,-1.0
KO,2024-07-19,65.29000091552734,65.63999938964844,64.81999969482422,65.63999938964844,13775700.0,0.09999847412109375,0.0,0.09999847412109375,75.11259908069417,62.290000915527344,65.80999755859375,85.22735400641129,-14.772645993588702,0.4832090318910147,0.2789723539128005,0.03700765350915192,805522500.0,1.0
KO,2024-07-22,64.7699966430664,65.29000091552734,64.31999969482422,65.25,11794200.0,-0.5200042724609375,0.5200042724609375,0.0,62.1173244295207,62.290000915527344,65.80999755859375,70.45449126845308,-29.545508731546928,0.4976542317026045,0.32270872947076135,0.0331791045130323,793728300.0,-1.0
KO,2024-07-23,64.95999908447266,66.04000091552734,64.8499984741211,65.43000030517578,11810300.0,0.19000244140625,0.0,0.19000244140625,64.69268223068279,62.290000915527344,66.04000091552734,71.199951171875,-28.800048828125004,0.5184573125594483,0.36185844608849876,0.033900958003238335,805538600.0,1.0
KO,2024-07-24,65.80999755859375,65.97000122070312,64.83000183105469,65.08999633789062,13244600.0,0.8499984741210938,0.0,0.8499984741210938,73.8641748050097,62.290000915527344,66.04000091552734,93.8665771484375,-6.1334228515625,0.5966538232739254,0.4088175215255841,0.04294768858962983,818783200.0,1.0
KO,2024-07-25,66.06999969482422,66.88999938964844,65.86000061035156,66.04000091552734,16328600.0,0.26000213623046875,0.0,0.26000213623046875,76.05911258468797,62.290000915527344,66.88999938964844,82.1739137645933,-17.826086235406706,0.6718603331538162,0.46142608385123063,0.03720563427785106,835111800.0,1.0
KO,2024-07-26,67.05000305175781,67.11000061035156,66.01000213623047,66.06999969482422,13530100.0,0.9800033569335938,0.0,0.9800033569335938,82.46403875300098,62.290000915527344,67.11000061035156,98.75523729476215,-1.2447627052378487,0.8013031903575012,0.5294015051524849,0.05740424559383217,848641900.0,1.0
KO,2024-07-29,66.83000183105469,67.02999877929688,66.38999938964844,66.87999725341797,12140200.0,-0.220001220703125,0.220001220703125,0.0,77.1198073632455,62.290000915527344,67.11000061035156,94.19089632728522,-5.809103672714783,0.8760369191036546,0.5987285879427189,0.039832041725560874,836501700.0,-1.0
KO,2024-07-30,67.68000030517578,67.83000183105469,66.36000061035156,66.4800033569336,13258000.0,0.8499984741210938,0.0,0.8499984741210938,82.24840837117482,62.400001525878906,67.83000183105469,97.23754111512798,-2.7624588848720215,0.9924118051554132,0.6774652313852578,0.03787764538232086,849759700.0,1.0
KO,2024-07-31,66.73999786376953,67.61000061035156,66.61000061035156,67.5,15576800.0,-0.94000244140625,0.94000244140625,0.0,63.95572538622839,63.34999847412109,67.83000183105469,75.66957253283792,-24.33042746716208,0.9972932241988275,0.7414308299479718,0.023776581750498238,834182900.0,-1.0
KO,2024-08-01,67.95999908447266,68.11000061035156,66.69999694824219,67.0,16495900.0,1.220001220703125,0.0,1.220001220703125,72.96135404505844,63.34999847412109,68.11000061035156,96.84870885378017,-3.1512911462198403,1.0870745675601796,0.8105595774704134,0.04089444220409444,850678800.0,1.0
KO,2024-08-02,69.33000183105469,69.66999816894531,67.69000244140625,68.52999877929688,22514800.0,1.3700027465820312,0.0,1.3700027465820312,79.57394112289325,63.38999938964844,69.66999816894531,94.58604452262821,-5.413955477371794,1.2543157301197994,0.8993108080002908,0.0704030480828568,873193600.0,1.0
KO,2024-08-05,68.0999984741211,69.55000305175781,67.7300033569336,68.98999786376953,25484300.0,-1.2300033569335938,1.2300033569335938,0.0,63.48905195907535,64.31999969482422,69.66999816894531,70.65420294195242,-29.34579705804759,1.272931008721713,0.9740348481445753,0.04833742970909283,847709300.0,-1.0
KO,2024-08-06,68.05000305175781,68.83999633789062,67.7699966430664,68.1500015258789,12969100.0,-0.04999542236328125,0.04999542236328125,0.0,62.89281337279599,64.31999969482422,69.66999816894531,69.71970879947521,-30.28029120052479,1.269021053606238,1.033032089236908,0.03403746507010097,834740200.0,-1.0
KO,2024-08-07,68.45999908447266,69.18000030517578,67.83000183105469,68.05000305175781,13365300.0,0.40999603271484375,0.0,0.40999603271484375,65.92114575720653,64.31999969482422,69.66999816894531,77.38318823219035,-22.61681176780965,1.284202156298079,1.0832661026491424,0.03617374603735102,848105500.0,1.0
KO,2024-08-08,68.7300033569336,68.86000061035156,67.8499984741211,68.0,15240900.0,0.2700042724609375,0.0,0.2700042724609375,67.91108334891473,64.31999969482422,69.66999816894531,82.42999850264177,-17.57000149735823,1.3030002025771807,1.12721292263475,0.02505593182268684,863346400.0,1.0
KO,2024-08-09,68.68000030517578,68.79000091552734,68.25,68.69999694824219,12080400.0,-0.0500030517578125,0.0500030517578125,0.0,67.07416416686382,64.83000183105469,69.66999816894531,79.5454832058614,-20.454516794138602,1.298890164022282,1.1615483709122565,0.027682155071578007,851266000.0,-1.0
KO,2024-08-12,68.16999816894531,68.54000091552734,67.83000183105469,68.44999694824219,11012300.0,-0.5100021362304688,0.5100021362304688,0.0,58.57837759456087,64.83000183105469,69.66999816894531,69.00824101338613,-30.99175898661387,1.240183950138686,1.1772754867575423,0.00723992112234173,840253700.0,-1.0
KO,2024-08-13,68.45999908447266,68.61000061035156,68.01000213623047,68.08000183105469,9877600.0,0.29000091552734375,0.0,0.29000091552734375,61.75657172823459,65.86000061035156,69.66999816894531,68.24147349534627,-31.758526504653734,1.203189878959833,1.1824583651980005,0.02577167029903138,850131300.0,1.0
KO,2024-08-14,68.58000183105469,68.88999938964844,68.12999725341797,68.2300033569336,14328000.0,0.12000274658203125,0.0,0.12000274658203125,63.10809678229893,66.01000213623047,69.66999816894531,70.2186470108792,-29.78135298912081,1.1700672231600322,1.1799801367904068,0.009123054074962278,864459300.0,1.0
KO,2024-08-15,68.6500015258789,68.91999816894531,68.5,68.62000274658203,11285100.0,0.06999969482421875,0.0,0.06999969482421875,63.965217622483365,66.36000061035156,69.66999816894531,69.18436871899836,-30.815631281001643,1.136366346286806,1.1712573786896867,-0.009808167996776085,875744400.0,1.0
KO,2024-08-16,69.18000030517578,69.30000305175781,68.63999938964844,68.83999633789062,12651200.0,0.529998779296875,0.0,0.529998779296875,70.04522010180904,66.36000061035156,69.66999816894531,85.19642824214932,-14.803571757850676,1.1392915864435764,1.1648642202404647,0.015859058080083477,888395600.0,1.0
KO,2024-08-19,68.9800033569336,69.41999816894531,68.8499984741211,69.3499984741211,9843900.0,-0.1999969482421875,0.1999969482421875,0.0,65.25154024519344,66.61000061035156,69.66999816894531,77.45113194375188,-22.548868056248132,1.1126458888554254,1.1544205539634569,0.013666425620413758,878551700.0,-1.0
KO,2024-08-20,69.37999725341797,69.38999938964844,68.7699966430664,68.98999786376953,11957400.0,0.399993896484375,0.0,0.399993896484375,69.99091620107272,66.69999694824219,69.66999816894531,90.23566342310498,-9.764336576895017,1.1109982498508515,1.145736093140936,0.013438477669421633,890509100.0,1.0
KO,2024-08-21,69.56999969482422,70.12999725341797,69.33000183105469,69.4800033569336,8792400.0,0.19000244140625,0.0,0.19000244140625,72.07820552429033,67.69000244140625,70.12999725341797,77.04923158701123,-22.950768412988758,1.1122033057873608,1.139029535670221,0.012221683353168089,899301500.0,1.0
KO,2024-08-22,69.33000183105469,69.91999816894531,68.79000091552734,69.91999816894531,12509200.0,-0.23999786376953125,0.23999786376953125,0.0,65.44390386578672,67.7300033569336,70.12999725341797,66.66677263074908,-33.33322736925092,1.0813276276501682,1.1274891540662104,0.009464203887458611,886792300.0,-1.0
KO,2024-08-23,69.79000091552734,69.8499984741211,68.94000244140625,69.4000015258789,11834700.0,0.45999908447265625,0.0,0.45999908447265625,71.2883895589382,67.7699966430664,70.12999725341797,85.59337923900043,-14.40662076099958,1.0815095432254083,1.11829323189805,0.023764160042474725,898627000.0,1.0
KO,2024-08-26,70.83999633789062,70.91999816894531,69.7300033569336,69.83000183105469,12912200.0,1.0499954223632812,0.0,1.0499954223632812,80.13657345406384,67.83000183105469,70.91999816894531,97.41094091039277,-2.5890590896072214,1.1530874931868311,1.1252520841558062,0.03476478652126902,911539200.0,1.0
KO,2024-08-27,71.5,71.52999877929688,71.05000305175781,71.31999969482422,16988400.0,0.660003662109375,0.0,0.660003662109375,83.76525533527229,67.83000183105469,71.52999877929688,99.18922151243592,-0.8107784875640767,1.2486763501831462,1.1499369373612742,0.04257798324559192,928527600.0,1.0
KO,2024-08-28,71.75,71.80999755859375,71.30000305175781,71.61000061035156,13272600.0,0.25,0.0,0.25,84.96564205885434,67.83000183105469,71.80999755859375,98.49252203517193,-1.50747796482807,1.3292809948362958,1.1858057488562785,0.045156568175056755,941800200.0,1.0
KO,2024-08-29,72.05000305175781,72.22000122070312,71.2300033569336,71.9000015258789,17201700.0,0.3000030517578125,0.0,0.3000030517578125,86.36189272616876,67.83000183105469,72.22000122070312,96.12760381365504,-3.872396186344946,1.4012161479687393,1.2288878286787708,0.041486018125491464,959001900.0,1.0
KO,2024-08-30,72.47000122070312,72.56999969482422,71.77999877929688,72.19999694824219,18624200.0,0.4199981689453125,0.0,0.4199981689453125,88.14097888676106,68.01000213623047,72.56999969482422,97.80704983201937,-2.192950167980619,1.4751114506753282,1.2781325530780823,0.05059434175018396,977626100.0,1.0
KO,2024-09-03,73.01000213623047,73.29000091552734,72.25,72.44000244140625,14751900.0,0.5400009155273438,0.0,0.5400009155273438,90.06387169793989,68.12999725341797,73.29000091552734,94.57367091901611,-5.426329080983895,1.5592732400667302,1.334360690475812,0.05232062592267783,992378000.0,1.0
KO,2024-09-04,72.55999755859375,73.52999877929688,71.91000366210938,73.30000305175781,18138500.0,-0.45000457763671875,0.45000457763671875,0.0,77.91592671840361,68.5,73.52999877929688,80.71567681694908,-19.28432318305091,1.571544667270544,1.3817974858347586,0.0429782647245287,974239500.0,-1.0
KO,2024-09-05,71.73500061035156,72.66999816894531,71.27999877929688,72.62000274658203,10978334.0,-0.8249969482421875,0.8249969482421875,0.0,60.61976400981932,68.63999938964844,73.52999877929688,63.292466401016,-36.70753359898399,1.49743797000896,1.404925582669599,0.03468914922514266,963261166.0,-1.0
