symbol,datetime,close,high,low,open,volume,change_in_price,down_days,up_days,RSI,low_14,high_14,k_percent,r_percent,MACD,MACD_EMA,Price_Rate_Of_Change,On Balance Volume,Prediction
MSFT,2020-01-22,165.6999969482422,167.49000549316406,165.67999267578125,167.39999389648438,24138800.0,-0.8000030517578125,0.8000030517578125,0.0,65.65206267784549,156.50999450683594,168.19000244140625,78.68147430110743,-21.31852569889256,0.8747084318236205,0.5636736466836766,0.035042793045674925,30617100.0,-1.0
MSFT,2020-01-23,166.72000122070312,166.8000030517578,165.27000427246094,166.19000244140625,19680800.0,1.0200042724609375,0.0,1.0200042724609375,69.90119932251784,156.50999450683594,168.19000244140625,87.41438166020215,-12.585618339797847,0.9359657255932916,0.6408473715155659,0.028564408584234036,50297900.0,1.0
MSFT,2020-01-24,165.0399932861328,167.52999877929688,164.4499969482422,167.50999450683594,24918100.0,-1.6800079345703125,1.6800079345703125,0.0,56.5954632782011,156.50999450683594,168.19000244140625,73.03076185462093,-26.96923814537906,0.8687913847456059,0.6877565501581682,0.02293291826097099,25379800.0,-1.0
MSFT,2020-01-27,162.27999877929688,163.3800048828125,160.1999969482422,161.14999389648438,32078100.0,-2.7599945068359375,2.7599945068359375,0.0,41.5890204069626,157.32000732421875,168.19000244140625,45.63011667995553,-54.36988332004448,0.6359789329553109,0.6771624692228332,-0.006124448845395203,-6698300.0,-1.0
MSFT,2020-01-28,165.4600067138672,165.75999450683594,163.07000732421875,163.77999877929688,24899900.0,3.1800079345703125,0.0,3.1800079345703125,56.81271169274771,157.9499969482422,168.19000244140625,73.33989977484357,-26.660100225156423,0.650373879643297,0.67170646466658,0.020539084258102802,18201600.0,1.0
MSFT,2020-01-29,168.0399932861328,168.75,165.69000244140625,167.83999633789062,34754500.0,2.579986572265625,0.0,2.579986572265625,65.28310385604598,160.1999969482422,168.75,91.69583087199933,-8.304169128000671,0.8190289684264371,0.7016018026440732,0.029783066726861485,52956100.0,1.0
MSFT,2020-01-30,172.77999877929688,174.0500030517578,170.7899932861328,174.0500030517578,51597500.0,4.7400054931640625,0.0,4.7400054931640625,75.47849694462609,160.1999969482422,174.0500030517578,90.83029810262275,-9.169701897377253,1.2481101678101822,0.812178336313013,0.03977854416072857,104553600.0,1.0
MSFT,2020-01-31,170.22999572753906,172.39999389648438,169.5800018310547,172.2100067138672,36142700.0,-2.5500030517578125,2.5500030517578125,0.0,63.840706538333365,160.1999969482422,174.0500030517578,72.4187318354387,-27.581268164561283,1.3959644893472216,0.9300224873673965,0.018731235844985372,68410900.0,-1.0
MSFT,2020-02-03,174.3800048828125,174.5,170.39999389648438,170.42999267578125,30107000.0,4.1500091552734375,0.0,4.1500091552734375,71.9594682478317,160.1999969482422,174.5,99.1608734854588,-0.839126514541196,1.7721686309055258,1.0997037427518959,0.04732735665352861,98517900.0,1.0
MSFT,2020-02-04,180.1199951171875,180.63999938964844,176.30999755859375,177.13999938964844,36433300.0,5.739990234375,0.0,5.739990234375,79.35657163651925,160.1999969482422,180.63999938964844,97.45594809026275,-2.5440519097372563,2.4328866769409956,1.3679236202893688,0.08702473406471767,134951200.0,1.0
MSFT,2020-02-05,179.89999389648438,184.1999969482422,178.41000366210938,184.02999877929688,39186300.0,-0.220001220703125,0.220001220703125,0.0,78.44144150850514,160.1999969482422,184.1999969482422,82.08332061767578,-17.91667938232422,2.9022114745851013,1.6762371606778608,0.07905465798511857,95764900.0,-1.0
MSFT,2020-02-06,183.6300048828125,183.82000732421875,180.05999755859375,180.97000122070312,27751400.0,3.730010986328125,0.0,3.730010986328125,82.40974604143217,160.1999969482422,184.1999969482422,97.62503306070963,-2.3749669392903643,3.4923070172523865,2.040828519201916,0.11263943500318652,123516300.0,1.0
MSFT,2020-02-07,183.88999938964844,185.6300048828125,182.47999572753903,182.8500061035156,33529100.0,0.2599945068359375,0.0,0.2599945068359375,82.66635810126294,160.1999969482422,185.6300048828125,93.15766830415083,-6.842331695849167,3.9289953509435236,2.4196066722731215,0.13316490493533628,157045400.0,1.0
MSFT,2020-02-10,188.6999969482422,188.83999633789065,183.25,183.5800018310547,35844300.0,4.80999755859375,0.0,4.80999755859375,86.78244597415784,160.1999969482422,188.83999633789065,99.51117530505581,-0.48882469494418623,4.564268775600567,2.849578701514334,0.14045684329364438,192889700.0,1.0
MSFT,2020-02-11,184.44000244140625,190.6999969482422,183.5,190.6499938964844,53159900.0,-4.2599945068359375,4.2599945068359375,0.0,69.83576033182347,160.1999969482422,190.6999969482422,79.47542784643954,-20.52457215356045,4.70180265472348,3.2207414252762177,0.09759586890335115,139729800.0,-1.0
MSFT,2020-02-12,184.7100067138672,185.8500061035156,181.8500061035156,185.5800018310547,47062900.0,0.2700042724609375,0.0,0.2700042724609375,70.26047418841603,160.1999969482422,190.6999969482422,80.36068775614754,-19.63931224385246,4.7738959542601265,3.531853754083682,0.06904738985332037,186792700.0,1.0
MSFT,2020-02-13,183.7100067138672,186.22999572753903,182.8699951171875,183.0800018310547,35295800.0,-1.0,1.0,0.0,66.27282623752087,160.1999969482422,190.6999969482422,77.08199923155738,-22.918000768442624,4.702138855513965,3.766200882062555,0.07918704884363326,151496900.0,-1.0
MSFT,2020-02-14,185.3500061035156,185.41000366210935,182.6499938964844,183.25,23149500.0,1.639999389648409,0.0,1.639999389648409,69.54377266963637,163.07000732421875,190.6999969482422,80.6370146441353,-19.362985355864687,4.711560049657606,3.955460148880926,0.06290859567342721,174646400.0,1.0
MSFT,2020-02-18,187.22999572753903,187.6999969482422,185.5,185.6100006103516,27792200.0,1.8799896240234375,0.0,1.8799896240234375,73.00645801549837,165.69000244140625,190.6999969482422,86.12554185185964,-13.874458148140354,4.802803829893662,4.125063258510799,0.03947368866918799,202438600.0,1.0
MSFT,2020-02-19,187.27999877929688,188.17999267578125,186.47000122070312,188.05999755859372,29997500.0,0.05000305175784092,0.0,0.05000305175784092,73.10031639691304,169.5800018310547,190.6999969482422,83.80682310782302,-16.19317689217698,4.82234110466149,4.264607274268604,0.04102281897273996,232436100.0,1.0
MSFT,2020-02-20,184.4199981689453,187.25,181.1000061035156,186.9499969482422,36862400.0,-2.8600006103515625,2.8600006103515625,0.0,59.45664868023939,169.5800018310547,190.6999969482422,70.26515042048376,-29.734849579516226,4.569014669240232,4.3255196395014694,0.004302092605383168,195573700.0,-1.0
MSFT,2020-02-21,178.58999633789062,183.5,177.25,183.1699981689453,48572600.0,-5.8300018310546875,5.8300018310546875,0.0,41.31809544955287,170.39999389648438,190.6999969482422,40.34483354768296,-59.65516645231704,3.8818987572995525,4.2367594576537915,-0.02882159480857638,147001100.0,-1.0
MSFT,2020-02-24,170.88999938964844,174.5500030517578,163.22999572753906,167.77000427246094,68311100.0,-7.6999969482421875,7.6999969482421875,0.0,28.20514700157341,163.22999572753906,190.6999969482422,27.884977508979187,-72.11502249102081,2.7206843660219135,3.933446008485587,-0.09438260650040597,78690000.0,-1.0
MSFT,2020-02-25,168.07000732421875,174.83999633789062,167.64999389648438,174.1999969482422,68073300.0,-2.8199920654296875,2.8199920654296875,0.0,24.869823237314662,163.22999572753906,190.6999969482422,17.619262401167823,-82.38073759883218,1.5678891577127274,3.4602117797010417,-0.08875512307796674,10616700.0,-1.0
MSFT,2020-02-26,170.1699981689453,173.25999450683594,168.2100067138672,169.7100067138672,56206100.0,2.0999908447265625,0.0,2.0999908447265625,31.7995236588646,163.22999572753906,190.6999969482422,25.26393204589968,-74.73606795410032,0.8070666875389634,2.9294725310392846,-0.07871803376330166,66822800.0,1.0
MSFT,2020-02-27,158.17999267578125,167.02999877929688,157.97999572753906,163.32000732421875,93174900.0,-11.990005493164062,11.990005493164062,0.0,19.780189925593163,157.97999572753906,190.6999969482422,0.6112375940733223,-99.38876240592668,-0.7103728322170184,2.201382483678724,-0.1389690986068579,-26352100.0,-1.0
MSFT,2020-02-28,162.00999450683594,163.7100067138672,152.0,152.41000366210938,97012700.0,3.8300018310546875,0.0,3.8300018310546875,29.58922743807706,152.0,190.6999969482422,25.865620920392878,-74.13437907960711,-1.597355453959949,1.4415338949493195,-0.12592398612409306,70660600.0,1.0
MSFT,2020-03-02,172.7899932861328,172.9199981689453,162.30999755859375,165.30999755859375,71030800.0,10.779998779296875,0.0,10.779998779296875,49.60260839325237,152.0,190.6999969482422,53.72091712032325,-46.27908287967675,-1.4472012554959406,0.8637254217243627,-0.07712440725801017,141691400.0,1.0
MSFT,2020-03-03,164.50999450683594,175.0,162.25999450683594,173.8000030517578,71677000.0,-8.279998779296875,8.279998779296875,0.0,39.621629206632406,152.0,188.17999267578125,34.577106244717626,-65.42289375528237,-1.9495141853534221,0.30102963144496264,-0.1215826805899044,70014400.0,-1.0
MSFT,2020-03-04,170.5500030517578,170.6999969482422,165.6199951171875,168.49000549316406,49814400.0,6.040008544921875,0.0,6.040008544921875,48.366534265769396,152.0,188.17999267578125,51.27143948864068,-48.728560511359326,-1.8548885608001342,-0.1301833538391126,-0.07520873687723029,119828800.0,1.0
MSFT,2020-03-05,166.27000427246094,170.8699951171875,165.69000244140625,166.0500030517578,47817300.0,-4.279998779296875,4.279998779296875,0.0,43.24538456744143,152.0,188.17999267578125,39.44170027987104,-60.55829972012895,-2.090294711794769,-0.5222269703150039,-0.06898478256374663,72011500.0,-1.0
MSFT,2020-03-06,161.57000732421875,163.11000061035156,156.0,162.61000061035156,72821100.0,-4.6999969482421875,4.6999969482421875,0.0,38.129866483600246,152.0,188.17999267578125,26.451103542165384,-73.54889645783462,-2.614754555950384,-0.9407507167222129,-0.05453796066895089,-809600.0,-1.0
MSFT,2020-03-09,150.6199951171875,157.75,150.0,151.0,70419300.0,-10.95001220703125,10.95001220703125,0.0,28.93029405689701,150.0,188.17999267578125,1.62387437434157,-98.37612562565843,-3.845571235538614,-1.521735064835355,-0.10382585498059127,-71228900.0,-1.0
MSFT,2020-03-10,160.9199981689453,161.02999877929688,152.5800018310547,158.16000366210938,65354400.0,10.300003051757812,0.0,10.300003051757812,43.67871622439458,150.0,187.25,29.315431326027685,-70.68456867397231,-3.964238884298794,-2.0102494465214824,-0.05435740788347765,-5874500.0,1.0
MSFT,2020-03-11,153.6300048828125,157.6999969482422,151.14999389648438,157.1300048828125,56371600.0,-7.2899932861328125,7.2899932861328125,0.0,37.349081479289076,150.0,183.5,10.835835471082088,-89.16416452891791,-4.5799637100550115,-2.5242037607923944,-0.028764622604925627,-62246100.0,-1.0
MSFT,2020-03-12,139.05999755859375,153.47000122070312,138.5800018310547,145.3000030517578,93226400.0,-14.57000732421875,14.57000732421875,0.0,27.993891558849995,138.5800018310547,175.0,1.317945501568823,-98.68205449843119,-6.147284944423035,-3.248832925334812,-0.1416579083167232,-155472500.0,-1.0
MSFT,2020-03-13,158.8300018310547,161.91000366210938,140.72999572753906,147.5,92727400.0,19.770004272460938,0.0,19.770004272460938,48.27756282585591,138.5800018310547,175.0,55.601320752582616,-44.398679247417384,-5.758649794459302,-3.7508034635226344,-0.0807916661699325,-62745100.0,1.0
MSFT,2020-03-16,135.4199981689453,149.35000610351562,135.0,140.0,87905900.0,-23.410003662109375,23.410003662109375,0.0,34.860589077400306,135.0,175.0,1.0499954223632812,-98.95000457763672,-7.221694806326212,-4.444989658288509,-0.17682813998684943,-150651000.0,-1.0
MSFT,2020-03-17,146.57000732421875,147.5,135.0,140.0,81059800.0,11.150009155273438,0.0,11.150009155273438,43.491293573100315,135.0,175.0,28.925018310546875,-71.07498168945312,-7.4107483405301195,-5.038146812862784,-0.14060390089973618,-69591200.0,1.0
MSFT,2020-03-18,140.39999389648438,146.0,135.02000427246094,138.0,81593200.0,-6.170013427734375,6.170013427734375,0.0,40.09899045777311,135.0,175.0,13.499984741210938,-86.50001525878906,-7.958625193286309,-5.622246757262614,-0.15559036333206722,-151184400.0,-1.0
MSFT,2020-03-19,142.7100067138672,150.14999389648438,139.0,142.77000427246094,85922700.0,2.3100128173828125,0.0,2.3100128173828125,42.051576317710996,135.0,175.0,19.27501678466797,-80.72498321533203,-8.115274266615444,-6.1208551740012505,-0.11672958937549371,-65261700.0,1.0
MSFT,2020-03-20,137.35000610351562,147.10000610351562,135.86000061035156,146.0,84866200.0,-5.3600006103515625,5.3600006103515625,0.0,38.67622893050659,135.0,175.0,5.8750152587890625,-94.12498474121094,-8.567114041287539,-6.610109235604466,-0.08810243954228902,-150127900.0,-1.0
MSFT,2020-03-23,135.97999572753906,140.57000732421875,132.52000427246094,137.00999450683594,78975200.0,-1.3700103759765625,1.3700103759765625,0.0,37.78184038327866,132.52000427246094,170.8699951171875,9.022144148839875,-90.97785585116013,-8.93115097441455,-7.074319320182607,-0.15498385983836793,-229103100.0,-1.0
MSFT,2020-03-24,148.33999633789062,149.60000610351562,141.27000427246094,143.75,82516700.0,12.360000610351562,0.0,12.360000610351562,49.853461806656384,132.52000427246094,170.8699951171875,41.25161888429777,-58.74838111570223,-8.139759102580314,-7.287407914469415,-0.034433433423093684,-146586400.0,1.0
MSFT,2020-03-25,146.9199981689453,154.3300018310547,144.44000244140625,148.91000366210938,75638200.0,-1.4199981689453125,1.4199981689453125,0.0,48.603397727150224,132.52000427246094,163.11000061035156,47.07419294015301,-52.92580705984699,-7.5389638981746145,-7.337719231682125,0.05652236982845982,-222224600.0,-1.0
MSFT,2020-03-26,156.11000061035156,156.66000366210938,148.3699951171875,148.39999389648438,64568100.0,9.19000244140625,0.0,9.19000244140625,56.709393523690984,132.52000427246094,161.91000366210938,80.26538559983553,-19.734614400164478,-6.256431581345623,-7.121461287346906,-0.017125235719611442,-157656500.0,1.0
MSFT,2020-03-27,149.6999969482422,154.88999938964844,149.1999969482422,151.75,57042300.0,-6.410003662109375,6.410003662109375,0.0,50.32204251982519,132.52000427246094,161.91000366210938,58.45523318327213,-41.544766816727865,-5.686974795630476,-6.834563549334115,0.10544970441870505,-214698800.0,-1.0
MSFT,2020-03-30,160.22999572753906,160.60000610351562,150.00999450683594,152.44000244140625,63420300.0,10.529998779296875,0.0,10.529998779296875,59.06201710853587,132.52000427246094,161.91000366210938,94.28374287356387,-5.716257126436125,-4.343113616399648,-6.336272951844728,0.09319770567455765,-151278500.0,1.0
MSFT,2020-03-31,157.7100067138672,164.77999877929688,156.55999755859375,159.39999389648438,77927200.0,-2.519989013671875,2.519989013671875,0.0,56.32567089548244,132.52000427246094,164.77999877929688,78.08433580504315,-21.91566419495684,-3.4402343194588525,-5.75706465728171,0.12329069494223277,-229205700.0,-1.0
MSFT,2020-04-01,152.11000061035156,157.75,150.82000732421875,153.0,57969900.0,-5.600006103515625,5.600006103515625,0.0,50.34491420411637,132.52000427246094,164.77999877929688,60.72535546693747,-39.27464453306253,-3.1371411998853205,-5.233079554663957,0.06586779801174925,-287175600.0,-1.0
MSFT,2020-04-02,155.25999450683594,155.47999572753906,150.36000061035156,151.86000061035156,49630700.0,3.149993896484375,0.0,3.149993896484375,53.546308119809744,132.52000427246094,164.77999877929688,70.48975234498681,-29.510247655013195,-2.6143213112962087,-4.709327577225963,0.13039670627915534,-237544900.0,1.0
MSFT,2020-04-03,153.8300018310547,157.3800048828125,152.19000244140625,155.10000610351562,41243300.0,-1.42999267578125,1.42999267578125,0.0,51.797055791078385,132.52000427246094,164.77999877929688,66.0570402579521,-33.942959742047904,-2.288278181400983,-4.225117454906071,0.131269353319303,-278788200.0,-1.0
MSFT,2020-04-06,165.27000427246094,166.5,157.5800018310547,160.32000732421875,67111700.0,11.44000244140625,0.0,11.44000244140625,62.96504449612261,132.52000427246094,166.5,96.38023577930525,-3.619764220694747,-1.0994355079134266,-3.59998081436858,0.11412975834249672,-211676500.0,1.0
MSFT,2020-04-07,163.49000549316406,170.0,163.25999450683594,169.58999633789062,62769000.0,-1.779998779296875,1.779998779296875,0.0,60.45059190141224,132.52000427246094,170.0,82.63074906902241,-17.369250930977582,-0.2967681134582847,-2.939338061864127,0.11278251790586524,-274445500.0,-1.0
MSFT,2020-04-08,165.1300048828125,166.6699981689453,163.5,165.6699981689453,48318200.0,1.6399993896484375,0.0,1.6399993896484375,62.061233931694545,132.52000427246094,170.0,87.00641496175734,-12.99358503824265,0.4656220132991393,-2.2583458717415126,0.05777979781689169,-226127300.0,1.0
MSFT,2020-04-09,165.13999938964844,167.3699951171875,163.3300018310547,166.36000061035156,51385100.0,0.0099945068359375,0.0,0.0099945068359375,62.072095273493964,132.52000427246094,170.0,87.03308120502106,-12.966918794978929,1.0583825029082448,-1.5950000603692418,0.10313963096969547,-174742200.0,1.0
MSFT,2020-04-13,165.50999450683594,165.57000732421875,162.3000030517578,164.35000610351562,41905300.0,0.3699951171875,0.0,0.3699951171875,62.53030360696188,141.27000427246094,170.0,84.37171541637169,-15.628284583628322,1.540089542140123,-0.9679820366912674,0.032952623853745644,-132836900.0,1.0
MSFT,2020-04-14,173.6999969482422,173.75,168.0,169.0,52874300.0,8.19000244140625,0.0,8.19000244140625,71.36570947584663,144.44000244140625,173.75,99.82939933154941,-0.17060066845058985,2.5506752510936224,-0.2642504864948116,0.10138855845327299,-79962600.0,1.0
MSFT,2020-04-15,171.8800048828125,173.57000732421875,169.24000549316406,171.1999969482422,40940800.0,-1.8199920654296875,1.8199920654296875,0.0,67.2968345774284,148.3699951171875,173.75,92.63201435215692,-7.367985647843088,3.1686659506478634,0.42233287323939034,0.1299717585506046,-120903400.0,-1.0
MSFT,2020-04-16,177.0399932861328,177.27999877929688,172.89999389648438,174.3000030517578,50479600.0,5.1599884033203125,0.0,5.1599884033203125,72.43761128683536,149.1999969482422,177.27999877929688,99.1452796384841,-0.8547203615159019,4.026929031283288,1.1432521655854997,0.14028081637177903,-70423800.0,1.0
MSFT,2020-04-17,178.60000610351562,180.0,175.8699951171875,179.5,52765600.0,1.5600128173828125,0.0,1.5600128173828125,73.8704528796116,150.00999450683594,180.0,95.33179846598064,-4.668201534019359,4.777471923642764,1.870096166186141,0.16102193315751778,-17658200.0,1.0
MSFT,2020-04-20,175.05999755859375,178.75,174.99000549316406,176.6300048828125,36669600.0,-3.540008544921875,3.540008544921875,0.0,65.0202359103003,150.36000061035156,180.0,83.33332475326733,-16.66667524673267,5.0294350244011525,2.5019639718993876,0.059236358885749185,-54327800.0,-1.0
MSFT,2020-04-21,167.82000732421875,173.6699981689453,166.11000061035156,173.5,56203700.0,-7.239990234375,7.239990234375,0.0,50.68913347666285,150.36000061035156,180.0,58.90690645548722,-41.09309354451278,4.593492640382664,2.920269723640044,0.026484810603518705,-110531500.0,-1.0
MSFT,2020-04-22,173.52000427246094,174.0,170.82000732421875,171.38999938964844,34620200.0,5.6999969482421875,0.0,5.6999969482421875,58.915272100848796,150.36000061035156,180.0,78.13766578618029,-21.862334213819707,4.653157998793887,3.266847390630768,0.050808448746807455,-75911300.0,1.0
MSFT,2020-04-23,171.4199981689453,175.05999755859375,170.91000366210938,174.11000061035156,32790800.0,-2.100006103515625,2.100006103515625,0.0,55.01388079209045,152.19000244140625,180.0,69.14777927262593,-30.852220727374085,4.479718653350545,3.5094216498714674,0.03802833233927294,-108702100.0,-1.0
MSFT,2020-04-24,174.5500030517578,174.55999755859375,170.7100067138672,172.05999755859375,34277600.0,3.1300048828125,0.0,3.1300048828125,59.61329394321792,157.5800018310547,180.0,75.69135863806109,-24.308641361938914,4.541924583419473,3.715922241141756,0.05461910969097694,-74424500.0,1.0
MSFT,2020-04-27,174.0500030517578,176.89999389648438,173.3000030517578,176.58999633789062,33194400.0,-0.5,0.5,0.0,58.51065893252867,162.3000030517578,180.0,66.38419223663713,-33.61580776336287,4.499076331735893,3.87255306202801,0.002015003509872937,-107618900.0,-1.0
MSFT,2020-04-28,169.80999755859375,175.6699981689453,169.38999938964844,175.58999633789062,34392700.0,-4.2400054931640625,4.2400054931640625,0.0,49.54411544523227,162.3000030517578,180.0,42.42935481173496,-57.57064518826505,4.076602390881618,3.91336292837557,-0.01204332828376442,-142011600.0,-1.0
MSFT,2020-04-29,177.42999267578125,177.67999267578125,171.8800048828125,173.22000122070312,51286600.0,7.6199951171875,0.0,7.6199951171875,61.711444063545535,162.3000030517578,180.0,85.4801821054891,-14.519817894510886,4.30597889960444,3.99188612350927,0.0022028886378124835,-90725000.0,1.0
MSFT,2020-04-30,179.2100067138672,180.3999938964844,176.22999572753906,180.0,53875900.0,1.7800140380859375,0.0,1.7800140380859375,64.04823707817376,162.3000030517578,180.3999938964844,93.42548185341255,-6.574518146587445,4.578376274562828,4.109184154781089,0.0034154568281370423,-36849100.0,1.0
MSFT,2020-05-01,174.57000732421875,178.63999938964844,174.00999450683594,175.8000030517578,39370500.0,-4.6399993896484375,4.6399993896484375,0.0,54.11460338477114,166.11000061035156,180.3999938964844,59.20231412618554,-40.797685873814466,4.36999465464595,4.1613462551315585,-0.0027989845836197125,-76219600.0,-1.0
MSFT,2020-05-04,178.83999633789062,179.0,173.8000030517578,174.49000549316406,30372900.0,4.269989013671875,0.0,4.269989013671875,60.6027879026754,166.11000061035156,180.3999938964844,89.08328697321632,-10.91671302678369,4.497093829860745,4.228495770466165,0.06566552575809315,-45846700.0,1.0
MSFT,2020-05-05,180.75999450683597,183.6499938964844,179.89999389648438,180.6199951171875,36839200.0,1.919998168945341,0.0,1.919998168945341,63.29550032881406,166.11000061035156,183.6499938964844,83.52337231546561,-16.476627684534392,4.698384360895261,4.322473488987259,0.04172423960413685,-9007500.0,1.0
MSFT,2020-05-06,182.5399932861328,184.1999969482422,181.6300048828125,182.0800018310547,32139300.0,1.7799987792968466,0.0,1.7799987792968466,65.796222010468,166.11000061035156,184.1999969482422,90.82363737889546,-9.176362621104538,4.944366553288091,4.446852102308291,0.06486988237059732,23131800.0,1.0
MSFT,2020-05-07,183.6000061035156,184.5500030517578,182.5800018310547,184.1699981689453,28316000.0,1.060012817382784,0.0,1.060012817382784,67.32586294237095,166.11000061035156,184.5500030517578,94.84817341396312,-5.151826586036874,5.1651986879747085,4.590521419867451,0.05184762471229676,51447800.0,1.0
MSFT,2020-05-08,184.67999267578125,185.0,183.3600006103516,184.97999572753903,30877800.0,1.0799865722656534,0.0,1.0799865722656534,68.95787015824067,166.11000061035156,185.0,98.30594317332742,-1.6940568266725904,5.365408967334616,4.745498929728401,0.06107434322113958,82325600.0,1.0
MSFT,2020-05-11,186.7400054931641,187.50999450683597,182.8500061035156,183.1499938964844,30892700.0,2.060012817382841,0.0,2.060012817382841,72.03236114779368,169.38999938964844,187.50999450683597,95.75061136224309,-4.249388637756917,5.6252953840580915,4.921458220928158,0.09969971249030007,113218300.0,1.0
MSFT,2020-05-12,182.50999450683597,187.0399932861328,182.3000030517578,186.8000030517578,32038200.0,-4.230010986328125,4.230010986328125,0.0,58.34180592860747,169.38999938964844,187.50999450683597,72.40617357971966,-27.593826420280344,5.4276411943437495,5.022694815764924,0.028631020913907346,81180100.0,-1.0
MSFT,2020-05-13,179.75,184.0500030517578,176.5399932861328,182.5500030517578,44711500.0,-2.759994506835966,2.759994506835966,0.0,51.03869935757973,169.38999938964844,187.50999450683597,57.17441171120788,-42.82558828879212,4.9909257712747035,5.016341006859165,0.0030131871318714865,36468600.0,-1.0
MSFT,2020-05-14,180.52999877929688,180.69000244140625,175.67999267578125,177.5399932861328,41873900.0,0.779998779296875,0.0,0.779998779296875,52.95886703540155,169.38999938964844,187.50999450683597,61.47904189599759,-38.52095810400241,4.654066814079982,4.943886168232951,0.034140981869863696,78342500.0,1.0
MSFT,2020-05-15,183.16000366210935,187.05999755859372,177.0,179.05999755859375,46610400.0,2.6300048828124716,0.0,2.6300048828124716,59.18622104900029,169.38999938964844,187.50999450683597,75.993421540161,-24.006578459838998,4.546765099818572,4.864461954488357,0.024155711321178552,124952900.0,1.0
MSFT,2020-05-18,184.91000366210935,186.1999969482422,183.9600067138672,185.75,35264500.0,1.75,0.0,1.75,62.95172552696338,171.8800048828125,187.50999450683597,83.36537062871491,-16.63462937128509,4.550391805884374,4.8016479247285115,0.02295867051000844,160217400.0,1.0
MSFT,2020-05-19,183.6300048828125,186.6000061035156,183.4900054931641,185.02999877929688,26799100.0,-1.2799987792968466,1.2799987792968466,0.0,58.40415426475958,173.8000030517578,187.50999450683597,71.69954746699477,-28.30045253300523,4.399322552491867,4.721182850241166,0.005971357712121206,133418300.0,-1.0
MSFT,2020-05-20,185.66000366210935,185.8500061035156,183.94000244140625,184.80999755859372,31261300.0,2.0299987792968466,0.0,2.0299987792968466,63.26079281519826,173.8000030517578,187.50999450683597,86.50625822205464,-13.493741777945356,4.392676300924137,4.65548154035162,0.011220029902571538,164679600.0,1.0
MSFT,2020-05-21,183.42999267578125,186.6699981689453,183.2899932861328,185.3999938964844,29119500.0,-2.2300109863280966,2.2300109863280966,0.0,55.10549435804438,173.8000030517578,187.50999450683597,70.2406683153439,-29.759331684656093,4.159601153008708,4.556305462851472,-0.006768464639233862,135560100.0,-1.0
MSFT,2020-05-22,183.50999450683597,184.4600067138672,182.5399932861328,183.19000244140625,20826900.0,0.08000183105471592,0.0,0.08000183105471592,55.34379645223258,175.67999267578125,187.50999450683597,66.18766372884512,-33.812336271154884,3.9359661308799616,4.432237596425579,-0.01729683458987774,156387000.0,1.0
MSFT,2020-05-26,181.57000732421875,186.5,181.1000061035156,186.33999633789065,36073600.0,-1.939987182617216,1.939987182617216,0.0,48.18710432417623,175.67999267578125,187.50999450683597,49.788788983749214,-50.211211016250786,3.561205604442989,4.258031197993574,-0.005150332644287103,120313400.0,-1.0
MSFT,2020-05-27,181.80999755859372,181.9900054931641,176.60000610351562,180.1999969482422,39517100.0,0.23999023437497158,0.0,0.23999023437497158,49.1261370313361,175.67999267578125,187.50999450683597,51.81744661036915,-48.18255338963084,3.2461422208857584,4.055653402539031,0.011460348031119505,159830500.0,1.0
MSFT,2020-05-28,181.3999938964844,184.1499938964844,180.3800048828125,180.7400054931641,33810200.0,-0.41000366210931816,0.41000366210931816,0.0,47.4315938279982,175.67999267578125,187.50999450683597,48.35165118645786,-51.64834881354214,2.929608597255026,3.8304444414528698,0.0048191166181257294,126020300.0,-1.0
MSFT,2020-05-29,183.25,184.2700042724609,180.41000366210935,182.72999572753903,42130400.0,1.8500061035155966,0.0,1.8500061035155966,55.43488151348848,175.67999267578125,187.50999450683597,63.989908305397435,-36.01009169460257,2.795754952563641,3.6235065436534413,0.0004913536585022804,168150700.0,1.0
MSFT,2020-06-01,182.8300018310547,183.0,181.4600067138672,182.5399932861328,22622400.0,-0.4199981689453125,0.4199981689453125,0.0,53.30887176206131,175.67999267578125,187.05999755859372,62.82957897559683,-37.17042102440317,2.62552849327858,3.4239109335618156,-0.01124872527099996,145528300.0,-1.0
MSFT,2020-06-02,184.91000366210935,185.0,181.3500061035156,184.25,30794600.0,2.080001831054659,0.0,2.080001831054659,61.701977675534685,175.67999267578125,187.05999755859372,81.10726736390448,-18.892732636095516,2.6281171287260747,3.264752172584044,0.006970531750046582,176322900.0,1.0
MSFT,2020-06-03,185.3600006103516,185.94000244140625,183.5800018310547,184.82000732421875,27311000.0,0.44999694824224434,0.0,0.44999694824224434,63.3467093781203,175.67999267578125,187.05999755859372,85.06154465004069,-14.938455349959312,2.636081547094676,3.139018047479456,-0.0016158733482724008,203633900.0,1.0
MSFT,2020-06-04,182.9199981689453,185.83999633789065,182.3000030517578,184.3000030517578,28761800.0,-2.4400024414062784,2.4400024414062784,0.0,49.93090413543,176.60000610351562,187.05999755859372,60.42062359775131,-39.579376402248684,2.4176833144498744,2.994751100867377,-0.002780322342035846,174872100.0,-1.0
MSFT,2020-06-05,187.1999969482422,187.72999572753903,182.00999450683597,182.6199951171875,39893600.0,4.279998779296875,0.0,4.279998779296875,64.953346124461,176.60000610351562,187.72999572753903,95.23810176648433,-4.761898233515657,2.560367656516206,2.907874411994174,0.020107909933313017,214765700.0,1.0
MSFT,2020-06-08,188.3600006103516,188.5500030517578,184.44000244140625,185.94000244140625,33211600.0,1.1600036621094034,0.0,1.1600036621094034,67.95964229981182,176.60000610351562,188.5500030517578,98.41002100478218,-1.5899789952178227,2.7354944546465845,2.8733984205237135,0.037396007117014296,247977300.0,1.0
MSFT,2020-06-09,189.8000030517578,190.6999969482422,187.25999450683597,188.0,29783900.0,1.4400024414062216,0.0,1.4400024414062216,71.46559318972517,176.60000610351562,190.6999969482422,93.617060419433,-6.382939580567,2.956376518120294,2.8899940400433928,0.04394700841789012,277761200.0,1.0
MSFT,2020-06-10,196.83999633789065,198.5200042724609,191.00999450683597,191.1300048828125,43872300.0,7.039993286132841,0.0,7.039993286132841,82.35628440098064,176.60000610351562,198.5200042724609,92.33572958527718,-7.664270414722813,3.6572331867872094,3.0434418693948406,0.08511578258496,321633500.0,1.0
MSFT,2020-06-11,186.2700042724609,195.75999450683597,186.07000732421875,193.1300048828125,52854700.0,-10.569992065429744,10.569992065429744,0.0,49.576196062369654,176.60000610351562,198.5200042724609,44.11495883537554,-55.88504116462446,3.32160831237411,3.0990751579914733,0.016480241595966838,268778800.0,-1.0
MSFT,2020-06-12,187.7400054931641,191.72000122070312,185.17999267578125,190.5399932861328,43373600.0,1.4700012207031818,0.0,1.4700012207031818,52.60346437177407,176.60000610351562,198.5200042724609,50.82116934403231,-49.17883065596768,3.1380476919034948,3.106869664773965,0.026855568631709126,312152400.0,1.0
MSFT,2020-06-15,188.94000244140625,190.82000732421875,184.00999450683597,184.5800018310547,32770200.0,1.199996948242159,0.0,1.199996948242159,55.14024304734393,176.60000610351562,198.5200042724609,56.29560843382308,-43.70439156617692,3.0541830896827946,3.0963323497556368,0.021794379425036592,344922600.0,1.0
MSFT,2020-06-16,193.57000732421875,195.5800018310547,191.4600067138672,192.88999938964844,42556700.0,4.6300048828125,0.0,4.6300048828125,63.77248715079672,180.3800048828125,198.5200042724609,72.71225405295839,-27.287745947041625,3.322967024794451,3.1416592847637244,0.044292224249208756,387479300.0,1.0
MSFT,2020-06-17,194.2400054931641,196.32000732421875,193.69000244140625,195.02999877929688,25687800.0,0.6699981689453409,0.0,0.6699981689453409,64.90023266377335,180.41000366210935,198.5200042724609,76.36665579762378,-23.633344202376215,3.5491236215617903,3.2231521521238053,0.06188501769917787,413167100.0,1.0
MSFT,2020-06-18,196.32000732421875,196.4900054931641,194.0,194.0,23061600.0,2.080001831054659,0.0,2.080001831054659,68.42152258129856,181.3500061035156,198.5200042724609,87.1869703968798,-12.8130296031202,3.8517721102535063,3.348876143750322,0.04871800493938094,436228700.0,1.0
MSFT,2020-06-19,195.1499938964844,199.2899932861328,194.3699951171875,198.58999633789065,44441100.0,-1.1700134277343466,1.1700134277343466,0.0,64.23870107991577,181.3500061035156,199.2899932861328,76.92306383775,-23.07693616225001,3.951669406420592,3.469434796284818,0.03604795744388878,391787600.0,-1.0
MSFT,2020-06-22,200.57000732421875,200.75999450683597,195.22999572753903,195.7899932861328,32818900.0,5.420013427734347,0.0,5.420013427734347,73.04622176143855,182.00999450683597,200.75999450683597,98.98673502604152,-1.013264973958485,4.417225882328609,3.6589930134941326,0.056743962588472696,424606500.0,1.0
MSFT,2020-06-23,201.91000366210935,203.9499969482422,201.42999267578125,202.08999633789065,30917400.0,1.3399963378905966,0.0,1.3399963378905966,74.81560940071317,182.00999450683597,203.9499969482422,90.70194594744953,-9.29805405255046,4.838522789871149,3.894898968770089,0.02575699765567796,455523900.0,1.0
MSFT,2020-06-24,197.83999633789065,203.25,196.55999755859372,201.6000061035156,36740600.0,-4.070007324218693,4.070007324218693,0.0,60.82268697998822,182.00999450683597,203.9499969482422,72.15132210368196,-27.848677896318048,4.788812017727793,4.073681578561966,0.06211409137300539,418783300.0,-1.0
MSFT,2020-06-25,200.33999633789065,200.6100006103516,195.47000122070312,197.8000030517578,27803900.0,2.5,0.0,2.5,65.40814558936422,184.00999450683597,203.9499969482422,81.89568621689222,-18.104313783107777,4.89470553784372,4.237886370418564,0.06711404323030856,446587200.0,1.0
MSFT,2020-06-26,196.3300018310547,199.88999938964844,194.8800048828125,199.72999572753903,54675800.0,-4.009994506835966,4.009994506835966,0.0,53.762154103714366,184.00999450683597,203.9499969482422,61.78538523463632,-38.21461476536368,4.602027092191889,4.310714514773316,0.03911294217295369,391911400.0,-1.0
MSFT,2020-06-29,198.44000244140625,198.52999877929688,193.5500030517578,195.77999877929688,26701600.0,2.1100006103515625,0.0,2.1100006103515625,58.27291107652853,184.00999450683597,203.9499969482422,72.36713223568012,-27.632867764319887,4.488583426312317,4.34628829708115,0.025158831083942346,418613000.0,1.0
MSFT,2020-06-30,203.50999450683597,204.3999938964844,197.7400054931641,197.8800048828125,34310300.0,5.069992065429716,0.0,5.069992065429716,67.15626524968253,184.00999450683597,204.3999938964844,95.63511811530377,-4.364881884696235,4.752969552501497,4.427624548165282,0.047724406669655384,452923300.0,1.0
MSFT,2020-07-01,204.6999969482422,206.3500061035156,201.7700042724609,203.13999938964844,32061200.0,1.1900024414062216,0.0,1.1900024414062216,68.94668686464665,184.00999450683597,206.3500061035156,92.61410788381752,-7.385892116182465,5.000867678259681,4.542273174184231,0.04268535712808963,484984500.0,1.0
MSFT,2020-07-02,206.25999450683597,208.0200042724609,205.0,205.67999267578125,29315800.0,1.5599975585937784,0.0,1.5599975585937784,71.31219310518316,184.00999450683597,208.0200042724609,92.66968325791876,-7.330316742081229,5.262536959979826,4.686325931343421,0.05693057113926825,514300300.0,1.0
MSFT,2020-07-06,210.6999969482422,211.1300048828125,208.08999633789065,208.8300018310547,31897600.0,4.440002441406222,0.0,4.440002441406222,77.05274972448294,191.4600067138672,211.1300048828125,97.81388930046164,-2.1861106995383577,5.7617468630783435,4.90141011769049,0.050506004158679785,546197900.0,1.0
MSFT,2020-07-07,208.25,214.6699981689453,207.9900054931641,210.4499969482422,33600700.0,-2.4499969482421875,2.4499969482421875,0.0,68.34521862577311,193.5500030517578,214.6699981689453,69.60227436927434,-30.39772563072566,5.891771586841941,5.0994824115208415,0.031400110063394715,512597200.0,-1.0
MSFT,2020-07-08,212.8300018310547,213.25999450683597,208.69000244140625,210.07000732421875,33600000.0,4.5800018310546875,0.0,4.5800018310546875,74.54903760145244,193.5500030517578,214.6699981689453,91.28789411322717,-8.712105886772823,6.291840542559498,5.337954037728633,0.07576832678242984,546197200.0,1.0
MSFT,2020-07-09,214.32000732421875,216.3800048828125,211.47000122070312,216.3300018310547,33121700.0,1.4900054931640625,0.0,1.4900054931640625,76.2931099947725,193.5500030517578,216.3800048828125,90.97679634965415,-9.023203650345845,6.652438601823491,5.600850950547658,0.06978142778214691,579318900.0,1.0
MSFT,2020-07-10,213.6699981689453,214.0800018310547,211.0800018310547,213.6199951171875,26177600.0,-0.6500091552734375,0.6500091552734375,0.0,73.74922615195622,193.5500030517578,216.3800048828125,88.12962550804144,-11.87037449195856,6.807295888379258,5.842139938114017,0.088320665085166,553141300.0,-1.0
MSFT,2020-07-13,207.07000732421875,215.8000030517578,206.5,214.47999572753903,38135600.0,-6.5999908447265625,6.5999908447265625,0.0,53.032338787164896,193.5500030517578,216.3800048828125,59.220338099448796,-40.779661900551204,6.324568863879591,5.938625723267145,0.04348923995483567,515005700.0,-1.0
MSFT,2020-07-14,208.3500061035156,208.8500061035156,202.02999877929688,206.1300048828125,37591800.0,1.2799987792968466,0.0,1.2799987792968466,55.8101558196464,193.5500030517578,216.3800048828125,64.82699020911143,-35.173009790888564,5.9763938773461405,5.946179354082944,0.023782672730193966,552597500.0,1.0
MSFT,2020-07-15,208.0399932861328,211.3300018310547,205.02999877929688,209.55999755859372,32179400.0,-0.3100128173827841,0.3100128173827841,0.0,54.9027186731421,193.5500030517578,216.3800048828125,63.469071713629376,-36.530928286370624,5.6107702776915005,5.87909753880465,0.01631654317383857,520418100.0,-1.0
MSFT,2020-07-16,203.9199981689453,205.6999969482422,202.30999755859372,205.3999938964844,29940700.0,-4.1199951171875,4.1199951171875,0.0,43.9458562772346,193.5500030517578,216.3800048828125,45.422664412937685,-54.577335587062315,4.93172057192524,5.689622145428755,-0.011344887036798146,490477400.0,-1.0
MSFT,2020-07-17,202.8800048828125,205.0399932861328,201.38999938964844,204.47000122070312,31635300.0,-1.0399932861328125,1.0399932861328125,0.0,41.531760800880946,193.5500030517578,216.3800048828125,40.86728463754865,-59.13271536245135,4.260539176758272,5.403805551694643,-0.037114343515394776,458842100.0,-1.0
MSFT,2020-07-20,211.6000061035156,212.3000030517578,203.00999450683597,205.0,36884800.0,8.720001220703097,0.0,8.720001220703097,61.821891236050725,197.7400054931641,216.3800048828125,74.35622888511766,-25.64377111488234,4.381728497720189,5.199390140899743,0.01608646388242785,495726900.0,1.0
MSFT,2020-07-21,208.75,213.94000244140625,208.02999877929688,213.66000366210935,37990400.0,-2.8500061035155966,2.8500061035155966,0.0,54.667521809172726,201.38999938964844,216.3800048828125,49.09938567873085,-50.90061432126915,4.199396828003614,4.99939147832051,-0.019170238199280765,457736500.0,-1.0
MSFT,2020-07-22,211.75,212.3000030517578,208.38999938964844,209.1999969482422,49605700.0,3.0,0.0,3.0,60.25408759860314,201.38999938964844,216.3800048828125,69.11272057289149,-30.887279427108517,4.247999479859686,4.849113078628341,-0.011991448471401434,507342200.0,1.0
MSFT,2020-07-23,202.5399932861328,210.9199981689453,202.1499938964844,207.19000244140625,67457000.0,-9.210006713867188,9.210006713867188,0.0,41.94395663042398,201.38999938964844,216.3800048828125,7.671737658860833,-92.32826234113917,3.502979907391648,4.579886444380997,-0.05208969428647714,439885200.0,-1.0
MSFT,2020-07-24,201.3000030517578,202.8600006103516,197.50999450683597,200.4199981689453,39827000.0,-1.239990234375,1.239990234375,0.0,40.05314700016372,197.50999450683597,216.3800048828125,20.084824912162837,-79.91517508783717,2.780440181571038,4.219997191818999,-0.02786499284479471,400058200.0,-1.0
MSFT,2020-07-27,203.8500061035156,203.97000122070312,200.8600006103516,201.47000122070312,30160900.0,2.550003051757784,0.0,2.550003051757784,45.84584076298525,197.50999450683597,216.3800048828125,33.59834716758353,-66.40165283241647,2.386077819152206,3.853213317285635,-0.02159827150551774,430219100.0,1.0
MSFT,2020-07-28,202.0200042724609,204.6999969482422,201.7400054931641,203.6100006103516,23251400.0,-1.8300018310546875,1.8300018310546875,0.0,42.44925210979375,197.50999450683597,216.3800048828125,23.900409569284868,-76.09959043071514,1.9039317154345667,3.4633569969154165,-0.02893669105916652,406967700.0,-1.0
MSFT,2020-07-29,204.05999755859372,204.6499938964844,202.00999450683597,202.5,19632600.0,2.0399932861328125,0.0,2.0399932861328125,47.4563741003929,197.50999450683597,215.8000030517578,35.81191903585162,-64.18808096414837,1.66721706502409,3.1041290105371484,0.0006865407557155034,426600300.0,1.0
MSFT,2020-07-30,203.8999938964844,204.4600067138672,199.57000732421875,201.0,25079600.0,-0.16000366210931816,0.16000366210931816,0.0,47.0856296368548,197.50999450683597,215.8000030517578,34.93710445216056,-65.06289554783945,1.4499935672434958,2.773301921878416,0.005027548250805092,401520700.0,-1.0
MSFT,2020-07-31,205.00999450683597,205.1000061035156,199.00999450683597,204.3999938964844,51044000.0,1.1100006103515625,0.0,1.1100006103515625,50.19986777407452,197.50999450683597,213.94000244140625,45.64818245899501,-54.351817541005,1.35182612184866,2.489006761872463,-0.03114372120318265,452564700.0,1.0
MSFT,2020-08-03,216.5399932861328,217.63999938964844,210.44000244140625,211.5200042724609,78983000.0,11.529998779296847,0.0,11.529998779296847,70.7984697798185,197.50999450683597,217.63999938964844,94.5354901306813,-5.464509869318706,2.179271190636257,2.4270596476252217,0.03731733310722296,531547700.0,1.0
MSFT,2020-08-04,213.2899932861328,214.7700042724609,210.30999755859372,214.1699981689453,49280100.0,-3.25,3.25,0.0,62.4035158726675,197.50999450683597,217.63999938964844,78.39043691822562,-21.609563081774386,2.543462504108703,2.450340218921918,0.0072726955661526205,482267600.0,-1.0
MSFT,2020-08-05,212.94000244140625,215.0,211.57000732421875,214.8999938964844,28806400.0,-0.3499908447265625,0.3499908447265625,0.0,61.49742325129458,197.50999450683597,217.63999938964844,76.65178436069249,-23.34821563930751,2.7718929287407548,2.5146507608856856,0.05134792880426886,453461200.0,-1.0
MSFT,2020-08-06,216.3500061035156,216.3699951171875,211.5500030517578,212.33999633789065,32656800.0,3.4100036621093466,0.0,3.4100036621093466,66.90039197814046,197.50999450683597,217.63999938964844,93.59168915436146,-6.408310845638549,3.1912948660956317,2.649979581927675,0.07476404780723311,486118000.0,1.0
MSFT,2020-08-07,212.47999572753903,215.6999969482422,210.92999267578125,214.8500061035156,27820400.0,-3.8700103759765625,3.8700103759765625,0.0,56.515228503730434,197.50999450683597,217.63999938964844,74.36660501500847,-25.633394984991536,3.174801621780972,2.7549439898983348,0.042334998114452294,458297600.0,-1.0
MSFT,2020-08-10,208.25,211.8800048828125,206.3500061035156,211.6699981689453,36716500.0,-4.229995727539034,4.229995727539034,0.0,47.26237078762016,197.50999450683597,217.63999938964844,53.35321851975373,-46.64678148024627,2.788266302118444,2.7616084523423567,0.030838509037633743,421581100.0,-1.0
MSFT,2020-08-11,203.3800048828125,207.6499938964844,203.13999938964844,207.16000366210935,36446500.0,-4.8699951171875,4.8699951171875,0.0,38.819393105192134,197.50999450683597,217.63999938964844,29.160501500864033,-70.83949849913597,2.0651630480639085,2.622319371486667,-0.0033323173768340375,385134600.0,-1.0
MSFT,2020-08-12,209.19000244140625,210.27999877929688,204.75,205.2899932861328,28013100.0,5.80999755859375,0.0,5.80999755859375,50.89482632512138,197.50999450683597,217.63999938964844,58.022876807859014,-41.97712319214099,1.9385673094342621,2.4855689590761854,0.025944132924336838,413147700.0,1.0
MSFT,2020-08-13,208.6999969482422,211.3500061035156,208.1499938964844,209.44000244140625,22588900.0,-0.4900054931640625,0.4900054931640625,0.0,49.93570611858404,199.00999450683597,217.63999938964844,52.012881920100575,-47.987118079899425,1.7782021300923816,2.3440955932794245,0.017999134385046744,390558800.0,-1.0
MSFT,2020-08-14,208.8999938964844,209.58999633789065,207.50999450683597,208.75999450683597,17958900.0,0.19999694824221592,0.0,0.19999694824221592,50.37611944693639,199.00999450683597,217.63999938964844,53.0864025632794,-46.9135974367206,1.6482495638056207,2.204926387384664,-0.03528216323325095,408517700.0,1.0
MSFT,2020-08-17,210.27999877929688,211.19000244140625,208.9199981689453,209.6000061035156,20184800.0,1.3800048828124716,0.0,1.3800048828124716,53.62421497598656,199.00999450683597,217.63999938964844,60.49383423864963,-39.50616576135037,1.637736720171631,2.0914884539420573,-0.014112216238846065,428702500.0,1.0
MSFT,2020-08-18,211.4900054931641,212.3600006103516,209.2100067138672,210.52999877929688,21336200.0,1.210006713867216,0.0,1.210006713867216,56.504512415349126,199.00999450683597,217.63999938964844,66.98876927209953,-33.01123072790046,1.7073607997378133,2.0146629231012083,-0.006809415476742742,450038700.0,1.0
MSFT,2020-08-19,209.6999969482422,212.1000061035156,209.25,211.4900054931641,27627600.0,-1.7900085449219034,1.7900085449219034,0.0,51.08844592942227,199.00999450683597,217.63999938964844,57.380567040368966,-42.619432959631034,1.599660351542468,1.9316624087894603,-0.030737272787926928,422411100.0,-1.0
MSFT,2020-08-20,214.5800018310547,215.0,208.91000366210935,209.5399932861328,26981500.0,4.8800048828125,0.0,4.8800048828125,62.41962341518077,203.13999938964844,217.63999938964844,78.89656856142241,-21.103431438577587,1.8863365398215706,1.9225972349958822,0.009883312056389926,449392600.0,1.0
MSFT,2020-08-21,213.0200042724609,216.25,212.8500061035156,213.8600006103516,36249300.0,-1.5599975585937784,1.5599975585937784,0.0,57.50572439318341,203.13999938964844,216.3699951171875,74.6788214167494,-25.321178583250603,1.9649998504204973,1.9310777580808054,0.02290518258084462,413143300.0,-1.0
MSFT,2020-08-24,213.69000244140625,215.5200042724609,212.42999267578125,214.7899932861328,25460100.0,0.6699981689453409,0.0,0.6699981689453409,59.10128162359249,203.13999938964844,216.3699951171875,79.74305713339969,-20.256942866600312,2.057684444392862,1.9563990953432167,0.05069327028748161,438603400.0,1.0
MSFT,2020-08-25,216.47000122070312,216.6100006103516,213.1000061035156,213.1000061035156,23043700.0,2.779998779296875,0.0,2.779998779296875,65.33311304336057,203.13999938964844,216.6100006103516,98.96065792901867,-1.039342070981325,2.3286167741203485,2.0308426310986434,0.034800892462994115,461647100.0,1.0
MSFT,2020-08-26,221.1499938964844,222.08999633789065,217.3600006103516,217.8800048828125,39600800.0,4.679992675781278,0.0,4.679992675781278,73.25033499426475,203.13999938964844,222.08999633789065,95.03956415415969,-4.960435845840301,2.8876804198217485,2.2022101888432646,0.05965499343696612,501247900.0,1.0
MSFT,2020-08-27,226.5800018310547,231.1499938964844,219.3999938964844,222.88999938964844,57602200.0,5.430007934570284,0.0,5.430007934570284,79.51388754764663,203.13999938964844,231.1499938964844,83.68442355704715,-16.31557644295285,3.725947067735177,2.506957564621647,0.0846338365300825,558850100.0,1.0
MSFT,2020-08-28,228.91000366210935,230.63999938964844,226.5800018310547,228.17999267578125,26292900.0,2.330001831054659,0.0,2.330001831054659,81.6421619305626,203.13999938964844,231.1499938964844,92.00288941924507,-7.997110580754942,4.52611635335461,2.91078932236824,0.08859618123911983,585143000.0,1.0
MSFT,2020-08-31,225.52999877929688,228.6999969482422,224.30999755859372,227.0,28774200.0,-3.3800048828124716,3.3800048828124716,0.0,69.54833439553323,204.75,231.1499938964844,78.71213478600113,-21.28786521399887,4.8318204885551665,3.2949955556056256,0.0663860840770869,556368800.0,-1.0
MSFT,2020-09-01,227.2700042724609,227.4499969482422,224.42999267578125,225.50999450683597,25725500.0,1.740005493164034,0.0,1.740005493164034,72.011064682183,207.50999450683597,231.1499938964844,83.58718390778607,-16.412816092213934,5.15507233633457,3.667010911751415,0.08378639761523377,582094300.0,1.0
MSFT,2020-09-02,231.6499938964844,232.8600006103516,227.3500061035156,227.97000122070312,34080800.0,4.379989624023494,0.0,4.379989624023494,77.33499127738779,207.50999450683597,232.8600006103516,95.22679912215335,-4.7732008778466515,5.698985250064993,4.073405779414131,0.0795507126468824,616175100.0,1.0
MSFT,2020-09-03,217.3000030517578,229.30999755859372,214.9600067138672,229.2700042724609,58400300.0,-14.349990844726591,14.349990844726591,0.0,44.98648677420534,208.91000366210935,232.8600006103516,35.031317155404615,-64.96868284459539,4.9154555488769915,4.241815733306703,0.020092004006452946,557774800.0,-1.0
MSFT,2020-09-04,214.25,218.3600006103516,205.19000244140625,215.1000061035156,59664100.0,-3.0500030517578125,3.0500030517578125,0.0,40.801003872504026,205.19000244140625,232.8600006103516,32.7430363503312,-67.2569636496688,4.002257729088512,4.193904132463065,0.0026206071982581847,498110700.0,-1.0
MSFT,2020-09-08,202.66000366210935,210.02999877929688,202.1999969482422,206.5,52924300.0,-11.589996337890653,11.589996337890653,0.0,28.979256692484,202.1999969482422,232.8600006103516,1.5003478764604643,-98.49965212353953,2.316622884783442,3.8184478829271407,-0.06379635737385025,445186400.0,-1.0
MSFT,2020-09-09,211.2899932861328,214.83999633789065,206.6999969482422,207.6000061035156,45679000.0,8.629989624023466,0.0,8.629989624023466,43.134949497830476,202.1999969482422,232.8600006103516,29.64773402530388,-70.35226597469611,1.657999805645204,3.3863582674707535,-0.044585127209937236,490865400.0,1.0
MSFT,2020-09-10,205.3699951171875,214.7400054931641,204.1100006103516,213.3999938964844,35461500.0,-5.9199981689453125,5.9199981689453125,0.0,37.25715018116439,202.1999969482422,232.8600006103516,10.339196967751494,-89.66080303224851,0.6508400472640972,2.8392546234294223,-0.09360935008590054,455403900.0,-1.0
MSFT,2020-09-11,204.02999877929688,208.6300048828125,201.2400054931641,207.1999969482422,33620100.0,-1.339996337890625,1.339996337890625,0.0,35.976773892898436,201.2400054931641,232.8600006103516,8.82350954132894,-91.17649045867105,-0.25255636774636514,2.2208924251942648,-0.1086890240041124,421783800.0,-1.0
MSFT,2020-09-14,205.41000366210935,209.1999969482422,204.02999877929688,204.2400054931641,30375800.0,1.3800048828124716,0.0,1.3800048828124716,38.48870530448188,201.2400054931641,232.8600006103516,13.187852033154154,-86.81214796684584,-0.8473817000451902,1.6072376001463737,-0.08921205704823731,452159600.0,1.0
MSFT,2020-09-15,208.77999877929688,209.77999877929688,206.92999267578125,208.4199981689453,21823900.0,3.3699951171875284,0.0,3.3699951171875284,44.611965723006236,201.2400054931641,232.8600006103516,23.845649748485613,-76.15435025151439,-1.0349249249410093,1.0788050951288972,-0.08135699892449266,473983500.0,1.0
MSFT,2020-09-16,205.0500030517578,210.6499938964844,204.63999938964844,210.6199951171875,26328100.0,-3.7299957275390625,3.7299957275390625,0.0,39.58007250006224,201.2400054931641,232.8600006103516,12.049330002972528,-87.95066999702748,-1.4676157093566076,0.5695209342317961,-0.11482836842470678,447655400.0,-1.0
MSFT,2020-09-17,202.91000366210935,204.3300018310547,199.9600067138672,200.0500030517578,34011300.0,-2.139999389648466,2.139999389648466,0.0,36.830053888143404,199.9600067138672,232.8600006103516,8.966557737134982,-91.03344226286502,-1.9606055382709258,0.06349563973125154,-0.06622180942271305,413644100.0,-1.0
MSFT,2020-09-18,200.38999938964844,203.6499938964844,196.25,202.8000030517578,55225300.0,-2.520004272460909,2.520004272460909,0.0,33.65304153421302,196.25,232.8600006103516,11.30838383126888,-88.69161616873113,-2.5255338558437472,-0.4543102593837484,-0.06469078464574829,358418800.0,-1.0
MSFT,2020-09-21,202.5399932861328,202.7100067138672,196.3800048828125,197.19000244140625,39839700.0,2.149993896484375,0.0,2.149993896484375,38.84611490798497,196.25,232.8600006103516,17.181079435312267,-82.81892056468774,-2.7678511383293483,-0.9170184351728686,-0.0005921759291814821,398258500.0,1.0
MSFT,2020-09-22,207.4199981689453,208.1000061035156,202.0800018310547,205.05999755859372,33517100.0,4.8800048828125,0.0,4.8800048828125,49.24950054589625,196.25,232.8600006103516,30.51078389162048,-69.48921610837952,-2.5368705301499404,-1.2409888541682832,-0.01831603597027276,431775600.0,1.0
MSFT,2020-09-23,200.58999633789065,208.1000061035156,200.02999877929688,207.8999938964844,30803800.0,-6.830001831054659,6.830001831054659,0.0,38.63537449100024,196.25,229.30999755859372,13.127636595249841,-86.87236340475016,-2.8718357028877506,-1.5671582239121769,-0.02327505912715877,400971800.0,-1.0
MSFT,2020-09-24,203.19000244140625,205.57000732421875,199.1999969482422,199.8500061035156,31202500.0,2.6000061035155966,0.0,2.6000061035155966,43.94203374954719,196.25,218.3600006103516,31.388522161130282,-68.61147783886972,-2.894137558261832,-1.8325540907821083,-0.004117023687282728,432174300.0,1.0
MSFT,2020-09-25,207.82000732421875,209.0399932861328,202.5399932861328,203.5500030517578,29437300.0,4.6300048828125,0.0,4.6300048828125,52.39998523883406,196.25,214.83999633789065,62.2378138969099,-37.7621861030901,-2.509283983437001,-1.967900069313087,0.011732649915501492,461611600.0,1.0
MSFT,2020-09-28,209.44000244140625,212.57000732421875,208.05999755859372,210.8800048828125,32004900.0,1.6199951171875,0.0,1.6199951171875,55.13295889244596,196.25,214.83999633789065,70.95215190829282,-29.047848091707174,-2.049934385850321,-1.9843069326205338,0.0031612398983058565,493616500.0,1.0
MSFT,2020-09-29,207.25999450683597,210.07000732421875,206.80999755859372,209.3500061035156,24221900.0,-2.180007934570284,2.180007934570284,0.0,50.62017749203573,196.25,214.7400054931641,59.545652979424226,-40.454347020575774,-1.840587707623115,-1.9555630876210501,0.010777817225978481,469394600.0,-1.0
MSFT,2020-09-30,210.3300018310547,211.97999572753903,206.5399932861328,207.72999572753903,33829100.0,3.0700073242187216,0.0,3.0700073242187216,56.416874631550755,196.25,212.57000732421875,86.27448230467449,-13.7255176953255,-1.4106935362242439,-1.8465891773416891,0.03656792683963128,503223700.0,1.0
MSFT,2020-10-01,212.4600067138672,213.9900054931641,211.32000732421875,213.4900054931641,27158400.0,2.1300048828125,0.0,2.1300048828125,60.16082841550013,196.25,213.9900054931641,91.37543232505496,-8.624567674945032,-0.8878907355620242,-1.6548494889857563,0.06023258326753722,530382100.0,1.0
MSFT,2020-10-02,206.19000244140625,210.9900054931641,205.5399932861328,208.0,33154800.0,-6.2700042724609375,6.2700042724609375,0.0,46.57223914225389,196.25,213.9900054931641,56.03156349211119,-43.96843650788881,-0.9683400793144017,-1.5175476070514855,0.018021177427990587,497227300.0,-1.0
MSFT,2020-10-05,210.3800048828125,210.41000366210935,206.97999572753903,207.22000122070312,21331600.0,4.19000244140625,0.0,4.19000244140625,54.497136372067835,196.25,213.9900054931641,79.65051018872195,-20.349489811278037,-0.6860898861482951,-1.3512560628708477,0.014270594638884582,518558900.0,1.0
MSFT,2020-10-06,205.91000366210935,210.17999267578125,204.82000732421875,208.82000732421875,28554300.0,-4.470001220703153,4.470001220703153,0.0,46.08301416539356,196.25,213.9900054931641,54.45321685966624,-45.54678314033376,-0.8137161839781584,-1.2437480870923099,0.02652179780320263,490004600.0,-1.0
MSFT,2020-10-07,209.8300018310547,210.1100006103516,206.72000122070312,207.05999755859372,25681100.0,3.919998168945341,0.0,3.919998168945341,53.36824073199017,196.25,213.9900054931641,76.55015572733383,-23.44984427266617,-0.5917288664829243,-1.1133442429704328,0.03267877016519649,515685700.0,1.0
MSFT,2020-10-08,210.5800018310547,211.19000244140625,208.32000732421875,210.50999450683597,19925800.0,0.75,0.0,0.75,54.7189360240909,196.3800048828125,213.9900054931641,80.63598214695735,-19.364017853042657,-0.35123478745074976,-0.9609223518664961,0.013280696802835168,535611500.0,1.0
MSFT,2020-10-09,215.80999755859372,215.8600006103516,211.22999572753903,211.22999572753903,26458000.0,5.229995727539034,0.0,5.229995727539034,63.27741851345446,199.1999969482422,215.8600006103516,99.69986170008117,-0.3001382999188262,0.2583967021732576,-0.7170585410585454,0.030414414834480263,562069500.0,1.0
MSFT,2020-10-12,221.3999938964844,223.8600006103516,216.80999755859372,218.7899932861328,40461400.0,5.589996337890682,0.0,5.589996337890682,70.21924745164719,199.1999969482422,223.8600006103516,90.02430515593541,-9.975694844064591,1.1790090437498861,-0.337845024096859,0.06822348627043917,602530900.0,1.0
MSFT,2020-10-13,222.8600006103516,225.2100067138672,220.42999267578125,222.72000122070312,28950800.0,1.4600067138671875,0.0,1.4600067138671875,71.8243608402926,199.1999969482422,225.2100067138672,90.9649933825808,-9.035006617419192,2.003318262226742,0.13038763316786128,0.05957304554849707,631481700.0,1.0
MSFT,2020-10-14,220.8600006103516,224.22000122070312,219.1300048828125,223.0,23421700.0,-2.0,2.0,0.0,66.185923819241,202.5399932861328,225.2100067138672,80.81162978847722,-19.18837021152278,2.466770606256148,0.5976642277855189,0.0395368240188243,608060000.0,-1.0
MSFT,2020-10-15,219.66000366210935,220.3600006103516,216.00999450683597,217.1000061035156,22733100.0,-1.1999969482422443,1.1999969482422443,0.0,62.774257104116245,204.82000732421875,225.2100067138672,72.78075910794064,-27.21924089205936,2.7060367129572853,1.0193387248198724,0.06532810059270888,585326900.0,-1.0
1.0,1.0,1.0,1.0,1.0,1.0,1.0,1.0,1.0,1.0,1.0,1.0,1.0,1.0,1.0,1.0,1.0,1.0,1.0,1.0
MSFT,2020-10-19,214.22000122070312,222.3000030517578,213.72000122070312,220.4199981689453,27625800.0,-5.440002441406222,5.440002441406222,0.0,47.878665232087926,204.82000732421875,225.2100067138672,46.10100136273937,-53.89899863726063,2.518783663355009,1.6141587784464775,0.040357425141083425,557701100.0,-1.0
MSFT,2020-10-20,214.6499938964844,217.3699951171875,213.08999633789065,215.8000030517578,22753500.0,0.4299926757812784,0.0,0.4299926757812784,48.98275169110492,204.82000732421875,225.2100067138672,48.20984240566542,-51.79015759433457,2.2549638540101,1.742319793559202,0.022970938490057158,580454600.0,1.0
MSFT,2020-10-21,214.8000030517578,216.9199981689453,213.1199951171875,213.1199951171875,22724900.0,0.15000915527340908,0.0,0.15000915527340908,49.41409364805046,204.82000732421875,225.2100067138672,48.945542061201294,-51.05445793879871,2.034536368811729,1.8007631086097078,0.020039895450702838,603179500.0,1.0
MSFT,2020-10-22,214.88999938964844,216.05999755859372,211.6999969482422,213.92999267578125,22351500.0,0.089996337890625,0.0,0.089996337890625,49.708437373638894,204.82000732421875,225.2100067138672,49.38691695372,-50.61308304628,1.8458303664099844,1.809776560169763,-0.004263000692057872,625531000.0,1.0
MSFT,2020-10-23,216.22999572753903,216.27999877929688,213.16000366210935,215.02999877929688,18879600.0,1.3399963378905966,0.0,1.3399963378905966,54.27898071210746,204.82000732421875,225.2100067138672,55.958748135681105,-44.041251864318895,1.7838429610935407,1.8045898403545186,-0.023351392554069372,644410600.0,1.0
MSFT,2020-10-26,210.0800018310547,216.33999633789065,208.1000061035156,213.8500061035156,37111600.0,-6.149993896484347,6.149993896484347,0.0,36.643463601902134,206.72000122070312,225.2100067138672,18.171982758976398,-81.8280172410236,1.224350886357655,1.688542049555146,-0.057345413013981994,607299000.0,-1.0
MSFT,2020-10-27,213.25,214.6699981689453,210.3300018310547,211.58999633789065,36700300.0,3.1699981689453125,0.0,3.1699981689453125,46.90361367008689,208.1000061035156,225.2100067138672,30.099320355188325,-69.90067964481167,1.0249269990522123,1.5558190394545592,-0.03445621927610787,643999300.0,1.0
MSFT,2020-10-28,202.67999267578125,208.83999633789065,202.1000061035156,207.6699981689453,51195600.0,-10.57000732421875,10.57000732421875,0.0,28.898349217203304,202.1000061035156,225.2100067138672,2.5096778751527244,-97.49032212484727,0.013811746436800831,1.2474175808510077,-0.07730133252864502,592803700.0,-1.0
MSFT,2020-10-29,204.72000122070312,207.3600006103516,203.3699951171875,204.07000732421875,31432600.0,2.040008544921875,0.0,2.040008544921875,34.49789811774059,202.1000061035156,225.2100067138672,11.337062085640802,-88.66293791435919,-0.6157942562773258,0.874775213425341,-0.06801421375002614,624236300.0,1.0
MSFT,2020-10-30,202.47000122070312,204.2899932861328,199.6199951171875,203.5,36953700.0,-2.25,2.25,0.0,31.355340051060338,199.6199951171875,225.2100067138672,11.137181758391286,-88.86281824160871,-1.2815448782641568,0.44351119508744136,-0.05485015373468516,587282600.0,-1.0
MSFT,2020-11-02,202.3300018310547,205.27999877929688,200.1199951171875,204.2899932861328,30842200.0,-0.1399993896484375,0.1399993896484375,0.0,31.151606453333827,199.6199951171875,224.22000122070312,11.016284721489953,-88.98371527851005,-1.799707909315572,-0.005132625793161429,-0.05739572520729286,556440400.0,-1.0
MSFT,2020-11-03,206.42999267578125,208.1199951171875,203.1199951171875,203.88999938964844,27512000.0,4.0999908447265625,0.0,4.0999908447265625,43.54659037956287,199.6199951171875,222.3000030517578,30.02643375716601,-69.97356624283398,-1.858101829930206,-0.37572646662057047,-0.03896652819860402,583952400.0,1.0
MSFT,2020-11-04,216.38999938964844,218.32000732421875,212.4199981689453,214.0200042724609,42311800.0,9.960006713867188,0.0,9.960006713867188,62.48031311513925,199.6199951171875,222.3000030517578,73.94179191136449,-26.058208088635503,-1.088146704540378,-0.5182105142045321,0.0069803155300871556,626264200.0,1.0
MSFT,2020-11-05,223.2899932861328,224.1199951171875,221.1499938964844,222.0399932861328,36080100.0,6.899993896484375,0.0,6.899993896484375,70.41247337135422,199.6199951171875,224.1199951171875,96.61223742426658,-3.387762575733418,0.07792185269732954,-0.3989840408241598,0.032650407890169486,662344300.0,1.0
MSFT,2020-11-06,223.72000122070312,224.3600006103516,218.02999877929688,222.25999450683597,25231900.0,0.4300079345703125,0.0,0.4300079345703125,70.85553489128236,199.6199951171875,224.3600006103516,97.41309924193305,-2.586900758066946,1.0249229555063835,-0.11420264155805109,0.06492764313957711,687576200.0,1.0
MSFT,2020-11-09,218.38999938964844,228.1199951171875,217.8800048828125,224.44000244140625,44395000.0,-5.3300018310546875,5.3300018310546875,0.0,58.357284009132655,199.6199951171875,228.1199951171875,65.85966411389803,-34.14033588610197,1.3300100429996462,0.17463989535348848,0.024103162436803993,643181200.0,-1.0
MSFT,2020-11-10,211.00999450683597,216.5,209.72000122070312,214.5,44045100.0,-7.380004882812472,7.380004882812472,0.0,45.52733606664595,199.6199951171875,228.1199951171875,39.96491013911743,-60.03508986088257,0.965163268067613,0.33274456989631346,0.04109928030429666,599136100.0,-1.0
MSFT,2020-11-11,216.5500030517578,218.0399932861328,212.1999969482422,212.38999938964844,29440800.0,5.540008544921847,0.0,5.540008544921847,54.241121924410365,199.6199951171875,228.1199951171875,59.40353661252741,-40.59646338747259,1.1102536276462445,0.4882463814462998,0.057786253226430384,628576900.0,1.0
MSFT,2020-11-12,215.44000244140625,219.1100006103516,214.4600067138672,217.2100067138672,21593900.0,-1.1100006103515625,1.1100006103515625,0.0,52.30672115933312,199.6199951171875,228.1199951171875,55.50879762883771,-44.49120237116228,1.122728894062334,0.6151428839695067,0.06405887856228709,606983000.0,-1.0
MSFT,2020-11-13,216.50999450683597,217.4199981689453,214.16000366210935,216.3600006103516,18621100.0,1.069992065429716,0.0,1.069992065429716,54.126364196826785,199.6199951171875,228.1199951171875,59.26315575315251,-40.73684424684749,1.205063820981053,0.733127071371816,0.07008349007786574,625604100.0,1.0
MSFT,2020-11-16,217.22999572753903,217.7400054931641,214.5200042724609,214.8699951171875,24953300.0,0.7200012207030682,0.0,0.7200012207030682,55.44618361141895,199.6199951171875,228.1199951171875,61.78947582579486,-38.21052417420515,1.313274313997141,0.849156519896881,0.05231799367798384,650557400.0,1.0
MSFT,2020-11-17,214.4600067138672,217.67999267578125,214.0800018310547,216.1000061035156,24154100.0,-2.7699890136718466,2.7699890136718466,0.0,49.16681283476963,199.6199951171875,228.1199951171875,52.07021612870065,-47.92978387129934,1.1621207482843374,0.9117493655743724,-0.008919047466264596,626403300.0,-1.0
MSFT,2020-11-18,211.0800018310547,215.1699981689453,210.92999267578125,213.6499938964844,28372800.0,-3.3800048828125,3.3800048828125,0.0,42.40519365306428,199.6199951171875,228.1199951171875,40.210549873218206,-59.789450126781794,0.7608220376704651,0.881563899993591,-0.054682215156107605,598030500.0,-1.0
MSFT,2020-11-19,212.4199981689453,213.02999877929688,209.92999267578125,211.3800048828125,24792700.0,1.339996337890625,0.0,1.339996337890625,45.81398230741987,200.1199951171875,228.1199951171875,43.92858232770647,-56.07141767229352,0.5446381711934691,0.8141787542335667,-0.050509578893709106,622823200.0,1.0
MSFT,2020-11-20,210.38999938964844,213.2899932861328,210.0,212.1999969482422,22843100.0,-2.029998779296875,2.029998779296875,0.0,41.51862059582432,203.1199951171875,228.1199951171875,29.08001708984375,-70.91998291015625,0.20711942389809224,0.6927668881664718,-0.03663171400869192,599980100.0,-1.0
MSFT,2020-11-23,210.1100006103516,212.2899932861328,208.16000366210935,210.9499969482422,25683500.0,-0.2799987792968466,0.2799987792968466,0.0,40.90821224522152,208.16000366210935,228.1199951171875,9.769527971146164,-90.23047202885384,-0.08201476073992353,0.5378105583851928,-0.00426517188717912,574296600.0,-1.0
MSFT,2020-11-24,213.8600006103516,214.25,208.8600006103516,209.58999633789065,33979700.0,3.75,0.0,3.75,51.8481235833977,208.16000366210935,228.1199951171875,28.557111164454284,-71.44288883554572,-0.008464458870349745,0.42855555493408426,-0.012422084523191046,608276300.0,1.0
MSFT,2020-11-25,213.8699951171875,215.2899932861328,212.4600067138672,215.1100006103516,21012900.0,0.009994506835909078,0.0,0.009994506835909078,51.87552233091074,208.16000366210935,228.1199951171875,28.607183865429143,-71.39281613457086,0.050054165146519836,0.3528552769765714,-0.007287445722368835,629289200.0,1.0
MSFT,2020-11-27,215.22999572753903,216.2700042724609,214.0399932861328,214.8500061035156,14512200.0,1.360000610351534,0.0,1.360000610351534,55.82232982117111,208.16000366210935,228.1199951171875,35.42081709474362,-64.57918290525639,0.20382174720660373,0.3230485710225779,-0.005911961626586804,643801400.0,1.0
MSFT,2020-11-30,214.07000732421875,214.75999450683597,210.83999633789065,214.1000061035156,33064800.0,-1.159988403320284,1.159988403320284,0.0,51.65325170527823,208.16000366210935,219.1100006103516,53.97265122578971,-46.02734877421029,0.2294374832355004,0.3043263534651624,-0.01454674062270711,610736600.0,-1.0
MSFT,2020-12-01,216.2100067138672,217.32000732421875,213.3500061035156,214.50999450683597,30904500.0,2.1399993896484375,0.0,2.1399993896484375,58.285055290372654,208.16000366210935,219.1100006103516,73.5160300939634,-26.483969906036613,0.4176043191374106,0.32698194659961205,0.008160029586937734,641641100.0,1.0
MSFT,2020-12-02,215.3699951171875,215.47000122070312,212.8000030517578,214.8800048828125,23724500.0,-0.8400115966796875,0.8400115966796875,0.0,54.87576107893594,208.16000366210935,219.1100006103516,65.84468917350284,-34.15531082649715,0.4932599836135978,0.36023755400240925,0.02032401577088505,617916600.0,-1.0
MSFT,2020-12-03,214.2400054931641,216.3800048828125,213.6499938964844,214.6100006103516,25120900.0,-1.129989624023409,1.129989624023409,0.0,50.308211915298834,208.16000366210935,217.7400054931641,63.46556021884753,-36.53443978115247,0.4567715470296321,0.37954435260785385,0.008567966010296635,592795700.0,-1.0
MSFT,2020-12-04,214.3600006103516,215.3800048828125,213.17999267578125,214.22000122070312,24666000.0,0.1199951171875,0.0,0.1199951171875,50.80988126765351,208.16000366210935,217.7400054931641,64.71811861396726,-35.281881386032744,0.43255062676402645,0.39014560743908844,0.018869723999336063,617461700.0,1.0
MSFT,2020-12-07,214.2899932861328,215.5399932861328,212.9900054931641,214.3699951171875,24620000.0,-0.07000732421877842,0.07000732421877842,0.0,50.46690236566306,208.16000366210935,217.67999267578125,64.39072161974167,-35.60927838025833,0.4030601406186918,0.39272851407500914,0.019894306142681062,592841700.0,-1.0
MSFT,2020-12-08,216.00999450683597,216.9499969482422,212.88999938964844,213.97000122070312,23284100.0,1.7200012207031534,0.0,1.7200012207031534,58.42308387279241,208.16000366210935,217.32000732421875,85.69855574619815,-14.301444253801849,0.5125698539793859,0.4166967820558845,0.01005327733259298,616125800.0,1.0
MSFT,2020-12-09,211.8000030517578,215.22999572753903,211.2100067138672,215.16000366210935,32440600.0,-4.209991455078153,4.209991455078153,0.0,40.19094044570061,208.16000366210935,217.32000732421875,39.7379687161635,-60.26203128383649,0.25668703980019814,0.3846948336047472,-0.009678739948048576,583685200.0,-1.0
MSFT,2020-12-10,210.5200042724609,213.0800018310547,210.3600006103516,211.7700042724609,26733300.0,-1.2799987792969034,1.2799987792969034,0.0,36.2250682760562,208.16000366210935,217.32000732421875,25.764188502606906,-74.23581149739309,-0.04882432068336584,0.29799100274712464,-0.02188352715037234,556951900.0,-1.0
MSFT,2020-12-11,213.25999450683597,213.32000732421875,209.1100006103516,210.0500030517578,30979400.0,2.739990234375057,0.0,2.739990234375057,48.72259208276021,208.16000366210935,217.32000732421875,55.676733687595195,-44.323266312404805,-0.06905395303510886,0.22458201159067792,-0.003783868779693056,587931300.0,1.0
MSFT,2020-12-14,214.1999969482422,216.2100067138672,212.8800048828125,213.1000061035156,28798400.0,0.9400024414062216,0.0,0.9400024414062216,52.413913270905596,208.8600006103516,217.32000732421875,63.12047399604991,-36.87952600395009,-0.009130491324299328,0.17783951100768247,-0.009296562153504051,616729700.0,1.0
MSFT,2020-12-15,214.1300048828125,215.4199981689453,212.2400054931641,215.1699981689453,27000600.0,-0.0699920654296875,0.0699920654296875,0.0,52.091737887909105,209.1100006103516,217.32000732421875,61.14494722619218,-38.85505277380783,0.03233872838222851,0.14873935448259168,-0.005757488333972827,589729100.0,-1.0
MSFT,2020-12-16,219.27999877929688,220.1100006103516,214.72000122070312,214.75,35023300.0,5.149993896484375,0.0,5.149993896484375,68.51986775667221,209.1100006103516,220.1100006103516,92.4545288085935,-7.5454711914065085,0.47528604631673943,0.21404869284942127,0.023524986729397845,624752400.0,1.0
MSFT,2020-12-17,219.4199981689453,220.88999938964844,217.9199981689453,219.8699951171875,32515800.0,0.1399993896484375,0.0,0.1399993896484375,68.85486044368756,209.1100006103516,220.88999938964844,87.52121075524533,-12.47878924475466,0.8280762204452117,0.3368541983685794,0.023605138758099775,657268200.0,1.0
MSFT,2020-12-18,218.58999633789065,219.69000244140625,216.0200042724609,218.58999633789065,63354900.0,-0.8300018310546591,0.8300018310546591,0.0,64.18270172697173,209.1100006103516,220.88999938964844,80.47535407389005,-19.524645926109955,1.0288310405673826,0.47524956680834013,0.02006628021130319,593913300.0,-1.0
MSFT,2020-12-21,222.58999633789065,224.0,217.27999877929688,217.5500030517578,37181900.0,4.0,0.0,4.0,73.9949663656595,209.1100006103516,224.0,90.53053243850643,-9.46946756149357,1.4934813275763474,0.6788959189619417,0.030461561957247474,631095200.0,1.0
MSFT,2020-12-22,223.94000244140625,225.6300048828125,221.8500061035156,222.69000244140625,22612200.0,1.3500061035155966,0.0,1.3500061035155966,76.50184777372766,209.1100006103516,225.6300048828125,89.76996365416497,-10.230036345835025,1.9481966389927265,0.9327560629680988,0.057318221032705896,653707400.0,1.0
MSFT,2020-12-23,221.0200042724609,223.55999755859372,220.8000030517578,223.1100006103516,18699600.0,-2.919998168945341,2.919998168945341,0.0,61.66587516227562,209.1100006103516,225.6300048828125,72.09443451515004,-27.905565484849966,2.0493190769682315,1.1560686657681254,0.049876495282655364,635007800.0,-1.0
MSFT,2020-12-24,222.75,223.6100006103516,221.1999969482422,221.4199981689453,10550600.0,1.729995727539091,0.0,1.729995727539091,66.15305916267005,209.1100006103516,225.6300048828125,82.56656090813783,-17.433439091862166,2.243197351284266,1.3734944028713536,0.04449969866645498,645558400.0,1.0
MSFT,2020-12-28,224.9600067138672,226.02999877929688,223.0200042724609,224.4499969482422,17933500.0,2.2100067138671875,0.0,2.2100067138671875,71.13360894719443,209.1100006103516,226.02999877929688,93.67616914171106,-6.323830858288952,2.545829612703187,1.6079614448377206,0.05023347301085623,663491900.0,1.0
MSFT,2020-12-29,224.1499938964844,227.17999267578125,223.5800018310547,226.30999755859372,17403200.0,-0.8100128173827841,0.8100128173827841,0.0,66.96625778023255,209.1100006103516,227.17999267578125,83.23187543013013,-16.76812456986987,2.689305950675248,1.8242303460052263,0.04679395126878916,646088700.0,-1.0
MSFT,2020-12-30,221.67999267578125,225.6300048828125,221.47000122070312,225.22999572753903,20272300.0,-2.4700012207031534,2.4700012207031534,0.0,55.521652416324095,209.1100006103516,227.17999267578125,69.5627979243984,-30.4372020756016,2.574031691970305,1.974190615198242,0.010944882843144876,625816400.0,-1.0
MSFT,2020-12-31,222.4199981689453,223.0,219.67999267578125,221.6999969482422,20942100.0,0.7400054931640625,0.0,0.7400054931640625,58.002790358397405,209.1100006103516,227.17999267578125,73.65801551212382,-26.34198448787618,2.513415184350464,2.0820355290286865,0.013672409192575508,646758500.0,1.0
MSFT,2021-01-04,217.69000244140625,223.0,214.80999755859372,222.52999877929688,37130100.0,-4.7299957275390625,4.7299957275390625,0.0,41.095603847534136,212.2400054931641,227.17999267578125,36.47926120434221,-63.52073879565779,2.0599591150914023,2.0776202462412297,-0.004117269369880994,609628400.0,-1.0
MSFT,2021-01-05,217.8999938964844,218.5200042724609,215.6999969482422,217.25999450683597,23823000.0,0.20999145507815342,0.0,0.20999145507815342,41.9622106620143,212.2400054931641,227.17999267578125,37.88482770524577,-62.11517229475423,1.6979634034674405,2.0016888776864716,-0.021070140251437164,633451400.0,1.0
MSFT,2021-01-06,212.25,216.4900054931641,211.94000244140625,212.1699981689453,35930700.0,-5.649993896484403,5.649993896484403,0.0,28.805567626468957,211.94000244140625,227.17999267578125,2.0341060186149336,-97.96589398138507,0.944286756733419,1.790208453495861,-0.052201492872917754,597520700.0,-1.0
MSFT,2021-01-07,218.2899932861328,219.33999633789065,213.7100067138672,214.0399932861328,27694500.0,6.0399932861328125,0.0,6.0399932861328125,48.660708963803415,211.94000244140625,227.17999267578125,41.66663329221601,-58.33336670778399,0.8248610779133969,1.5971389783793684,-0.01235187283302508,625215200.0,1.0
MSFT,2021-01-08,219.6199951171875,220.5800018310547,217.02999877929688,218.67999267578125,22956200.0,1.3300018310546875,0.0,1.3300018310546875,52.05781033454923,211.94000244140625,227.17999267578125,50.39368501994457,-49.60631498005543,0.8279908363174115,1.4433093499669771,-0.01405164930555558,648171400.0,1.0
MSFT,2021-01-11,217.4900054931641,218.91000366210935,216.72999572753903,218.47000122070312,23031300.0,-2.129989624023409,2.129989624023409,0.0,46.386034686214934,211.94000244140625,227.17999267578125,36.41736619515261,-63.58263380484739,0.651093431371919,1.2848661662479657,-0.03320590770698362,625140100.0,-1.0
MSFT,2021-01-12,214.92999267578125,217.1000061035156,213.32000732421875,216.5,23249300.0,-2.560012817382841,2.560012817382841,0.0,40.29736572379801,211.94000244140625,227.17999267578125,19.619371065152265,-80.38062893484773,0.30086118397596806,1.0880651697935662,-0.04113317631835889,601890800.0,-1.0
MSFT,2021-01-13,216.33999633789065,216.75999450683597,213.92999267578125,214.0200042724609,20087100.0,1.4100036621094034,0.0,1.4100036621094034,44.89419595796317,211.94000244140625,227.17999267578125,28.871369527257766,-71.12863047274223,0.13551300648836673,0.8975547371325262,-0.024088760891022853,621977900.0,1.0
MSFT,2021-01-14,213.0200042724609,217.4600067138672,212.7400054931641,215.91000366210935,29480800.0,-3.3199920654297443,3.3199920654297443,0.0,37.1276614203242,211.94000244140625,227.17999267578125,7.0866307290580135,-92.913369270942,-0.26042026563479226,0.6659597365790625,-0.0422623593825604,592497100.0,-1.0
MSFT,2021-01-15,212.6499938964844,214.50999450683597,212.02999877929688,213.5200042724609,31746500.0,-0.37001037597650566,0.37001037597650566,0.0,36.3196754808096,211.94000244140625,227.17999267578125,4.658739567146911,-95.34126043285309,-0.5971731410783434,0.4133331610475813,-0.02315222788551541,560750600.0,-1.0
MSFT,2021-01-19,216.44000244140625,216.97999572753903,212.6300048828125,213.75,30480900.0,3.7900085449218466,0.0,3.7900085449218466,49.34772396817162,211.94000244140625,227.17999267578125,29.527577976066517,-70.47242202393349,-0.5518686085155196,0.2202928071349611,-0.006700282221080434,591231500.0,1.0
MSFT,2021-01-20,224.33999633789065,225.7899932861328,217.2899932861328,217.6999969482422,37777300.0,7.899993896484403,0.0,7.899993896484403,66.05187387247167,211.94000244140625,225.7899932861328,89.53070103440356,-10.469298965596435,0.12011443907806552,0.200257133523582,0.056961113488295245,629008800.0,1.0
MSFT,2021-01-21,224.97000122070312,226.3000030517578,222.4199981689453,224.6999969482422,30709400.0,0.6300048828124716,0.0,0.6300048828124716,67.05169778868768,211.94000244140625,226.3000030517578,90.73814920247328,-9.261850797526716,0.6954848579574104,0.29930267841034774,0.03060153071613425,659718200.0,1.0
MSFT,2021-01-22,225.9499969482422,230.07000732421875,225.8000030517578,227.0800018310547,30172700.0,0.9799957275390625,0.0,0.9799957275390625,68.70593529689998,211.94000244140625,230.07000732421875,77.27518330741108,-22.724816692588927,1.216524191569789,0.48274698104223607,0.028822520589152356,689890900.0,1.0
MSFT,2021-01-25,229.52999877929688,229.77999877929688,224.22000122070312,229.1199951171875,33152100.0,3.5800018310546875,0.0,3.5800018310546875,74.17187333051223,211.94000244140625,230.07000732421875,97.02146497801658,-2.9785350219834235,1.8964665594937458,0.7654908967325381,0.05535883480637094,723043000.0,1.0
MSFT,2021-01-26,232.3300018310547,234.17999267578125,230.0800018310547,231.8600006103516,49169600.0,2.8000030517578125,0.0,2.8000030517578125,77.68869861487741,211.94000244140625,234.17999267578125,91.68169218947253,-8.318307810527472,2.6309348509823565,1.1385796875825018,0.0809566358731566,772212600.0,1.0
MSFT,2021-01-27,232.8999938964844,240.44000244140625,230.13999938964844,238.0,69870600.0,0.5699920654297159,0.0,0.5699920654297159,78.3801609896063,212.02999877929688,240.44000244140625,73.46002262232014,-26.539977377679858,3.221860260012676,1.5552358020685368,0.07654616732418495,842083200.0,1.0
MSFT,2021-01-28,238.92999267578125,242.63999938964844,235.08999633789065,235.6100006103516,49111200.0,6.029998779296847,0.0,6.029998779296847,84.31416280204499,212.02999877929688,242.63999938964844,87.87975615847407,-12.120243841525939,4.129145194835843,2.0700176806219988,0.12163171478571777,891194400.0,1.0
MSFT,2021-01-29,231.9600067138672,238.0200042724609,231.3500061035156,235.9900054931641,42503100.0,-6.9699859619140625,6.9699859619140625,0.0,61.720477240678065,212.02999877929688,242.63999938964844,65.10946598227268,-34.89053401772731,4.236914908527723,2.5033971262031436,0.09080655241769109,848691300.0,-1.0
MSFT,2021-02-01,239.6499938964844,242.5,232.42999267578125,235.05999755859372,33314200.0,7.689987182617216,0.0,7.689987182617216,71.45739956565741,212.02999877929688,242.63999938964844,90.23193259214479,-9.768067407855217,4.886512209360177,2.9800201428345505,0.10723522081534576,882005500.0,1.0
MSFT,2021-02-02,239.50999450683597,242.30999755859372,238.69000244140625,241.3000030517578,25916300.0,-0.1399993896484375,0.1399993896484375,0.0,71.0776157311303,212.02999877929688,242.63999938964844,89.77456772165506,-10.22543227834494,5.328601172267014,3.4497363487210433,0.06762056885343326,856089200.0,-1.0
MSFT,2021-02-03,243.0,245.08999633789065,239.25999450683597,239.57000732421875,27158100.0,3.490005493164034,0.0,3.490005493164034,74.91282374008179,212.02999877929688,245.08999633789065,93.67817152984826,-6.321828470151745,5.8926473655932625,3.9383185520954873,0.08014401334162247,883247300.0,1.0
MSFT,2021-02-04,242.00999450683597,243.2400054931641,240.3699951171875,242.66000366210935,25296100.0,-0.9900054931640341,0.9900054931640341,0.0,71.79667235293326,212.02999877929688,245.08999633789065,90.6835993390627,-9.316400660937305,6.188436425154038,4.388342126707198,0.07107766220626499,857951200.0,-1.0
MSFT,2021-02-05,242.1999969482422,243.27999877929688,240.4199981689453,242.22999572753903,18054800.0,0.19000244140622158,0.0,0.19000244140622158,72.05409693288313,212.6300048828125,245.08999633789065,91.09673397897231,-8.903266021027694,6.364813388209939,4.7836363790077465,0.05519974833933605,876006000.0,1.0
MSFT,2021-02-08,242.47000122070312,243.67999267578125,240.80999755859372,243.1499938964844,22211900.0,0.2700042724609375,0.0,0.2700042724609375,72.46617132576532,217.2899932861328,245.08999633789065,90.57555816699143,-9.424441833008581,6.452005783966598,5.117310259999517,0.043644812593003124,898217900.0,1.0
MSFT,2021-02-09,243.7700042724609,244.75999450683597,241.3800048828125,241.8699951171875,23565000.0,1.300003051757784,0.0,1.300003051757784,74.55090891652344,222.4199981689453,245.08999633789065,94.17736139371222,-5.82263860628778,6.55049573020159,5.403947354039932,0.0466724373587053,921782900.0,1.0
MSFT,2021-02-10,242.82000732421875,245.9199981689453,240.88999938964844,245.0,22186700.0,-0.9499969482421591,0.9499969482421591,0.0,70.07701065138485,224.22000122070312,245.9199981689453,85.71432589543438,-14.285674104565613,6.4772274616886705,5.6186033755696805,0.01628098090521468,899596200.0,-1.0
MSFT,2021-02-11,244.4900054931641,245.1499938964844,242.1499938964844,244.77999877929688,15751100.0,1.669998168945341,0.0,1.669998168945341,73.32409796487137,224.22000122070312,245.9199981689453,93.4101710742542,-6.58982892574581,6.4792282167415465,5.790728343804054,0.05401792730051613,915347300.0,1.0
MSFT,2021-02-12,244.9900054931641,245.3000030517578,242.72999572753903,243.92999267578125,16561100.0,0.5,0.0,0.5,74.28798688037661,230.0800018310547,245.9199981689453,94.12883276016548,-5.8711672398345165,6.446844441146737,5.921951563272591,0.022282544263223736,931908400.0,1.0
MSFT,2021-02-16,243.6999969482422,246.1300048828125,242.9199981689453,245.02999877929688,26728500.0,-1.2900085449219034,1.2900085449219034,0.0,67.07314178199698,230.13999938964844,246.1300048828125,84.80295747484782,-15.197042525152183,6.245097559948334,5.9865807626077405,0.017494060947367496,905179900.0,-1.0
MSFT,2021-02-17,244.1999969482422,244.30999755859372,240.94000244140625,241.32000732421875,21653500.0,0.5,0.0,0.5,68.44376754954037,231.3500061035156,246.1300048828125,86.94175849815514,-13.058241501844863,6.055750601046526,6.000414730295498,0.004938259046264104,926833400.0,1.0
MSFT,2021-02-18,243.7899932861328,243.92999267578125,240.8600006103516,241.8000030517578,16925600.0,-0.410003662109375,0.410003662109375,0.0,65.85023578641994,231.3500061035156,246.1300048828125,84.1677145470576,-15.832285452942397,5.805683596377065,5.961468503511812,0.007355063095324299,909907800.0,-1.0
MSFT,2021-02-19,240.97000122070312,243.8600006103516,240.17999267578125,243.75,25262600.0,-2.8199920654296875,2.8199920654296875,0.0,50.625896668239236,232.42999267578125,246.1300048828125,62.33577325236901,-37.66422674763099,5.318643885601745,5.832903579929799,-0.005078429987767086,884645200.0,-1.0
MSFT,2021-02-22,234.50999450683597,237.92999267578125,232.3999938964844,237.4199981689453,36446900.0,-6.460006713867159,6.460006713867159,0.0,31.423137084786546,232.3999938964844,246.1300048828125,15.367799868861237,-84.63220013113877,4.3611205695008834,5.538546977844017,-0.03282883108752799,848198300.0,-1.0
MSFT,2021-02-23,233.2700042724609,234.8300018310547,228.72999572753903,230.3300018310547,30228700.0,-1.2399902343750568,1.2399902343750568,0.0,28.987901943829854,228.72999572753903,246.1300048828125,26.091989403039612,-73.90801059696038,3.4623082596419295,5.1232992342036,-0.043073388095215326,817969600.0,-1.0
MSFT,2021-02-24,234.5500030517578,235.1999969482422,229.0,230.00999450683597,26339700.0,1.2799987792969034,0.0,1.2799987792969034,34.98883153496368,228.72999572753903,246.1300048828125,33.448300355950636,-66.55169964404935,2.820762241304152,4.66279183562371,-0.03405816663788597,844309300.0,1.0
MSFT,2021-02-25,228.9900054931641,234.58999633789065,227.8800048828125,232.0800018310547,39542200.0,-5.559997558593722,5.559997558593722,0.0,24.578669167852652,227.8800048828125,246.1300048828125,6.082195125214197,-93.9178048747858,1.8424484646109534,4.098723161421159,-0.06339727453780675,804767100.0,-1.0
MSFT,2021-02-26,232.3800048828125,235.3699951171875,229.5399932861328,231.52999877929688,37819200.0,3.389999389648409,0.0,3.389999389648409,37.63303055021586,227.8800048828125,246.1300048828125,24.65753424657534,-75.34246575342466,1.3253940499241708,3.544057339121761,-0.0514714899694283,842586300.0,1.0
MSFT,2021-03-01,236.94000244140625,237.47000122070312,233.1499938964844,235.8999938964844,25324000.0,4.55999755859375,0.0,4.55999755859375,50.83959340629078,227.8800048828125,246.1300048828125,49.64382223886986,-50.35617776113014,1.268950720527016,3.089036015402812,-0.02773900119609618,867910300.0,1.0
MSFT,2021-03-02,233.8699951171875,237.3000030517578,233.4499969482422,237.00999450683597,22812500.0,-3.07000732421875,3.07000732421875,0.0,43.65798732228056,227.8800048828125,246.1300048828125,32.82186429794521,-67.1781357020548,0.9653668928013701,2.6643021908825237,-0.04230140032820773,845097800.0,-1.0
MSFT,2021-03-03,227.55999755859372,233.5800018310547,227.25999450683597,232.16000366210935,34029500.0,-6.309997558593778,6.309997558593778,0.0,32.70237809192048,227.25999450683597,246.1300048828125,1.5898404175743879,-98.41015958242562,0.21315335487588527,2.174072423681196,-0.06657367477954756,811068300.0,-1.0
MSFT,2021-03-04,226.72999572753903,232.4900054931641,224.25999450683597,226.7400054931641,44727800.0,-0.8300018310546875,0.8300018310546875,0.0,31.502557259084,224.25999450683597,246.1300048828125,11.294010282758169,-88.70598971724183,-0.44482780642113084,1.6502923776607306,-0.05909451558711554,766340500.0,-1.0
MSFT,2021-03-05,231.6000061035156,233.2700042724609,226.4600067138672,229.5200042724609,41872800.0,4.8700103759765625,0.0,4.8700103759765625,45.13141771195102,224.25999450683597,246.1300048828125,33.56199412114768,-66.43800587885232,-0.5667799933712843,1.2068779034543278,-0.012408803340940522,808213300.0,1.0
MSFT,2021-03-08,227.38999938964844,233.3699951171875,227.1300048828125,231.3699951171875,35267400.0,-4.210006713867159,4.210006713867159,0.0,37.65765553618021,224.25999450683597,244.30999755859372,15.61099454564955,-84.38900545435045,-0.991708538707627,0.7671606150219368,-0.02520686232741942,772945900.0,-1.0
MSFT,2021-03-09,233.77999877929688,235.3800048828125,231.6699981689453,232.8800048828125,33080500.0,6.3899993896484375,0.0,6.3899993896484375,51.6733075254993,224.25999450683597,243.92999267578125,48.398602738514526,-51.601397261485474,-0.8035847008742678,0.4530115518426958,-0.003282900287539192,806026400.0,1.0
MSFT,2021-03-10,232.4199981689453,237.0,232.0399932861328,237.0,29746800.0,-1.3600006103515625,1.3600006103515625,0.0,48.96969902618654,224.25999450683597,243.8600006103516,41.632658780885265,-58.367341219114735,-0.7555266463973567,0.21130391219468525,0.014978787691603435,776279600.0,-1.0
MSFT,2021-03-11,237.1300048828125,239.1699981689453,234.30999755859372,234.9600067138672,29907600.0,4.7100067138671875,0.0,4.7100067138671875,57.794029477415286,224.25999450683597,239.1699981689453,86.31795583446416,-13.682044165535846,-0.33353730296843764,0.10233566916206065,0.02044065711417553,806187200.0,1.0
MSFT,2021-03-12,235.75,235.82000732421875,233.22999572753903,234.00999450683597,22653700.0,-1.3800048828125,1.3800048828125,0.0,54.60198406863052,224.25999450683597,239.1699981689453,77.06239215999308,-22.937607840006923,-0.10920373619040902,0.06002778809156671,-0.0050223787842684775,783533500.0,-1.0
MSFT,2021-03-15,234.80999755859372,235.19000244140625,231.80999755859372,234.9600067138672,26034900.0,-0.9400024414062784,0.9400024414062784,0.0,52.330361945730814,224.25999450683597,239.1699981689453,70.7578837057457,-29.242116294254306,-0.007185281913308472,0.04658517409059167,0.004019337499601816,757498600.0,-1.0
MSFT,2021-03-16,237.7100067138672,240.05999755859372,235.94000244140625,236.27999877929688,28092200.0,2.900009155273466,0.0,2.900009155273466,58.47942959444445,224.25999450683597,240.05999755859372,85.12664309602714,-14.873356903972857,0.3041653516931433,0.09810120961110201,0.0446036617339125,785590800.0,1.0
MSFT,2021-03-17,237.0399932861328,238.5500030517578,233.22999572753903,236.1499938964844,29562100.0,-0.670013427734375,0.670013427734375,0.0,56.53532618030526,224.25999450683597,240.05999755859372,80.88605260031939,-19.113947399680615,0.4911863968770547,0.17671824706429257,0.04547257863041332,756028700.0,-1.0
MSFT,2021-03-18,230.72000122070312,234.19000244140625,230.3300018310547,232.55999755859372,34833000.0,-6.3199920654296875,6.3199920654296875,0.0,41.514419756676205,224.25999450683597,240.05999755859372,40.88611054507664,-59.11388945492336,0.12795637982998187,0.16696587361743045,-0.0037996755596765297,721195700.0,-1.0
MSFT,2021-03-19,230.3500061035156,232.47000122070312,229.3500061035156,231.0200042724609,46430700.0,-0.3699951171875284,0.3699951171875284,0.0,40.78247685523836,224.25999450683597,240.05999755859372,38.54436974935973,-61.45563025064027,-0.18759901472239449,0.09605289594946545,0.013017312642650491,674765000.0,-1.0
MSFT,2021-03-22,235.9900054931641,236.8999938964844,230.13999938964844,230.2700042724609,30127000.0,5.639999389648494,0.0,5.639999389648494,54.79941748350445,224.25999450683597,240.05999755859372,74.2405615233293,-25.75943847667069,0.017223337013120954,0.08028698416219655,0.009453360960762103,704892000.0,1.0
MSFT,2021-03-23,237.5800018310547,241.0500030517578,237.07000732421875,237.4900054931641,31638400.0,1.5899963378905966,0.0,1.5899963378905966,58.03087108484093,224.25999450683597,241.0500030517578,79.33293951924384,-20.66706048075616,0.30433772686507155,0.1250971327027716,0.022201203436713612,736530400.0,1.0
MSFT,2021-03-24,235.4600067138672,238.0,235.32000732421875,237.8500061035156,25620100.0,-2.1199951171875,2.1199951171875,0.0,52.280686121522244,226.4600067138672,241.0500030517578,61.68610184381439,-38.313898156185616,0.3567002426004535,0.171417754682308,-0.007042542632977211,710910300.0,-1.0
MSFT,2021-03-25,232.33999633789065,236.94000244140625,231.57000732421875,235.3000030517578,34061900.0,-3.120010375976534,3.120010375976534,0.0,44.75073759776054,227.1300048828125,241.0500030517578,37.42810445694838,-62.57189554305162,0.1447703290192237,0.16608826954969116,-0.01446449061340127,676848400.0,-1.0
MSFT,2021-03-26,236.47999572753903,236.7100067138672,231.5500030517578,231.5500030517578,25479900.0,4.139999389648381,0.0,4.139999389648381,54.732917244467515,229.3500061035156,241.0500030517578,60.940098151860056,-39.059901848139944,0.3073349311700042,0.1943376018737538,0.007112125490008614,702328300.0,1.0
MSFT,2021-03-29,235.2400054931641,236.8000030517578,231.8800048828125,236.58999633789065,25227500.0,-1.2399902343749432,1.2399902343749432,0.0,51.5162298035431,229.3500061035156,241.0500030517578,50.341888256076814,-49.658111743923186,0.33228136793769636,0.22192635508654232,-0.01039081717614121,677100800.0,-1.0
MSFT,2021-03-30,231.8500061035156,233.8500061035156,231.1000061035156,233.52999877929688,24792000.0,-3.3899993896484943,3.3899993896484943,0.0,43.459258122197504,229.3500061035156,241.0500030517578,21.36752694089886,-78.63247305910114,0.07761231304385774,0.1930635466780054,-0.021894985359505736,652308800.0,-1.0
MSFT,2021-03-31,235.7700042724609,239.1000061035156,232.38999938964844,232.91000366210935,43623500.0,3.9199981689453125,0.0,3.9199981689453125,53.22073091275952,229.3500061035156,241.0500030517578,54.871793534184135,-45.12820646581587,0.18990721156021095,0.19243227965444654,0.0218880158852246,695932300.0,1.0
MSFT,2021-04-01,242.3500061035156,242.83999633789065,238.0500030517578,238.47000122070312,30338000.0,6.5800018310546875,0.0,6.5800018310546875,64.94310042396691,229.3500061035156,242.83999633789065,96.36774952492947,-3.6322504750705358,0.8006237913613745,0.3140705819958322,0.052094637213108586,726270300.0,1.0
MSFT,2021-04-05,249.07000732421875,249.9600067138672,242.6999969482422,242.75999450683597,36910600.0,6.720001220703153,0.0,6.720001220703153,72.93515958568281,229.3500061035156,249.9600067138672,95.6817109980995,-4.318289001900495,1.8060499977850384,0.6124664651536735,0.05542608384503622,763180900.0,1.0
MSFT,2021-04-06,247.8600006103516,249.3999938964844,246.8800048828125,247.6100006103516,22931900.0,-1.210006713867159,1.210006713867159,0.0,69.6368556471166,229.3500061035156,249.9600067138672,89.81074215756769,-10.18925784243231,2.476670564131979,0.9853072849493347,0.043269630019647565,740249000.0,-1.0
MSFT,2021-04-07,249.8999938964844,250.92999267578125,247.19000244140625,247.80999755859372,22719800.0,2.0399932861328125,0.0,2.0399932861328125,72.09197029375676,229.3500061035156,250.92999267578125,95.22706478130719,-4.772935218692809,3.1365958789446893,1.415565003748406,0.0613267084467759,762968800.0,1.0
MSFT,2021-04-08,253.25,254.13999938964844,252.0,252.7700042724609,23625200.0,3.3500061035155966,0.0,3.3500061035155966,75.79971838249395,229.3500061035156,254.13999938964844,96.40984416826652,-3.5901558317334845,3.885123653742852,1.9094767337472955,0.0899974347580692,786594000.0,1.0
MSFT,2021-04-09,255.8500061035156,255.9900054931641,252.44000244140625,252.8699951171875,24326800.0,2.6000061035155966,0.0,2.6000061035155966,78.37282357971348,230.13999938964844,255.9900054931641,99.45841641550153,-0.5415835844984739,4.634710019416673,2.454523390881171,0.08190972059342294,810920800.0,1.0
MSFT,2021-04-12,255.91000366210935,257.6700134277344,254.6199951171875,254.7100067138672,27148700.0,0.05999755859375,0.0,0.05999755859375,78.43387788584148,231.1000061035156,257.6700134277344,93.37595302798142,-6.624046972018578,5.173961706377128,2.998411053980363,0.08786769973760222,838069500.0,1.0
MSFT,2021-04-13,258.489990234375,259.19000244140625,256.8299865722656,257.260009765625,23837500.0,2.5799865722656534,0.0,2.5799865722656534,81.0835272697091,231.1000061035156,259.19000244140625,97.50796618621483,-2.4920338137851665,5.743300712390834,3.547388985662458,0.1149018047425252,861907000.0,1.0
MSFT,2021-04-14,255.58999633789065,258.8299865722656,255.16000366210935,257.4800109863281,23070900.0,-2.8999938964843466,2.8999938964843466,0.0,69.93896322092368,231.1000061035156,259.19000244140625,87.18402786454072,-12.815972135459274,5.892574771375905,4.016426142805147,0.08406494340359494,838836100.0,-1.0
MSFT,2021-04-15,259.5,259.92999267578125,257.7300109863281,257.92999267578125,25627500.0,3.9100036621093466,0.0,3.9100036621093466,75.23445530217543,231.1000061035156,259.92999267578125,98.50852280245283,-1.491477197547159,6.254284656483861,4.463997845540891,0.07076539494353917,864463600.0,1.0
MSFT,2021-04-16,260.739990234375,261.0,257.6000061035156,259.4700012207031,24878600.0,1.239990234375,0.0,1.239990234375,76.7341741463917,231.1000061035156,261.0,99.13040194414363,-0.8695980558563644,6.565318292782251,4.884261934989163,0.04685422799608796,889342200.0,1.0
MSFT,2021-04-19,258.739990234375,261.4800109863281,257.82000732421875,260.19000244140625,23209300.0,-2.0,2.0,0.0,68.96217809283795,231.1000061035156,261.4800109863281,90.98084163408647,-9.01915836591353,6.574643013043044,5.222338150599939,0.0438957056291116,866132900.0,-1.0
MSFT,2021-04-20,258.260009765625,260.20001220703125,256.8399963378906,257.82000732421875,19722900.0,-0.47998046875,0.47998046875,0.0,67.08076892148944,232.38999938964844,261.4800109863281,88.93090430713113,-11.069095692868865,6.468734958611833,5.471617512202319,0.03345344567156561,846410000.0,-1.0
MSFT,2021-04-21,260.5799865722656,260.67999267578125,257.25,258.94000244140625,24030400.0,2.319976806640625,0.0,2.319976806640625,71.42807112900866,238.0500030517578,261.4800109863281,96.15866790751471,-3.841332092485293,6.497110160270523,5.67671604181596,0.02894367846896584,870440400.0,1.0
MSFT,2021-04-22,257.1700134277344,261.7799987792969,255.63999938964844,260.2099914550781,25606200.0,-3.40997314453125,3.40997314453125,0.0,58.3578077177363,242.6999969482422,261.7799987792969,75.83865351595895,-24.16134648404105,6.173279652490038,5.776028763950777,0.005159301515454073,844834200.0,-1.0
MSFT,2021-04-23,261.1499938964844,261.510009765625,257.2699890136719,257.8800048828125,21462600.0,3.97998046875,0.0,3.97998046875,66.59082547150658,246.8800048828125,261.7799987792969,95.77177757796834,-4.228222422031652,6.166706845864411,5.854164380333504,0.02047591012226957,866296800.0,1.0
MSFT,2021-04-26,261.54998779296875,262.44000244140625,260.1700134277344,261.6600036621094,19763300.0,0.399993896484375,0.0,0.399993896484375,67.33962736276229,247.19000244140625,262.44000244140625,94.16383837090164,-5.836161629098361,6.123189694570783,5.907969443180961,0.011837973129323887,886060100.0,1.0
MSFT,2021-04-27,261.9700012207031,263.19000244140625,260.1199951171875,261.5799865722656,31014200.0,0.420013427734375,0.0,0.420013427734375,68.20309052683594,252.0,263.19000244140625,89.09739987018442,-10.902600129815585,6.052820465489361,5.9369396476426415,0.024961872429381415,917074300.0,1.0
MSFT,2021-04-28,254.55999755859372,256.5400085449219,252.9499969482422,256.0799865722656,46903100.0,-7.410003662109403,7.410003662109403,0.0,44.34018454067104,252.44000244140625,263.19000244140625,19.720884811046247,-80.27911518895375,5.33759846435828,5.81707141098577,-0.019036618271315087,870171200.0,-1.0
MSFT,2021-04-29,252.50999450683597,256.1000061035156,249.0,255.4600067138672,40589000.0,-2.0500030517577557,2.0500030517577557,0.0,39.88548751364518,249.0,263.19000244140625,24.73568641957274,-75.26431358042726,4.552879006759042,5.564232930140425,-0.03156399492130546,829582200.0,-1.0
MSFT,2021-04-30,252.17999267578125,253.0800018310547,249.6000061035156,249.7400054931641,30945100.0,-0.3300018310547159,0.3300018310547159,0.0,39.15482684104756,249.0,263.19000244140625,22.410092520506346,-77.58990747949366,3.8598607214703975,5.2233584884064195,-0.02535362837670163,798637100.0,-1.0
MSFT,2021-05-03,251.8600006103516,254.3500061035156,251.1199951171875,253.3999938964844,19626600.0,-0.3199920654296591,0.3199920654296591,0.0,38.36842314605728,249.0,263.19000244140625,20.15503959327128,-79.84496040672872,3.2473842281022485,4.828163636345586,-0.024781262732397114,779010500.0,-1.0
MSFT,2021-05-04,247.7899932861328,251.2100067138672,245.75999450683597,250.97000122070312,32756100.0,-4.070007324218778,4.070007324218778,0.0,29.633686620391273,245.75999450683597,263.19000244140625,11.646574040110405,-88.35342595988959,2.4058435509905394,4.3436996192745765,-0.04908279202242505,746254400.0,-1.0
MSFT,2021-05-05,246.47000122070312,249.5,245.82000732421875,249.05999755859372,21901300.0,-1.3199920654296875,1.3199920654296875,0.0,27.307315967884534,245.75999450683597,263.19000244140625,4.07347326824188,-95.92652673175812,1.6138012767981422,3.7977199507792894,-0.04160676458508639,724353100.0,-1.0
MSFT,2021-05-06,249.72999572753903,249.8600006103516,244.69000244140625,246.4499969482422,26491100.0,3.259994506835909,0.0,3.259994506835909,40.59650998561197,244.69000244140625,263.19000244140625,27.243206952069105,-72.7567930479309,1.2349209795927436,3.28516015654198,-0.043729651295615346,750844200.0,1.0
MSFT,2021-05-07,252.4600067138672,254.3000030517578,251.1699981689453,252.1499938964844,27032900.0,2.7300109863281534,0.0,2.7300109863281534,49.514553240419524,244.69000244140625,263.19000244140625,42.00002309438345,-57.999976905616556,1.1417829225187575,2.856484709737336,-0.034754278353462564,777877100.0,1.0
MSFT,2021-05-10,247.17999267578125,251.72999572753903,247.1199951171875,250.8699951171875,29299900.0,-5.2800140380859375,5.2800140380859375,0.0,37.08888015494439,244.69000244140625,263.19000244140625,13.459406672297296,-86.5405933277027,0.6346020380422033,2.4121081753983096,-0.05645687855863191,748577200.0,-1.0
MSFT,2021-05-11,246.22999572753903,246.6000061035156,242.57000732421875,244.5500030517578,33641600.0,-0.9499969482422159,0.9499969482422159,0.0,35.25230133343349,242.57000732421875,263.19000244140625,17.74970548014123,-82.25029451985877,0.15422293281741872,1.9605311268821315,-0.0327231376137066,714935600.0,-1.0
MSFT,2021-05-12,239.0,244.3800048828125,238.07000732421875,242.1699981689453,36684400.0,-7.229995727539034,7.229995727539034,0.0,24.568801285935308,238.07000732421875,263.19000244140625,3.7022008620731546,-96.29779913792684,-0.800651785241115,1.4082945444574821,-0.053502810980696536,678251200.0,-1.0
MSFT,2021-05-13,243.02999877929688,245.6000061035156,241.4199981689453,241.8000030517578,29624300.0,4.029998779296875,0.0,4.029998779296875,36.873063484090466,238.07000732421875,263.19000244140625,19.745192751587837,-80.25480724841216,-1.2181673821218624,0.8830021591416132,-0.036283583798212726,707875500.0,1.0
MSFT,2021-05-14,248.1499938964844,249.17999267578125,245.4900054931641,245.5800018310547,23901100.0,5.119995117187528,0.0,5.119995117187528,49.05505300301735,238.07000732421875,263.19000244140625,40.12734288060735,-59.87265711939265,-1.1229658332125894,0.48180856067077255,-0.014730432402431659,731776600.0,1.0
MSFT,2021-05-17,245.17999267578125,246.58999633789065,243.5200042724609,246.5500030517578,24970200.0,-2.9700012207031534,2.9700012207031534,0.0,43.44372619399288,238.07000732421875,256.5400085449219,38.49477467057706,-61.50522532942294,-1.272503567960655,0.13094613494448698,-0.010533115464988474,706806400.0,-1.0
MSFT,2021-05-18,243.0800018310547,246.41000366210935,242.8999938964844,246.2700042724609,20168000.0,-2.0999908447265625,2.0999908447265625,0.0,39.735476890831265,238.07000732421875,256.1000061035156,27.7869930451061,-72.2130069548939,-1.5426819338754285,-0.20377947881949623,-0.013754206892760301,686638400.0,-1.0
MSFT,2021-05-19,243.1199951171875,243.22999572753903,238.6000061035156,239.30999755859372,25739800.0,0.0399932861328125,0.0,0.0399932861328125,39.848302409856295,238.07000732421875,254.3500061035156,31.019583363794734,-68.98041663620526,-1.7335893722780895,-0.509741457511215,-0.026468588969837614,712378200.0,1.0
MSFT,2021-05-20,246.47999572753903,247.9499969482422,243.8600006103516,243.9600067138672,21800700.0,3.360000610351534,0.0,3.360000610351534,49.08814746660567,238.07000732421875,254.3500061035156,51.65840929923904,-48.34159070076096,-1.5953704861868516,-0.7268672632463424,-0.02368696358748723,734178900.0,1.0
MSFT,2021-05-21,245.1699981689453,248.3300018310547,244.7400054931641,247.57000732421875,21863100.0,-1.3099975585937216,1.3099975585937216,0.0,45.91527219370735,238.07000732421875,254.3000030517578,43.74610421294995,-56.253895787050055,-1.5733997056190674,-0.8961737517208875,-0.008131703885404629,712315800.0,-1.0
MSFT,2021-05-24,250.77999877929688,251.16000366210935,247.50999450683597,247.7899932861328,21411500.0,5.6100006103515625,0.0,5.6100006103515625,59.007672241726674,238.07000732421875,254.3000030517578,78.31173629646622,-21.688263703533778,-1.0907342339148158,-0.9350858481596732,0.01847867087969468,733727300.0,1.0
MSFT,2021-05-25,251.72000122070312,252.75,250.82000732421875,251.7700042724609,17704300.0,0.94000244140625,0.0,0.94000244140625,60.84039551637711,238.07000732421875,254.3000030517578,84.10349654820341,-15.896503451796598,-0.6251615558132357,-0.8731009896903857,0.05322176242972021,751431600.0,1.0
MSFT,2021-05-26,251.4900054931641,252.94000244140625,250.75,251.42999267578125,17771600.0,-0.22999572753903408,0.22999572753903408,0.0,60.08203167404812,238.07000732421875,254.3000030517578,82.68639372574992,-17.31360627425007,-0.2716195263827217,-0.7528046970288529,0.03481054502061709,733660000.0,-1.0
MSFT,2021-05-27,249.30999755859372,251.47999572753903,249.25,251.1699981689453,24426200.0,-2.1800079345703693,2.1800079345703693,0.0,52.87403969214193,238.07000732421875,252.94000244140625,75.58839223412532,-24.411607765874674,-0.16543629552509742,-0.6353310167281019,0.004674606853277696,709233800.0,-1.0
MSFT,2021-05-28,249.67999267578125,252.0800018310547,249.55999755859372,251.0,18270200.0,0.3699951171875284,0.0,0.3699951171875284,53.955798538865906,238.07000732421875,252.94000244140625,78.07659155276444,-21.923408447235563,-0.050843711624281696,-0.5184335557073378,0.01835386301667219,727504000.0,1.0
MSFT,2021-06-01,247.3999938964844,251.2899932861328,246.9600067138672,251.22999572753903,23213300.0,-2.2799987792968466,2.2799987792968466,0.0,46.385110265391006,238.07000732421875,252.94000244140625,62.74370972376163,-37.25629027623837,-0.14236402615711086,-0.44321964979729245,0.01777189416195668,704290700.0,-1.0
MSFT,2021-06-02,247.3000030517578,249.2700042724609,245.83999633789065,248.1300048828125,19406700.0,-0.09999084472659092,0.09999084472659092,0.0,46.058088484525506,238.6000061035156,252.94000244140625,60.66945027910617,-39.33054972089383,-0.22042207186717633,-0.3986601342112692,0.01719318862504693,684884000.0,-1.0
MSFT,2021-06-03,245.7100067138672,246.33999633789065,243.0,245.22000122070312,25307700.0,-1.589996337890625,1.589996337890625,0.0,40.782663354570914,238.6000061035156,252.94000244140625,49.58160687645921,-50.418393123540795,-0.405904042646938,-0.40010891589840303,-0.0031239412001734523,659576300.0,-1.0
MSFT,2021-06-04,250.7899932861328,251.6499938964844,247.50999450683597,247.75999450683597,25281100.0,5.079986572265625,0.0,5.079986572265625,58.3635164404612,238.6000061035156,252.94000244140625,85.00690582749692,-14.99309417250307,-0.14135789384502573,-0.3483587114877276,0.022922850100585368,684857400.0,1.0
MSFT,2021-06-07,253.80999755859372,254.08999633789065,249.80999755859372,249.97999572753903,23079200.0,3.020004272460909,0.0,3.020004272460909,65.40814131524314,238.6000061035156,254.08999633789065,98.19238892303777,-1.807611076962234,0.30843054525678326,-0.21700086013882544,0.012082298405158953,707936600.0,1.0
MSFT,2021-06-08,252.57000732421875,256.010009765625,252.50999450683597,255.16000366210935,22455000.0,-1.2399902343749716,1.2399902343749716,0.0,60.5542807900287,238.6000061035156,256.010009765625,80.2412307994342,-19.758769200565794,0.5583974170787087,-0.06192120469531857,0.00337679206814534,685481600.0,-1.0
MSFT,2021-06-09,253.58999633789065,255.52999877929688,253.2100067138672,253.80999755859372,17937600.0,1.0199890136719034,0.0,1.0199890136719034,63.14977890886926,243.0,256.010009765625,81.39883465630827,-18.601165343691726,0.8292435494590791,0.11631174613556103,0.008350196027108625,703419200.0,1.0
MSFT,2021-06-10,257.239990234375,257.4599914550781,253.6699981689453,254.2899932861328,24563600.0,3.6499938964843466,0.0,3.6499938964843466,71.02252051505937,243.0,257.4599914550781,98.4785522080937,-1.5214477919062945,1.3231624705652223,0.3576818910214934,0.03180776043254152,727982800.0,1.0
MSFT,2021-06-11,257.8900146484375,258.489990234375,256.6099853515625,257.989990234375,18999700.0,0.6500244140625,0.0,0.6500244140625,72.24115302417329,243.0,258.489990234375,96.12668841710405,-3.87331158289596,1.74691100907134,0.6355277146314628,0.03288217804186355,746982500.0,1.0
MSFT,2021-06-14,259.8900146484375,259.95001220703125,256.79998779296875,257.8999938964844,19150500.0,2.0,0.0,2.0,75.84717465321134,243.0,259.95001220703125,99.64603235761174,-0.35396764238825534,2.2185440690510063,0.9521309855153717,0.050485129588075495,766133000.0,1.0
MSFT,2021-06-15,258.3599853515625,259.989990234375,257.67999267578125,259.7699890136719,18038900.0,-1.530029296875,1.530029296875,0.0,68.04459524249339,243.0,259.989990234375,90.40608699400785,-9.593913005992153,2.4407209776143475,1.2498489839351672,0.04472293636603775,748094100.0,-1.0
MSFT,2021-06-16,257.3800048828125,260.5799865722656,254.4199981689453,259.3999938964844,27220000.0,-0.97998046875,0.97998046875,0.0,63.23692045749904,243.0,260.5799865722656,81.79758740827793,-18.202412591722055,2.50880164091771,1.501639515331676,0.0474950056980592,720874100.0,-1.0
MSFT,2021-06-17,260.8999938964844,261.75,256.010009765625,256.07000732421875,27565500.0,3.519989013671875,0.0,3.519989013671875,71.56383736690971,243.0,261.75,95.46663411458334,-4.533365885416667,2.8143477042439713,1.7641811531141354,0.040312615658539386,748439600.0,1.0
MSFT,2021-06-18,259.42999267578125,262.29998779296875,258.75,259.6300048828125,37202200.0,-1.470001220703125,1.470001220703125,0.0,64.52172996275647,243.0,262.29998779296875,85.12954957291176,-14.870450427088242,2.904398252443599,1.992224572980028,0.02214252854988552,711237400.0,-1.0
MSFT,2021-06-21,262.6300048828125,263.5199890136719,257.9200134277344,259.82000732421875,26696100.0,3.20001220703125,0.0,3.20001220703125,71.55291647974602,243.0,263.5199890136719,95.66284304408543,-4.337156955914569,3.1971237497141374,2.23320440832685,0.03983053120666047,737933500.0,1.0
MSFT,2021-06-22,265.510009765625,265.7900085449219,262.3999938964844,262.7200012207031,24694100.0,2.8800048828125,0.0,2.8800048828125,76.40822004583953,243.0,265.7900085449219,98.77139677791273,-1.2286032220872731,3.6197766086009153,2.510518848381663,0.047005061713285334,762627600.0,1.0
MSFT,2021-06-23,265.2699890136719,266.8299865722656,264.42999267578125,265.989990234375,19518700.0,-0.240020751953125,0.240020751953125,0.0,75.17439926296773,247.50999450683597,266.8299865722656,91.9254751590445,-8.074524840955503,3.8905169183011594,2.7865184623655623,0.03121598151197502,743108900.0,-1.0
MSFT,2021-06-24,266.69000244140625,267.8500061035156,265.4700012207031,266.1600036621094,21446900.0,1.420013427734375,0.0,1.420013427734375,77.63924644990112,249.80999755859372,267.8500061035156,93.56982753516542,-6.430172464834588,4.171576443859294,3.063530058664309,0.034123026457480776,764555800.0,1.0
MSFT,2021-06-25,265.0199890136719,267.25,264.760009765625,266.2300109863281,25611100.0,-1.670013427734375,1.670013427734375,0.0,68.42087365714224,252.50999450683597,267.8500061035156,81.55140188775147,-18.448598112248536,4.211019998778113,3.2930280466870703,0.01973902064753763,738944700.0,-1.0
MSFT,2021-06-28,268.7200012207031,268.8999938964844,265.9100036621094,266.19000244140625,19590000.0,3.70001220703125,0.0,3.70001220703125,75.77417847785249,253.2100067138672,268.8999938964844,98.85281821019801,-1.1471817898019856,4.489091905913199,3.532240818532297,0.0400991502420287,758534700.0,1.0
MSFT,2021-06-29,271.3999938964844,271.6499938964844,267.9800109863281,268.8699951171875,19937800.0,2.67999267578125,0.0,2.67999267578125,79.72069467529398,253.6699981689453,271.6499938964844,98.60956585425052,-1.3904341457494758,4.869585358221855,3.799709726470209,0.054471943226729325,778472500.0,1.0
MSFT,2021-06-30,270.8999938964844,271.3599853515625,269.6000061035156,270.69000244140625,21656500.0,-0.5,0.5,0.0,77.0197133699448,254.4199981689453,271.6499938964844,95.64712602452211,-4.352873975477889,5.0723128737545835,4.054230355927084,0.03832886252947798,756816000.0,-1.0
MSFT,2021-07-01,271.6000061035156,271.8399963378906,269.6000061035156,269.6099853515625,16725300.0,0.70001220703125,0.0,0.70001220703125,78.21218407095844,254.4199981689453,271.8399963378906,98.6223291641739,-1.377670835826099,5.229182267125964,4.28922073816686,0.04691058771660095,773541300.0,1.0
MSFT,2021-07-02,277.6499938964844,278.0,272.5,272.82000732421875,26458000.0,6.04998779296875,0.0,6.04998779296875,85.64205594371866,254.4199981689453,278.0,98.51566549475552,-1.4843345052444803,5.775113926133713,4.586399375760231,0.05719068169828456,799999300.0,1.0
MSFT,2021-07-06,277.6600036621094,279.3699951171875,274.29998779296875,278.0299987792969,31565600.0,0.010009765625,0.0,0.010009765625,85.65139696936757,254.4199981689453,279.3699951171875,93.14632599504746,-6.853674004952532,6.137823396105546,4.896684179829294,0.045760963615682826,831564900.0,1.0
MSFT,2021-07-07,279.92999267578125,280.69000244140625,277.1499938964844,279.3999938964844,23260000.0,2.269989013671875,0.0,2.269989013671875,87.73870441877273,256.010009765625,280.69000244140625,96.9205429855301,-3.0794570144698867,6.533132521577443,5.223973848178924,0.05526446363804016,854824900.0,1.0
MSFT,2021-07-08,277.4200134277344,278.7300109863281,274.8699951171875,276.8999938964844,24618600.0,-2.509979248046875,2.509979248046875,0.0,74.00381429545527,257.9200134277344,280.69000244140625,85.63904000257328,-14.360959997426711,6.568169730902639,5.4928130247236675,0.04023402035359602,830206300.0,-1.0
MSFT,2021-07-09,277.94000244140625,278.04998779296875,275.32000732421875,275.7200012207031,23916700.0,0.519989013671875,0.0,0.519989013671875,74.94150768337809,257.9200134277344,280.69000244140625,87.9226994868166,-12.077300513183413,6.562250203904455,5.7067004605598255,0.04875109034536962,854123000.0,1.0
MSFT,2021-07-12,277.32000732421875,279.7699890136719,276.5799865722656,279.1600036621094,18931700.0,-0.6199951171875,0.6199951171875,0.0,71.3984205295322,262.3999938964844,280.69000244140625,81.57466625064447,-18.425333749355527,6.433370619797984,5.852034492407458,0.032003595059722834,835191300.0,-1.0
MSFT,2021-07-13,280.9800109863281,282.8500061035156,277.3900146484375,277.5199890136719,26120100.0,3.660003662109375,0.0,3.660003662109375,78.3654595314908,264.42999267578125,282.8500061035156,89.84802522254456,-10.151974777455445,6.551047925868033,5.991837179099574,0.03529851623171987,861311400.0,1.0
MSFT,2021-07-14,282.510009765625,283.6600036621094,280.54998779296875,282.3500061035156,23113700.0,1.529998779296875,0.0,1.529998779296875,80.64012832853459,264.760009765625,283.6600036621094,93.91537424412456,-6.084625755875443,6.690640613292771,6.131597865938214,0.04285720240206814,884425100.0,1.0
MSFT,2021-07-15,281.0299987792969,282.510009765625,279.8299865722656,282.0,22604200.0,-1.480010986328125,1.480010986328125,0.0,72.17071610348194,264.760009765625,283.6600036621094,86.08462575587545,-13.915374244124557,6.60569793229979,6.22641787921053,0.03472014898330733,861820900.0,-1.0
MSFT,2021-07-16,280.75,284.1000061035156,279.4599914550781,282.07000732421875,26186800.0,-0.279998779296875,0.279998779296875,0.0,70.55316624772851,265.9100036621094,284.1000061035156,81.58325643821827,-18.41674356178173,6.441532704884992,6.269440844345423,0.011165158190752145,835634100.0,-1.0
MSFT,2021-07-19,277.010009765625,280.3699951171875,274.45001220703125,278.92999267578125,32935600.0,-3.739990234375,3.739990234375,0.0,52.439156564708824,267.9800109863281,284.1000061035156,56.017379122335385,-43.98262087766461,5.941158645280723,6.203784404532484,-0.0023409705680021986,802698500.0,-1.0
MSFT,2021-07-20,279.32000732421875,280.9700012207031,276.260009765625,278.0299987792969,26259700.0,2.30999755859375,0.0,2.30999755859375,59.795495926611636,269.6000061035156,284.1000061035156,67.03449117726294,-32.965508822737064,5.665695484791627,6.096166620584313,-0.002179063935706882,828958200.0,1.0
MSFT,2021-07-21,281.3999938964844,281.5199890136719,277.2900085449219,278.8999938964844,24364300.0,2.079986572265625,0.0,2.079986572265625,65.36177254558997,269.6000061035156,284.1000061035156,81.37922615840517,-18.62077384159483,5.551235293765274,5.987180355220506,0.01434640716642721,853322500.0,1.0
MSFT,2021-07-22,286.1400146484375,286.4200134277344,283.4200134277344,283.8399963378906,23384100.0,4.740020751953125,0.0,4.740020751953125,74.60628380288836,272.5,286.4200134277344,97.98851645689506,-2.011483543104941,5.776417878800487,5.945027859936503,0.02950281404260946,876706600.0,1.0
MSFT,2021-07-23,289.6700134277344,289.989990234375,286.5,287.3699951171875,22768100.0,3.529998779296875,0.0,3.529998779296875,79.34353590614437,274.29998779296875,289.989990234375,97.9606325248478,-2.039367475152199,6.168610201278511,5.989744328204905,0.04453341186118265,899474700.0,1.0
MSFT,2021-07-26,289.04998779296875,289.69000244140625,286.6400146484375,289.0,23176100.0,-0.620025634765625,0.620025634765625,0.0,76.45300387313266,274.45001220703125,289.989990234375,93.95106968779334,-6.048930312206656,6.356125101856605,6.063020482935245,0.028720821735014113,876298600.0,-1.0
MSFT,2021-07-27,286.5400085449219,289.5799865722656,282.95001220703125,289.42999267578125,33604100.0,-2.509979248046875,2.509979248046875,0.0,65.33513777571383,274.45001220703125,289.989990234375,77.7993142372362,-22.20068576276379,6.230377746603779,6.096491935668952,0.01426497695653417,842694500.0,-1.0
MSFT,2021-07-28,286.2200012207031,290.1499938964844,283.8299865722656,288.989990234375,33566900.0,-0.32000732421875,0.32000732421875,0.0,63.96672013933464,274.45001220703125,290.1499938964844,74.96817032327289,-25.031829676727114,6.035328633330096,6.084259275201182,0.018467788008219577,809127600.0,-1.0
MSFT,2021-07-29,286.5,288.6199951171875,286.0799865722656,286.239990234375,18168300.0,0.279998779296875,0.0,0.279998779296875,64.71288052079727,274.45001220703125,290.1499938964844,76.75160411851719,-23.248395881482807,5.836069787565748,6.034621377674096,0.02048085485307216,827295900.0,1.0
MSFT,2021-07-30,284.9100036621094,286.6600036621094,283.9100036621094,285.1700134277344,20944800.0,-1.589996337890625,1.589996337890625,0.0,56.981607960554676,274.45001220703125,290.1499938964844,66.62422709769719,-33.37577290230281,5.486610074755504,5.925019117090378,0.028518802996211123,806351100.0,-1.0
MSFT,2021-08-02,284.82000732421875,286.7699890136719,283.739990234375,286.3599853515625,16267400.0,-0.089996337890625,0.089996337890625,0.0,56.54044797082276,274.45001220703125,290.1499938964844,66.05100134705135,-33.94899865294864,5.143112186485496,5.768637730969402,0.019690676842980093,790083700.0,-1.0
MSFT,2021-08-03,287.1199951171875,287.2300109863281,284.0,285.4200134277344,17879000.0,2.29998779296875,0.0,2.29998779296875,64.61819127672621,274.45001220703125,290.1499938964844,80.70062220943636,-19.299377790563643,4.998853753958201,5.614680935567162,0.02032694152369907,807962700.0,1.0
MSFT,2021-08-04,286.510009765625,287.5899963378906,284.6499938964844,286.2200012207031,16191300.0,-0.6099853515625,0.6099853515625,0.0,61.14061710214062,274.45001220703125,290.1499938964844,76.81536066182402,-23.18463933817598,4.780203971039214,5.447785542661573,0.0012930561901385307,791771400.0,-1.0
MSFT,2021-08-05,289.5199890136719,289.6300048828125,286.1000061035156,286.8800048828125,13900200.0,3.009979248046875,0.0,3.009979248046875,70.2550049896281,274.45001220703125,290.1499938964844,95.98722536577401,-4.01277463422599,4.794534206818184,5.3171352754928956,-0.0005179148931822031,805671600.0,1.0
MSFT,2021-08-06,289.4599914550781,289.5,287.6199951171875,288.510009765625,16589300.0,-0.05999755859375,0.05999755859375,0.0,69.8780492468402,276.260009765625,290.1499938964844,95.0323741560419,-4.967625843958106,4.746336903032727,5.202975601000862,0.0014184524456823944,789082300.0,-1.0
MSFT,2021-08-09,288.3299865722656,291.54998779296875,287.8099975585937,289.75,16117600.0,-1.1300048828125,1.1300048828125,0.0,62.5809553885971,277.2900085449219,291.54998779296875,77.4193134176955,-22.580686582304487,4.564343333597208,5.075249147520132,0.006246869456148385,772964700.0,-1.0
MSFT,2021-08-10,286.44000244140625,289.25,285.20001220703125,288.79998779296875,18616600.0,-1.889984130859375,1.889984130859375,0.0,52.08448512929199,282.95001220703125,291.54998779296875,40.58139699933287,-59.418603000667126,4.2189725056963425,4.9039938191553745,0.0007686437697045356,754348100.0,-1.0
MSFT,2021-08-11,286.95001220703125,288.6600036621094,285.8599853515625,287.2099914550781,13955900.0,0.510009765625,0.0,0.510009765625,54.46262463397037,282.95001220703125,291.54998779296875,46.511759946629574,-53.488240053370426,3.940987906670557,4.711392636658411,0.001570723235711169,768304000.0,1.0
MSFT,2021-08-12,289.8099975585937,289.9700012207031,286.3399963378906,286.6300048828125,14561300.0,2.859985351562443,0.0,2.859985351562443,65.53175616702806,282.95001220703125,291.54998779296875,79.7674979773169,-20.232502022683093,3.9064291416705146,4.550399937660832,0.017198391890428377,782865300.0,1.0
MSFT,2021-08-13,292.8500061035156,292.8999938964844,289.29998779296875,289.4800109863281,18249000.0,3.040008544921932,0.0,3.040008544921932,73.44775472011015,282.95001220703125,292.8999938964844,99.49760919638942,-0.5023908036105889,4.0773432793233155,4.455788605993329,0.02819323984552846,801114300.0,1.0
MSFT,2021-08-16,294.6000061035156,294.82000732421875,290.0199890136719,293.19000244140625,22507600.0,1.75,0.0,1.75,76.96207304908663,283.739990234375,294.82000732421875,98.0144324785854,-1.9855675214146034,4.304386056352428,4.425508096065149,0.02605186372782975,823621900.0,1.0
MSFT,2021-08-17,293.0799865722656,293.42999267578125,291.0799865722656,292.3900146484375,20075300.0,-1.52001953125,1.52001953125,0.0,67.94883414968801,283.739990234375,294.82000732421875,84.29586581100064,-15.704134188999367,4.311960622114839,4.402798601275087,0.02293105505114834,803546600.0,-1.0
MSFT,2021-08-18,290.7300109863281,294.82000732421875,290.2699890136719,292.0400085449219,21813000.0,-2.3499755859375,2.3499755859375,0.0,56.20653754312657,283.739990234375,294.82000732421875,63.086732586002704,-36.9132674139973,4.081293518667337,4.338497584753537,0.004179407358982479,781733600.0,-1.0
MSFT,2021-08-19,296.7699890136719,297.4700012207031,288.6400146484375,288.69000244140625,29850500.0,6.03997802734375,0.0,6.03997802734375,71.04557873877476,283.739990234375,297.4700012207031,94.90159033573754,-5.098409664262456,4.335882570641445,4.337974581931119,0.025253913405605122,811584100.0,1.0
MSFT,2021-08-20,304.3599853515625,305.8399963378906,298.0599975585937,299.7200012207031,40817600.0,7.589996337890625,0.0,7.589996337890625,80.58449980691543,284.0,305.8399963378906,93.22339178344812,-6.776608216551877,5.091404953750384,4.4886606562949725,0.05559601680652526,852401700.0,1.0
MSFT,2021-08-23,304.6499938964844,305.3999938964844,301.8500061035156,303.25,22830200.0,0.290008544921875,0.0,0.290008544921875,80.86246315930985,284.6499938964844,305.8399963378906,94.38413258942845,-5.6158674105715525,5.648451320695585,4.720618789175095,0.0635734928776337,875231900.0,1.0
MSFT,2021-08-24,302.6199951171875,305.6499938964844,302.0,305.0199890136719,18175800.0,-2.029998779296875,2.029998779296875,0.0,72.4814119996149,285.20001220703125,305.8399963378906,84.39920689721453,-15.60079310278547,5.858576619290602,4.948210355198197,0.05460875498708995,857056100.0,-1.0
MSFT,2021-08-25,302.010009765625,304.5899963378906,300.4200134277344,304.29998779296875,20006100.0,-0.6099853515625,0.6099853515625,0.0,69.96711248058189,285.20001220703125,305.8399963378906,81.4438492394996,-18.556150760500405,5.907780496192913,5.14012438339714,0.0420965884883413,837050000.0,-1.0
MSFT,2021-08-26,299.0899963378906,302.42999267578125,298.95001220703125,300.989990234375,17666100.0,-2.920013427734375,2.920013427734375,0.0,58.716767165869875,285.20001220703125,305.8399963378906,67.2964864836892,-32.7035135163108,5.646069864246499,5.241313479567012,0.021307802985564228,819383900.0,-1.0
MSFT,2021-08-27,299.7200012207031,300.8699951171875,296.8299865722656,298.989990234375,22605700.0,0.6300048828125,0.0,0.6300048828125,60.30570521850767,285.20001220703125,305.8399963378906,70.3488380689337,-29.6511619310663,5.426940045091214,5.278438792671853,0.017379480689448723,841989600.0,1.0
MSFT,2021-08-30,303.5899963378906,304.2200012207031,301.0599975585937,301.1199951171875,16348100.0,3.8699951171875,0.0,3.8699951171875,68.81345855318011,285.8599853515625,305.8399963378906,88.73874493092309,-11.261255069076913,5.50212922695215,5.323176879527913,0.03586055086376061,858337700.0,1.0
MSFT,2021-08-31,301.8800048828125,304.5,301.5,304.4200134277344,26285300.0,-1.709991455078125,1.709991455078125,0.0,62.034661302614154,286.3399963378906,305.8399963378906,79.69235151241986,-20.307648487580128,5.361926227982792,5.330926749218889,0.03835171284401295,832052400.0,-1.0
MSFT,2021-09-01,301.8299865722656,305.19000244140625,301.489990234375,302.8699951171875,18983800.0,-0.050018310546875,0.050018310546875,0.0,61.829093486113905,288.6400146484375,305.8399963378906,76.68596491539348,-23.314035084606527,5.1869859364619515,5.302138586667502,0.017050233331917575,813068600.0,-1.0
MSFT,2021-09-02,301.1499938964844,303.3599853515625,300.17999267578125,302.20001220703125,16285600.0,-0.67999267578125,0.67999267578125,0.0,58.77396940682178,288.6400146484375,305.8399963378906,72.73251491725647,-27.26748508274353,4.936569073681426,5.229024684070287,-0.010546693420852571,796783000.0,-1.0
MSFT,2021-09-03,301.1400146484375,302.6000061035156,300.260009765625,300.989990234375,14747900.0,-0.009979248046875,0.009979248046875,0.0,58.72483346810259,288.6400146484375,305.8399963378906,72.67449597149798,-27.325504028502028,4.683320263126802,5.119883799881591,-0.011521350134146124,782035100.0,-1.0
MSFT,2021-09-07,300.17999267578125,301.0899963378906,298.20001220703125,301.010009765625,17180400.0,-0.96002197265625,0.96002197265625,0.0,53.73797761287621,288.6400146484375,305.8399963378906,67.09296693274948,-32.907033067250524,4.354951832387769,4.966897406382827,-0.008062925387535502,764854700.0,-1.0
MSFT,2021-09-08,300.2099914550781,300.6099853515625,297.4700012207031,299.7799987792969,15046800.0,0.029998779296875,0.0,0.029998779296875,53.879189827918935,288.6400146484375,305.8399963378906,67.26737862596232,-32.73262137403768,4.050447103149963,4.783607345736255,-0.005960127983651198,779901500.0,1.0
MSFT,2021-09-09,297.25,302.1400146484375,297.0,300.82000732421875,19927000.0,-2.959991455078125,2.959991455078125,0.0,39.98390059232232,296.8299865722656,305.8399963378906,4.661631215282482,-95.33836878471752,3.529591406012628,4.53280415779153,-0.006151982214115725,759974500.0,-1.0
MSFT,2021-09-10,295.7099914550781,299.9200134277344,295.3800048828125,298.4200134277344,19633400.0,-1.540008544921875,1.540008544921875,0.0,34.62349107050481,295.3800048828125,305.6499938964844,3.213115143807183,-96.78688485619281,2.958440632238819,4.217931452680988,-0.013379186404954613,740341100.0,-1.0
MSFT,2021-09-13,296.989990234375,298.5400085449219,294.0799865722656,297.54998779296875,23652900.0,1.279998779296875,0.0,1.279998779296875,42.071488404626876,294.0799865722656,305.6499938964844,25.151268971265488,-74.8487310287345,2.579351573844349,3.89021547691366,-0.021739866870217672,763994000.0,1.0
MSFT,2021-09-14,299.7900085449219,301.3900146484375,298.1000061035156,299.5599975585937,21853400.0,2.800018310546875,0.0,2.800018310546875,55.008812677126336,294.0799865722656,305.19000244140625,51.3952638764136,-48.6047361235864,2.476313440914055,3.607435069713739,-0.006923268530825477,785847400.0,1.0
MSFT,2021-09-15,304.82000732421875,305.32000732421875,301.82000732421875,303.260009765625,28356300.0,5.029998779296875,0.0,5.029998779296875,69.24565086998456,294.0799865722656,305.32000732421875,95.55160963636907,-4.448390363630934,2.7686189266713654,3.4396718411052642,0.009906307805626957,814203700.0,1.0
MSFT,2021-09-16,305.2200012207031,305.3099975585937,300.760009765625,303.760009765625,19550800.0,0.399993896484375,0.0,0.399993896484375,70.11340351528148,294.0799865722656,305.32000732421875,99.11026762563363,-0.8897323743663678,2.997990328318508,3.3513355385479127,0.013514884299209884,833754500.0,1.0
MSFT,2021-09-17,299.8699951171875,304.5,299.5299987792969,304.1700134277344,41372500.0,-5.350006103515625,5.350006103515625,0.0,48.84420000714007,294.0799865722656,305.32000732421875,51.51243643314246,-48.48756356685754,2.7167510213135415,3.224418635101038,-0.004217372217148463,792382000.0,-1.0
MSFT,2021-09-20,294.29998779296875,298.7200012207031,289.5199890136719,296.3299865722656,38278700.0,-5.57000732421875,5.57000732421875,0.0,35.79856572331076,289.5199890136719,305.32000732421875,30.253121770790077,-69.74687822920991,2.021115640715948,2.98375803622402,-0.01958826379599321,754103300.0,-1.0
MSFT,2021-09-21,294.79998779296875,297.5400085449219,294.07000732421875,295.69000244140625,22364100.0,0.5,0.0,0.5,37.526821223983404,289.5199890136719,305.32000732421875,33.41767506542922,-66.58232493457078,1.492955548900511,2.6855975387593185,-0.018020731541571244,776467400.0,1.0
MSFT,2021-09-22,298.5799865722656,300.2200012207031,294.510009765625,296.7300109863281,26626300.0,3.779998779296875,0.0,3.779998779296875,49.40700522249032,289.5199890136719,305.32000732421875,57.341690246941,-42.658309753059,1.3636795328762332,2.4212139375827015,0.004474303018555448,803093700.0,1.0
MSFT,2021-09-23,299.5599975585937,300.8999938964844,297.5299987792969,298.8500061035156,18604600.0,0.9800109863280682,0.0,0.9800109863280682,52.130197992179625,289.5199890136719,305.32000732421875,63.5442842380751,-36.45571576192489,1.3250319120187442,2.2019775324699102,0.013019533376505521,821698300.0,1.0
MSFT,2021-09-24,299.3500061035156,299.79998779296875,296.92999267578125,298.2300109863281,14999000.0,-0.20999145507806816,0.20999145507806816,0.0,51.44557013314584,289.5199890136719,305.32000732421875,62.21522593604837,-37.78477406395164,1.2629009031124951,2.014162206598427,0.007946449196076122,806699300.0,-1.0
MSFT,2021-09-27,294.1700134277344,296.4700012207031,292.94000244140625,296.1400146484375,23571700.0,-5.17999267578125,5.17999267578125,0.0,37.447610572675565,289.5199890136719,305.32000732421875,29.43050015934793,-70.56949984065207,0.7866119401964511,1.7686521533180317,-0.01874643903065698,783127600.0,-1.0
MSFT,2021-09-28,283.5199890136719,290.7799987792969,282.75,289.79998779296875,43186200.0,-10.6500244140625,10.6500244140625,0.0,22.757795985469727,282.75,305.32000732421875,3.411558545865593,-96.58844145413441,-0.4450877639529267,1.32590416986384,-0.06987736302982017,739941400.0,-1.0
MSFT,2021-09-29,284.0,286.7699890136719,283.010009765625,285.1000061035156,26353700.0,0.480010986328125,0.0,0.480010986328125,24.30207112660429,282.75,305.32000732421875,5.538323413208144,-94.46167658679185,-1.3667309547452078,0.7873771449420305,-0.06952362602658879,766295100.0,1.0
MSFT,2021-09-30,281.9200134277344,287.8299865722656,281.6199951171875,285.7099914550781,32343600.0,-2.079986572265625,2.079986572265625,0.0,22.093590546120538,281.6199951171875,305.32000732421875,1.2658993924816058,-98.7341006075184,-2.2391656489684237,0.18206858615993954,-0.05985921226442936,733951500.0,-1.0
MSFT,2021-10-01,289.1000061035156,289.9800109863281,281.2900085449219,282.1199951171875,30086300.0,7.17999267578125,0.0,7.17999267578125,42.798351432200484,281.2900085449219,305.32000732421875,32.50103185740683,-67.49896814259317,-2.3244165988078294,-0.3192284508336144,-0.01766898370757375,764037800.0,1.0
MSFT,2021-10-04,283.1099853515625,287.75,280.25,287.3999938964844,31350700.0,-5.990020751953125,5.990020751953125,0.0,34.07976856775687,280.25,305.32000732421875,11.407995676170488,-88.59200432382951,-2.842555988737388,-0.8238939584143693,-0.039654012637259206,732687100.0,-1.0
MSFT,2021-10-05,288.760009765625,290.3999938964844,284.04998779296875,284.04998779296875,24993000.0,5.6500244140625,0.0,5.6500244140625,46.04273064954528,280.25,305.3099975585937,33.95854187825611,-66.04145812174387,-2.7653976544978605,-1.2121946976310678,-0.032888931771265506,757680100.0,1.0
MSFT,2021-10-06,293.1099853515625,293.6300048828125,285.510009765625,285.7799987792969,28002600.0,4.3499755859375,0.0,4.3499755859375,53.53376649353395,280.25,304.5,53.03086742912371,-46.96913257087629,-2.3264248654947437,-1.4350407312038032,-0.021531620575506172,785682700.0,1.0
MSFT,2021-10-07,294.8500061035156,296.6400146484375,293.9200134277344,295.17999267578125,20430500.0,1.740020751953125,0.0,1.740020751953125,56.33191992955592,280.25,300.8999938964844,70.70222963117317,-29.297770368826836,-1.817183277196989,-1.5114692404024406,-0.015032570263064926,806113200.0,1.0
1.0,1.0,1.0,1.0,1.0,1.0,1.0,1.0,1.0,1.0,1.0,1.0,1.0,1.0,1.0,1.0,1.0,1.0,1.0,1.0
MSFT,2021-10-11,294.2300109863281,297.9700012207031,292.75,292.9200134277344,19298600.0,-0.6199951171875,0.6199951171875,0.0,54.76738342051973,280.25,300.8999938964844,67.69983108182998,-32.30016891817001,-1.1022139264492807,-1.4113824885060329,0.03777519183008926,786814600.0,-1.0
MSFT,2021-10-12,292.8800048828125,295.44000244140625,292.3500061035156,295.3399963378906,17974100.0,-1.350006103515625,1.350006103515625,0.0,51.19503075300831,280.25,300.8999938964844,61.16226932620419,-38.83773067379581,-0.965999380882522,-1.3223058669813308,0.03126762282680451,768840500.0,-1.0
MSFT,2021-10-13,296.3099975585937,297.2799987792969,293.489990234375,294.9100036621094,23416300.0,3.429992675781193,0.0,3.429992675781193,59.02949069228827,280.25,299.79998779296875,82.14837640138963,-17.851623598610374,-0.5746523937706343,-1.1727751723391915,0.05104279031452297,792256800.0,1.0
MSFT,2021-10-14,302.75,303.2699890136719,297.8299865722656,299.2099914550781,27262900.0,6.440002441406307,0.0,6.440002441406307,69.60114571040236,280.25,303.2699890136719,97.741141347361,-2.258858652639003,0.2522396272840979,-0.8877722124145335,0.04721547425909378,819519700.0,1.0
MSFT,2021-10-15,304.2099914550781,304.45001220703125,300.5199890136719,302.3399963378906,25384800.0,1.459991455078125,0.0,1.459991455078125,71.52323873581719,280.25,304.45001220703125,99.0081792112345,-0.9918207887655015,1.0136815304838365,-0.5074814638348595,0.07452936030254786,844904500.0,1.0
MSFT,2021-10-18,307.2900085449219,308.2099914550781,302.69000244140625,303.57000732421875,22729300.0,3.08001708984375,0.0,3.08001708984375,75.32151387546378,280.25,308.2099914550781,96.70964523850324,-3.2903547614967588,1.8444002648816422,-0.037105118091558975,0.06417093140541485,867633800.0,1.0
MSFT,2021-10-19,308.2300109863281,309.29998779296875,307.2200012207031,308.3500061035156,17682100.0,0.94000244140625,0.0,0.94000244140625,76.42865736259945,280.25,309.29998779296875,96.31677364456725,-3.683226355432762,2.54921541946635,0.480158989420023,0.05158481931835368,885315900.0,1.0
MSFT,2021-10-20,307.4100036621094,309.70001220703125,306.1099853515625,309.2099914550781,16537100.0,-0.82000732421875,0.82000732421875,0.0,73.12650674002603,280.25,309.70001220703125,92.22408286684808,-7.77591713315192,3.006956447257835,0.9855184809875857,0.042597921989474985,868778800.0,-1.0
MSFT,2021-10-21,310.760009765625,311.0199890136719,306.3599853515625,307.1700134277344,16918100.0,3.350006103515625,0.0,3.350006103515625,77.6736109777494,280.25,311.0199890136719,99.15508826496051,-0.8449117350394884,3.5985551018220576,1.5081258051544801,0.053959651798425545,885696900.0,1.0
MSFT,2021-10-22,309.1600036621094,311.0899963378906,307.79998779296875,310.3999938964844,17449300.0,-1.600006103515625,1.600006103515625,0.0,71.04854897644934,284.04998779296875,311.0899963378906,92.86245537764927,-7.137544622350733,3.893413331735019,1.9851833104705883,0.05074258953304045,868247600.0,-1.0
MSFT,2021-10-25,308.1300048828125,309.3999938964844,306.4599914550781,309.3599853515625,17554500.0,-1.029998779296875,1.029998779296875,0.0,66.81546921755958,285.510009765625,311.0899963378906,88.42848706462023,-11.57151293537977,3.9978930869452824,2.3877252657655275,0.05206910593333891,850693100.0,-1.0
MSFT,2021-10-26,310.1099853515625,312.3999938964844,308.6000061035156,311.0,28107300.0,1.97998046875,0.0,1.97998046875,70.68897609450411,292.3500061035156,312.3999938964844,88.57850404415234,-11.421495955847659,4.19213756973744,2.7486077265599103,0.04657280519277762,878800400.0,1.0
MSFT,2021-10-27,323.1700134277344,326.1000061035156,316.0,316.0,52588700.0,13.060028076171875,0.0,13.060028076171875,84.47823397695564,292.3500061035156,326.1000061035156,91.3185402199074,-8.681459780092593,5.338375372078531,3.2665612556636345,0.0674484341130781,931389100.0,1.0
MSFT,2021-10-28,324.3500061035156,324.8699951171875,321.3599853515625,324.3299865722656,26297900.0,1.17999267578125,0.0,1.17999267578125,85.20390554386489,292.3500061035156,326.1000061035156,94.81481481481482,-5.185185185185185,6.269719215603743,3.867192847651657,0.06620431680138128,957687000.0,1.0
MSFT,2021-10-29,331.6199951171875,332.0,323.8999938964844,324.1300048828125,34766000.0,7.269989013671875,0.0,7.269989013671875,88.89477500943208,292.3500061035156,332.0,99.04160166126483,-0.9583983387351636,7.507896915004949,4.595333661122316,0.07917597675066901,992453000.0,1.0
MSFT,2021-11-01,329.3699951171875,331.489990234375,326.3699951171875,331.3599853515625,27073200.0,-2.25,2.25,0.0,81.62376282020809,293.489990234375,332.0,93.17059409016274,-6.829405909837261,8.212931899834985,5.31885330886485,0.06858509352548747,965379800.0,-1.0
MSFT,2021-11-02,333.1300048828125,333.45001220703125,330.0,330.3099975585937,26487100.0,3.760009765625,0.0,3.760009765625,84.12714943974946,297.8299865722656,333.45001220703125,99.1016083831607,-0.8983916168393167,8.971658870394549,6.04941442117079,0.0836667672304292,991866900.0,1.0
MSFT,2021-11-03,334.0,334.8999938964844,330.6499938964844,333.8999938964844,21500100.0,0.8699951171875,0.0,0.8699951171875,84.684190295974,300.5199890136719,334.8999938964844,97.38221707776921,-2.6177829222307833,9.53326327125933,6.746184191188498,0.07478436576154879,1013367000.0,1.0
MSFT,2021-11-04,336.44000244140625,336.5400085449219,329.510009765625,332.8900146484375,23992200.0,2.44000244140625,0.0,2.44000244140625,86.24617562089563,302.69000244140625,336.5400085449219,99.7045610473162,-0.29543895268378834,10.059269611749812,7.408801275300761,0.08823909450173262,1037359200.0,1.0
MSFT,2021-11-05,336.0599975585937,338.7900085449219,334.4200134277344,338.510009765625,22570100.0,-0.38000488281255684,0.38000488281255684,0.0,84.69401545253272,306.1099853515625,338.7900085449219,91.64623914072703,-8.353760859272963,10.326433510522293,7.992327722345069,0.09064353433026917,1014789100.0,-1.0
MSFT,2021-11-08,336.989990234375,337.6499938964844,334.44000244140625,337.29998779296875,20897000.0,0.9299926757813068,0.0,0.9299926757813068,85.43424748155503,306.1099853515625,338.7900085449219,94.49199194291685,-5.508008057083146,10.492257251383307,8.492313628152719,0.08667894022290001,1035686100.0,1.0
MSFT,2021-11-09,335.95001220703125,338.7200012207031,334.5299987792969,337.1099853515625,21307400.0,-1.03997802734375,1.03997802734375,0.0,80.4161138100094,306.3599853515625,338.7900085449219,91.24269408949371,-8.757305910506302,10.419645043308151,8.877779911183806,0.03954574449449866,1014378700.0,-1.0
MSFT,2021-11-10,330.79998779296875,334.6300048828125,329.9200134277344,334.57000732421875,25500900.0,-5.1500244140625,5.1500244140625,0.0,60.20898659043181,306.4599914550781,338.7900085449219,75.2860608463361,-24.7139391536639,9.83318458465385,9.068860845877815,0.019885868870292533,988877800.0,-1.0
MSFT,2021-11-11,332.42999267578125,333.7699890136719,330.510009765625,331.25,16849800.0,1.6300048828125,0.0,1.6300048828125,63.55358398064459,306.4599914550781,338.7900085449219,80.32783016641652,-19.672169833583478,9.39167681328695,9.133424039359642,0.0024425474052236495,1005727600.0,1.0
MSFT,2021-11-12,336.7200012207031,337.2300109863281,333.7900085449219,333.9200134277344,23831000.0,4.290008544921875,0.0,4.290008544921875,70.96495436957399,308.6000061035156,338.7900085449219,93.14340126922384,-6.856598730776151,9.280961414081162,9.162931514303947,0.022315348126657808,1029558600.0,1.0
MSFT,2021-11-15,336.07000732421875,337.8800048828125,334.0299987792969,337.5400085449219,16723000.0,-0.649993896484375,0.649993896484375,0.0,68.52874019355386,316.0,338.7900085449219,88.06493988213442,-11.935060117865564,9.036601272943017,9.13766546603176,0.008825390683257384,1012835600.0,-1.0
MSFT,2021-11-16,339.510009765625,340.6700134277344,335.510009765625,335.67999267578125,20886800.0,3.44000244140625,0.0,3.44000244140625,73.98289942597145,321.3599853515625,340.6700134277344,93.99273964007959,-6.007260359920411,9.016585957998927,9.113449564425194,0.016497035226422208,1033722400.0,1.0
MSFT,2021-11-17,339.1199951171875,342.19000244140625,338.0,338.94000244140625,19053400.0,-0.3900146484375,0.3900146484375,0.0,72.34276714602206,323.8999938964844,342.19000244140625,83.21483931142765,-16.785160688572347,8.86703904746372,9.0641674610329,0.007965737297389364,1014669000.0,-1.0
MSFT,2021-11-18,341.2699890136719,342.45001220703125,337.1199951171875,338.17999267578125,22463500.0,2.149993896484375,0.0,2.149993896484375,75.76075718539133,326.3699951171875,342.45001220703125,92.66155510428726,-7.338444895712741,8.820333271151753,9.01540062305667,0.015503158641098969,1037132500.0,1.0
MSFT,2021-11-19,343.1099853515625,345.1000061035156,342.20001220703125,342.6400146484375,21963400.0,1.839996337890625,0.0,1.839996337890625,78.39709933764499,329.510009765625,345.1000061035156,87.235271203262,-12.764728796738003,8.83000414263472,8.978321326972281,0.018160762320955204,1059095900.0,1.0
MSFT,2021-11-22,339.8299865722656,349.6700134277344,339.54998779296875,344.6199951171875,31031100.0,-3.279998779296875,3.279998779296875,0.0,64.06504381202296,329.510009765625,349.6700134277344,51.19035184520809,-48.809648154791915,8.475301884136115,8.877717438405048,0.011549260974109687,1028064800.0,-1.0
MSFT,2021-11-23,337.67999267578125,339.45001220703125,333.5599975585937,337.04998779296875,30427600.0,-2.149993896484375,2.149993896484375,0.0,56.28294480526889,329.510009765625,349.6700134277344,40.52570151815841,-59.47429848184159,7.929307132782185,8.688035377280476,0.020798080824351084,997637200.0,-1.0
MSFT,2021-11-24,337.9100036621094,338.1600036621094,333.9100036621094,336.2799987792969,21661300.0,0.230010986328125,0.0,0.230010986328125,56.92878051214542,329.9200134277344,349.6700134277344,40.455646756329116,-59.54435324367089,7.429519447493647,8.43633219132311,0.016484706876833455,1019298500.0,1.0
MSFT,2021-11-26,329.67999267578125,337.92999267578125,328.1199951171875,334.3500061035156,24217200.0,-8.230010986328125,8.230010986328125,0.0,35.36130917777784,328.1199951171875,349.6700134277344,7.238961638516408,-92.7610383614836,6.296755917973712,8.00841693665323,-0.020907604298526672,995081300.0,-1.0
MSFT,2021-11-29,336.6300048828125,339.0299987792969,334.739990234375,334.94000244140625,28563500.0,6.95001220703125,0.0,6.95001220703125,52.78911022544505,328.1199951171875,349.6700134277344,39.48957092746453,-60.51042907253547,5.89192215018744,7.585117979360072,0.0016663122158755428,1023644800.0,1.0
MSFT,2021-11-30,330.5899963378906,337.7799987792969,328.989990234375,335.32000732421875,42885600.0,-6.040008544921875,6.040008544921875,0.0,41.55429665882392,328.1199951171875,349.6700134277344,11.461712863112847,-88.53828713688715,5.025776241356141,7.0732496317592854,-0.026273197169921936,980759200.0,-1.0
MSFT,2021-12-01,330.0799865722656,339.2799987792969,329.3900146484375,335.1300048828125,33337600.0,-0.510009765625,0.510009765625,0.0,40.71015919631612,328.1199951171875,349.6700134277344,9.095080230715528,-90.90491976928448,4.249213553801894,6.5084424161678065,-0.026657256060050316,947421600.0,-1.0
MSFT,2021-12-02,329.489990234375,333.489990234375,327.79998779296875,330.29998779296875,30766000.0,-0.589996337890625,0.589996337890625,0.0,39.635428804189644,327.79998779296875,349.6700134277344,7.727482672538538,-92.27251732746147,3.5453061727375257,5.915815167481751,-0.034518121014224135,916655600.0,-1.0
MSFT,2021-12-03,323.010009765625,332.70001220703125,318.0299987792969,331.989990234375,41779300.0,-6.47998046875,6.47998046875,0.0,29.699333979385898,318.0299987792969,349.6700134277344,15.73959760026235,-84.26040239973764,2.436487917442264,5.219949717473854,-0.05858172727133648,874876300.0,-1.0
MSFT,2021-12-06,326.19000244140625,327.45001220703125,319.2300109863281,323.95001220703125,30032600.0,3.17999267578125,0.0,3.17999267578125,38.43800132279832,318.0299987792969,349.6700134277344,25.790138698663167,-74.20986130133683,1.7936640514761848,4.53469258427432,-0.04013767080545383,904908900.0,1.0
MSFT,2021-12-07,334.9200134277344,335.79998779296875,330.1000061035156,331.6400146484375,31021900.0,8.730010986328125,0.0,8.730010986328125,55.83000720114316,318.0299987792969,349.6700134277344,53.381816778873045,-46.618183221126955,1.965997636292741,4.020953594678004,-0.008173357343965737,935930800.0,1.0
MSFT,2021-12-08,334.9700012207031,335.5,330.79998779296875,335.3099975585937,24761000.0,0.04998779296875,0.0,0.04998779296875,55.91229804263506,318.0299987792969,349.6700134277344,53.53980593761454,-46.46019406238546,2.082599925416673,3.6332828608257377,-0.00870054869504866,960691800.0,1.0
MSFT,2021-12-09,333.1000061035156,336.489990234375,332.1199951171875,334.4100036621094,22214200.0,-1.8699951171875,1.8699951171875,0.0,51.75065840544643,318.0299987792969,349.6700134277344,47.629583904010495,-52.370416095989505,2.0010482630980846,3.306835941280207,0.010373736664989863,938477600.0,-1.0
MSFT,2021-12-10,342.5400085449219,343.0,334.7900085449219,334.9800109863281,38095700.0,9.44000244140625,0.0,9.44000244140625,66.3426972918312,318.0299987792969,349.6700134277344,77.46522888172997,-22.53477111827003,2.6673991695635664,3.178948586936879,0.017556378149258478,976573300.0,1.0
MSFT,2021-12-13,339.3999938964844,343.7900085449219,339.0799865722656,340.67999267578125,28899400.0,-3.1400146484375,3.1400146484375,0.0,59.442960950891674,318.0299987792969,343.7900085449219,82.95802412972809,-17.041975870271912,2.90858575772171,3.1248760210938458,0.02664931684620364,947673900.0,-1.0
MSFT,2021-12-14,328.3399963378906,334.6400146484375,324.1099853515625,333.2200012207031,44438700.0,-11.05999755859375,11.05999755859375,0.0,41.78241363346223,318.0299987792969,343.7900085449219,40.0232672751225,-59.9767327248775,2.1821243248782594,2.936325681850729,-0.00527141997442504,903235200.0,-1.0
MSFT,2021-12-15,334.6499938964844,335.19000244140625,324.5,328.6099853515625,35381100.0,6.30999755859375,0.0,6.30999755859375,51.30601317081009,318.0299987792969,343.7900085449219,64.51859012633514,-35.48140987366485,2.0914534995483223,2.767351245390248,0.01566057790841824,938616300.0,1.0
MSFT,2021-12-16,324.8999938964844,336.760009765625,323.0199890136719,335.7099914550781,35034800.0,-9.75,9.75,0.0,39.72112593454966,318.0299987792969,343.7900085449219,26.669225593054886,-73.33077440694512,1.2188030979416453,2.4576416159005277,0.005851162730934334,903581500.0,-1.0
MSFT,2021-12-17,323.79998779296875,324.9200134277344,317.25,320.8800048828125,47750300.0,-1.100006103515625,1.100006103515625,0.0,38.58689430507931,317.25,343.7900085449219,24.67967477057205,-75.32032522942795,0.43346337220935993,2.052805967162294,-0.007327062848490606,855831200.0,-1.0
MSFT,2021-12-20,319.9100036621094,322.79998779296875,317.57000732421875,320.04998779296875,28326500.0,-3.889984130859375,3.889984130859375,0.0,34.56012998184467,317.25,343.7900085449219,10.02261795661078,-89.97738204338923,-0.49708316263189545,1.542828141203456,-0.044816699999517096,827504700.0,-1.0
MSFT,2021-12-21,327.2900085449219,327.7300109863281,319.79998779296875,323.2900085449219,24740600.0,7.3800048828125,0.0,7.3800048828125,46.72931272415059,317.25,343.7900085449219,37.82971104899254,-62.17028895100746,-0.6317607344611247,1.1079103660705398,-0.022927404387836803,852245300.0,1.0
MSFT,2021-12-22,333.20001220703125,333.6099853515625,325.75,328.29998779296875,24831500.0,5.910003662109375,0.0,5.910003662109375,54.540585903817615,317.25,343.7900085449219,60.09799198080176,-39.90200801919824,-0.2586245144500481,0.8346033899664221,0.0003002284649749054,877076800.0,1.0
MSFT,2021-12-23,334.69000244140625,336.3900146484375,332.7300109863281,332.75,19617800.0,1.489990234375,0.0,1.489990234375,56.40035923711353,317.25,343.7900085449219,65.71212067203042,-34.28787932796957,0.15552558561637397,0.6987878290964125,-0.022917048834271148,896694600.0,1.0
MSFT,2021-12-27,342.45001220703125,342.4800109863281,335.42999267578125,335.4599914550781,19947000.0,7.760009765625,0.0,7.760009765625,65.0039852766493,317.25,343.7900085449219,94.95103275636654,-5.048967243633454,1.0972619064520472,0.7784826445675395,0.00898650078195673,916641600.0,1.0
MSFT,2021-12-28,341.25,343.8099975585937,340.32000732421875,343.1499938964844,15661500.0,-1.20001220703125,1.20001220703125,0.0,62.793023118027996,317.25,343.8099975585937,90.36145408919518,-9.638545910804822,1.7268576295492153,0.9681576415638747,0.03931901019096018,900980100.0,-1.0
MSFT,2021-12-29,341.95001220703125,344.29998779296875,339.67999267578125,341.29998779296875,15042000.0,0.70001220703125,0.0,0.70001220703125,63.625751209488165,317.25,344.29998779296875,91.31247080803362,-8.687529191966371,2.2562927723708412,1.2257846677252682,0.021813890463733054,916022100.0,1.0
MSFT,2021-12-30,339.32000732421875,343.1300048828125,338.82000732421875,341.9100036621094,15994500.0,-2.6300048828125,2.6300048828125,0.0,57.99852199664177,317.25,344.29998779296875,81.58971269464132,-18.410287305358686,2.4355786882332495,1.4677434718268647,0.04438292920475928,900027600.0,-1.0
MSFT,2021-12-31,336.32000732421875,339.3599853515625,335.8500061035156,338.510009765625,18000800.0,-3.0,3.0,0.0,51.95111544589417,317.25,344.29998779296875,70.4991346767843,-29.50086532321571,2.3089727398265723,1.6359893254268065,0.03866590488957966,882026800.0,-1.0
MSFT,2022-01-03,334.75,338.0,329.7799987792969,335.3500061035156,28865100.0,-1.57000732421875,1.57000732421875,0.0,48.873902250908465,317.25,344.29998779296875,64.69503843749929,-35.3049615625007,2.0582242160394344,1.7204363035493322,0.04638803465978736,853161700.0,-1.0
MSFT,2022-01-04,329.010009765625,335.20001220703125,326.1199951171875,334.8299865722656,32674300.0,-5.739990234375,5.739990234375,0.0,39.10308099371145,317.25,344.29998779296875,43.47510193214151,-56.52489806785849,1.3804223144209118,1.6524335057236483,0.005255281786174848,820487400.0,-1.0
MSFT,2022-01-05,316.3800048828125,326.07000732421875,315.9800109863281,325.8599853515625,40054300.0,-12.6300048828125,12.6300048828125,0.0,25.93785371555714,315.9800109863281,344.29998779296875,1.4124089832961382,-98.58759101670385,-0.17387212695092558,1.2871723791887337,-0.0504802122088992,780433100.0,-1.0
MSFT,2022-01-06,313.8800048828125,318.70001220703125,311.489990234375,313.1499938964844,39646100.0,-2.5,2.5,0.0,24.085763259649838,311.489990234375,344.29998779296875,7.284409711306108,-92.71559028869389,-1.5890729328468751,0.7119233167816118,-0.06217693210670949,740787000.0,-1.0
MSFT,2022-01-07,314.0400085449219,316.5,310.0899963378906,314.1499938964844,32720000.0,0.160003662109375,0.0,0.160003662109375,24.483966827177923,310.0899963378906,344.29998779296875,11.546370048697895,-88.4536299513021,-2.6669755748723105,0.03614353845082718,-0.08296102394335392,773507000.0,1.0
MSFT,2022-01-10,314.2699890136719,314.7200012207031,304.69000244140625,309.489990234375,44289500.0,0.22998046875,0.0,0.22998046875,25.135247586644027,304.69000244140625,344.29998779296875,24.185786708168326,-75.81421329183166,-3.4627472875005765,-0.6636346267394538,-0.07906230325663921,817796500.0,1.0
MSFT,2022-01-11,314.9800109863281,316.6099853515625,309.8900146484375,313.3800048828125,29386800.0,0.71002197265625,0.0,0.71002197265625,27.36672974430644,304.69000244140625,344.29998779296875,25.97831949088556,-74.02168050911445,-3.9901137165272758,-1.3289304446970187,-0.07887118075133837,847183300.0,1.0
MSFT,2022-01-12,318.2699890136719,323.4100036621094,317.0799865722656,319.6700134277344,34372200.0,3.28997802734375,0.0,3.28997802734375,37.35066204338078,304.69000244140625,344.29998779296875,34.28425042760066,-65.71574957239935,-4.095372771657139,-1.8822189100890434,-0.06203588900207013,881555500.0,1.0
MSFT,2022-01-13,304.79998779296875,320.8800048828125,304.0,320.4700012207031,45366000.0,-13.470001220703125,13.470001220703125,0.0,22.64548618511914,304.0,344.29998779296875,1.985081973420166,-98.01491802657983,-5.205699789474181,-2.5469150859660714,-0.09372032244535522,836189500.0,-1.0
MSFT,2022-01-14,310.20001220703125,310.82000732421875,303.75,304.25,39846400.0,5.4000244140625,0.0,5.4000244140625,34.5626664274441,303.75,344.29998779296875,15.906323424712998,-84.093676575287,-5.585518727217959,-3.1546358142164492,-0.0733382757071509,876035900.0,1.0
MSFT,2022-01-18,302.6499938964844,309.79998779296875,301.739990234375,304.07000732421875,42333200.0,-7.550018310546875,7.550018310546875,0.0,27.682571052423953,301.739990234375,344.29998779296875,2.1381666219706497,-97.86183337802935,-6.421725694927318,-3.808053790358623,-0.08011919116965027,833702700.0,-1.0
MSFT,2022-01-19,303.3299865722656,313.9100036621094,302.70001220703125,306.2900085449219,45933900.0,0.67999267578125,0.0,0.67999267578125,29.14826020790744,301.739990234375,343.1300048828125,3.841497403168105,-96.1585025968319,-6.949447114922975,-4.4363324552714944,-0.041247923728241376,879636600.0,1.0
MSFT,2022-01-20,301.6000061035156,311.6499938964844,301.1400146484375,309.07000732421875,35380700.0,-1.72998046875,1.72998046875,0.0,27.51145382539646,301.1400146484375,339.3599853515625,1.2035369117656454,-98.79646308823436,-7.421712229350703,-5.033408410087336,-0.03912322731064577,844255900.0,-1.0
MSFT,2022-01-21,296.0299987792969,304.1099853515625,295.6099853515625,302.69000244140625,57984400.0,-5.57000732421875,5.57000732421875,0.0,22.762779041281505,295.6099853515625,338.0,0.9908310511750595,-99.00916894882495,-8.15147366134022,-5.657021460337913,-0.05734941178059727,786271500.0,-1.0
MSFT,2022-01-24,296.3699951171875,297.1099853515625,276.04998779296875,292.20001220703125,85731500.0,0.339996337890625,0.0,0.339996337890625,23.690471521929823,276.04998779296875,335.20001220703125,34.35333717189103,-65.64666282810897,-8.603207569291328,-6.246258682128596,-0.056957375894093554,872003000.0,1.0
MSFT,2022-01-25,288.489990234375,294.989990234375,285.1700134277344,291.5199890136719,72848600.0,-7.8800048828125,7.8800048828125,0.0,17.931005754943953,276.04998779296875,326.07000732421875,24.870047149090695,-75.1299528509093,-9.487692273360153,-6.894545400374909,-0.08410064076447998,799154400.0,-1.0
MSFT,2022-01-26,296.7099914550781,308.5,293.0299987792969,307.989990234375,90428900.0,8.220001220703125,0.0,8.220001220703125,36.50950111416685,276.04998779296875,323.4100036621094,43.623303926237185,-56.37669607376282,-9.416816177479234,-7.398999555795774,-0.06774122067056598,889583300.0,1.0
MSFT,2022-01-27,299.8399963378906,307.29998779296875,297.92999267578125,302.6600036621094,53481300.0,3.1300048828125,0.0,3.1300048828125,42.25306438863104,276.04998779296875,323.4100036621094,50.23226472443655,-49.76773527556346,-9.004285329057666,-7.720056710448153,-0.016272938496464495,943064600.0,1.0
MSFT,2022-01-28,308.260009765625,308.4800109863281,294.45001220703125,300.2300109863281,49743700.0,8.420013427734375,0.0,8.420013427734375,54.91318636676283,276.04998779296875,323.4100036621094,68.01100333592586,-31.988996664074133,-7.906782478320565,-7.757401864022637,-0.006254037282601654,992808300.0,1.0
MSFT,2022-01-31,310.9800109863281,312.3800048828125,306.3699951171875,308.95001220703125,46444500.0,2.720001220703125,0.0,2.720001220703125,58.31922053759348,276.04998779296875,323.4100036621094,73.75424723225119,-26.245752767748808,-6.739829634885666,-7.553887418195243,0.027523599067683646,1039252800.0,1.0
MSFT,2022-02-01,308.760009765625,310.6300048828125,305.1300048828125,310.4100036621094,40950400.0,-2.220001220703125,2.220001220703125,0.0,54.445789922434265,276.04998779296875,323.4100036621094,69.06674622541631,-30.933253774583687,-5.925837280741916,-7.228277390704579,0.01790137287355109,998302400.0,-1.0
MSFT,2022-02-02,313.4599914550781,315.1199951171875,308.8800048828125,309.6300048828125,36636000.0,4.699981689453125,0.0,4.699981689453125,60.80503056524665,276.04998779296875,320.8800048828125,83.44855989489378,-16.55144010510623,-4.845635759895288,-6.751749064542722,0.03932355806217025,1034938400.0,1.0
MSFT,2022-02-03,301.25,311.2300109863281,299.9599914550781,309.489990234375,43730000.0,-12.209991455078125,12.209991455078125,0.0,42.86722795860802,276.04998779296875,315.1199951171875,64.49963522635494,-35.50036477364507,-4.918119519068341,-6.385023155447846,0.017633352167780947,991208400.0,-1.0
MSFT,2022-02-04,305.94000244140625,308.79998779296875,299.9700012207031,300.2099914550781,35096500.0,4.69000244140625,0.0,4.69000244140625,49.47347453151184,276.04998779296875,315.1199951171875,76.50373443853759,-23.49626556146241,-4.544730594102418,-6.016964643178762,0.03229074292906975,1026304900.0,1.0
MSFT,2022-02-07,300.95001220703125,307.8399963378906,299.8999938964844,306.1700134277344,28533300.0,-4.989990234375,4.989990234375,0.0,43.32357149519941,276.04998779296875,315.1199951171875,63.73181404198881,-36.268185958011195,-4.598459510969803,-5.733263616736971,0.043190482839746025,997771600.0,-1.0
MSFT,2022-02-08,304.5599975585937,305.5599975585937,299.95001220703125,301.25,32421200.0,3.609985351562443,0.0,3.609985351562443,48.651709851604465,276.04998779296875,315.1199951171875,72.97160077047677,-27.02839922952322,-4.300174679775807,-5.446645829344739,0.02645683101205587,1030192800.0,1.0
MSFT,2022-02-09,311.2099914550781,311.92999267578125,307.3900146484375,309.8699951171875,31284700.0,6.649993896484432,0.0,6.649993896484432,57.2033022393759,276.04998779296875,315.1199951171875,89.99231397715751,-10.007686022842485,-3.4869870547074697,-5.054714074417285,0.037920208297943736,1061477500.0,1.0
MSFT,2022-02-10,302.3800048828125,309.1199951171875,300.70001220703125,304.0400085449219,45386200.0,-8.829986572265625,8.829986572265625,0.0,45.574614420730356,276.04998779296875,315.1199951171875,67.39189187078108,-32.60810812921891,-3.5145228920600857,-4.746675837945846,-0.01907482221674861,1016091300.0,-1.0
MSFT,2022-02-11,295.0400085449219,304.2900085449219,294.2200012207031,303.19000244140625,39175600.0,-7.339996337890625,7.339996337890625,0.0,38.13834435627856,285.1700134277344,315.1199951171875,32.95492871924932,-67.04507128075068,-4.081571784267112,-4.6136550272101,-0.05125732162285834,976915700.0,-1.0
MSFT,2022-02-14,295.0,296.760009765625,291.3500061035156,293.7699890136719,36359500.0,-0.040008544921875,0.040008544921875,0.0,38.099246462974236,291.3500061035156,315.1199951171875,15.355471533390253,-84.64452846660974,-4.482518785628088,-4.587427778893697,-0.044565388426014096,940556200.0,-1.0
MSFT,2022-02-15,300.4700012207031,300.79998779296875,297.0199890136719,300.010009765625,27058300.0,5.470001220703125,0.0,5.470001220703125,46.71646529448265,291.3500061035156,315.1199951171875,38.367687557372946,-61.632312442627054,-4.309214842756489,-4.5317851916662555,-0.041440664162834984,967614500.0,1.0
MSFT,2022-02-16,299.5,300.8699951171875,293.67999267578125,298.3699951171875,29982100.0,-0.970001220703125,0.970001220703125,0.0,45.42263801565283,291.3500061035156,315.1199951171875,34.28690645080531,-65.7130935491947,-4.201706553636711,-4.4657694640603465,-0.0058091286307053736,937632400.0,-1.0
MSFT,2022-02-17,290.7300109863281,296.79998779296875,290.0,296.3599853515625,32461600.0,-8.769989013671875,8.769989013671875,0.0,35.24078947467311,290.0,315.1199951171875,2.906095255681956,-97.09390474431805,-4.769193980019452,-4.5264543672521675,-0.04971560218899829,905170800.0,-1.0
MSFT,2022-02-18,287.92999267578125,293.8599853515625,286.3099975585937,293.04998779296875,34264000.0,-2.800018310546875,2.800018310546875,0.0,32.552658242180556,286.3099975585937,315.1199951171875,5.623031081112759,-94.37696891888724,-5.382820131103529,-4.69772752002244,-0.043263063642254296,870906800.0,-1.0
MSFT,2022-02-22,287.7200012207031,291.5400085449219,284.5,285.0,41736100.0,-0.209991455078125,0.209991455078125,0.0,32.33919519547155,284.5,315.1199951171875,10.516008276224989,-89.48399172377502,-5.81899013613446,-4.921980043244844,-0.055292869952990986,829170700.0,-1.0
MSFT,2022-02-23,280.2699890136719,291.70001220703125,280.1000061035156,290.17999267578125,37811200.0,-7.45001220703125,7.45001220703125,0.0,25.495346097870424,280.1000061035156,311.92999267578125,0.5340338732796104,-99.46596612672039,-6.688708462732336,-5.275325727142342,-0.09941840972632243,791359500.0,-1.0
MSFT,2022-02-24,294.5899963378906,295.1600036621094,271.5199890136719,272.510009765625,56989700.0,14.32000732421875,0.0,14.32000732421875,49.29446016851652,271.5199890136719,311.92999267578125,57.08984220125287,-42.91015779874712,-6.151550345596604,-5.450570650833195,-0.02576231370834492,848349200.0,1.0
MSFT,2022-02-25,297.3099975585937,297.6300048828125,291.6499938964844,295.1400146484375,32546700.0,2.720001220703068,0.0,2.720001220703068,52.6120241911022,271.5199890136719,311.92999267578125,63.82085178849894,-36.17914821150106,-5.443616676723707,-5.449179856011298,0.007693834557783941,880895900.0,1.0
MSFT,2022-02-28,298.7900085449219,299.1400146484375,293.0,294.3099975585937,34627500.0,1.4800109863281818,0.0,1.4800109863281818,54.48181320071538,271.5199890136719,311.92999267578125,67.48333843092387,-32.51666156907613,-4.708868718706185,-5.301117628550276,0.012847486592955537,915523400.0,1.0
MSFT,2022-03-01,294.95001220703125,299.9700012207031,292.1499938964844,296.3999938964844,31217800.0,-3.839996337890625,3.839996337890625,0.0,48.726091359063005,271.5199890136719,311.92999267578125,57.98074998772802,-42.019250012271975,-4.385873659251217,-5.118068834690465,-0.01837118178602226,884305600.0,-1.0
MSFT,2022-03-02,300.19000244140625,301.4700012207031,293.70001220703125,295.3599853515625,31873000.0,5.239990234375,0.0,5.239990234375,56.038613586260794,271.5199890136719,309.1199951171875,76.25002333458055,-23.74997666541945,-3.6648284668021347,-4.8274207611127995,0.0023038478844950028,916178600.0,1.0
MSFT,2022-03-03,295.9200134277344,303.1300048828125,294.04998779296875,302.8900146484375,27314500.0,-4.269989013671875,4.269989013671875,0.0,49.412595359555226,271.5199890136719,304.2900085449219,74.4583761715316,-25.541623828468403,-3.3987684969790735,-4.5416903082860545,0.01785162262333606,888864100.0,-1.0
MSFT,2022-03-04,289.8599853515625,295.6600036621094,287.1700134277344,294.2900085449219,32356500.0,-6.060028076171875,6.060028076171875,0.0,41.39709101844081,271.5199890136719,303.1300048828125,58.01957333338482,-41.98042666661518,-3.6350055922598585,-4.360353365080815,0.006702992827685383,856507600.0,-1.0
MSFT,2022-03-07,278.9100036621094,289.69000244140625,278.5299987792969,288.5299987792969,43157200.0,-10.949981689453125,10.949981689453125,0.0,30.934793375107986,271.5199890136719,303.1300048828125,23.37871223801575,-76.62128776198425,-4.652169883250906,-4.418716668714834,-0.03062003865291174,813350400.0,-1.0
MSFT,2022-03-08,275.8500061035156,283.9599914550781,270.0,277.79998779296875,48159500.0,-3.05999755859375,3.05999755859375,0.0,28.60382216283503,270.0,303.1300048828125,17.65772786393565,-82.34227213606434,-5.640179661399486,-4.6630092672517645,-0.01577044665292593,765190900.0,-1.0
MSFT,2022-03-09,288.5,289.6000061035156,280.7799987792969,283.44000244140625,35204500.0,12.649993896484375,0.0,12.649993896484375,47.480559217263064,270.0,303.1300048828125,55.840619599780396,-44.1593804002196,-5.34086952249271,-4.798581318299954,-0.020672787309809038,800395400.0,1.0
MSFT,2022-03-10,285.5899963378906,286.6000061035156,280.5799865722656,283.0199890136719,30628000.0,-2.910003662109375,2.910003662109375,0.0,44.366959647038335,270.0,303.1300048828125,47.05703000357405,-52.94296999642595,-5.277639711238351,-4.894392996887634,-0.03942013829653779,769767400.0,-1.0
MSFT,2022-03-11,280.07000732421875,289.510009765625,279.42999267578125,287.9599914550781,27209300.0,-5.519989013671875,5.519989013671875,0.0,38.7982827344313,270.0,303.1300048828125,30.395429641010903,-69.6045703589891,-5.608297646973085,-5.037173926904725,-0.06265270151390834,742558100.0,-1.0
MSFT,2022-03-14,276.44000244140625,285.3999938964844,275.82000732421875,280.3399963378906,30660700.0,-3.6300048828125,3.6300048828125,0.0,35.424529271583665,270.0,303.1300048828125,19.438579813633698,-80.56142018636629,-6.093020947423042,-5.248343331008389,-0.0627564299018657,711897400.0,-1.0
MSFT,2022-03-15,287.1499938964844,287.82000732421875,278.7300109863281,280.3500061035156,34245100.0,10.709991455078125,0.0,10.709991455078125,50.17426857463614,270.0,303.1300048828125,51.76574515200755,-48.23425484799245,-5.548995486146225,-5.308473762035956,-0.04343918331346541,746142500.0,1.0
MSFT,2022-03-16,294.3900146484375,294.57000732421875,283.20001220703125,289.1099853515625,37826300.0,7.240020751953125,0.0,7.240020751953125,57.70893425002763,270.0,303.1300048828125,73.61910973062,-26.380890269379996,-4.481976782868799,-5.143174366202525,-0.00517031194198192,783968800.0,1.0
MSFT,2022-03-17,295.2200012207031,295.6099853515625,289.3699951171875,293.2900085449219,30816600.0,0.829986572265625,0.0,0.829986572265625,58.53828216628674,270.0,303.1300048828125,76.12435105250165,-23.87564894749835,-3.5287070547884127,-4.820280903919703,0.01849174132345177,814785400.0,1.0
MSFT,2022-03-18,300.42999267578125,301.0,292.7300109863281,295.3699951171875,43390600.0,5.209991455078125,0.0,5.209991455078125,63.694948560721656,270.0,303.1300048828125,91.8502511044543,-8.149748895545706,-2.326018267940981,-4.321428376723959,0.07715746560221137,858176000.0,1.0
MSFT,2022-03-21,299.1600036621094,300.1400146484375,294.8999938964844,298.8900146484375,28351200.0,-1.269989013671875,1.269989013671875,0.0,61.54214102409191,270.0,303.1300048828125,88.01690119048935,-11.98309880951065,-1.4585430626077027,-3.7488513139007074,0.08450243626185183,829824800.0,-1.0
MSFT,2022-03-22,304.0599975585937,305.0,298.7699890136719,299.79998779296875,27599700.0,4.899993896484318,0.0,4.899993896484318,66.57198268983927,270.0,305.0,97.31427873883912,-2.6857212611608765,-0.37139296910726216,-3.0733596449420184,0.053934133651971194,857424500.0,1.0
MSFT,2022-03-23,299.489990234375,303.2300109863281,297.7200012207031,300.510009765625,25715400.0,-4.570007324218693,4.570007324218693,0.0,58.35824717214091,270.0,305.0,84.25711495535714,-15.742885044642858,0.12003621183555424,-2.434680473586504,0.04867115121230947,831709100.0,-1.0
MSFT,2022-03-24,304.1000061035156,304.20001220703125,298.32000732421875,299.1400146484375,24484500.0,4.610015869140625,0.0,4.610015869140625,63.58743168560322,270.0,305.0,97.4285888671875,-2.5714111328125,0.8714416940232468,-1.7734560400645538,0.08579997197443179,856193600.0,1.0
MSFT,2022-03-25,303.67999267578125,305.5,299.2900085449219,305.2300109863281,22566500.0,-0.420013427734375,0.420013427734375,0.0,62.75893798355577,270.0,305.5,94.8732188050176,-5.126781194982395,1.4167133887495993,-1.135422154301723,0.09853852551657649,833627100.0,-1.0
MSFT,2022-03-28,310.70001220703125,310.79998779296875,304.3299865722656,304.3299865722656,29578200.0,7.02001953125,0.0,7.02001953125,70.23739387630961,275.82000732421875,310.79998779296875,99.7141919903963,-0.2858080096037075,2.3877772331078404,-0.4307822768198102,0.08201295076132409,863205300.0,1.0
MSFT,2022-03-29,315.4100036621094,315.82000732421875,309.04998779296875,313.9100036621094,30393400.0,4.709991455078125,0.0,4.709991455078125,74.24177589128043,275.82000732421875,315.82000732421875,98.97499084472656,-1.0250091552734375,3.497096916892076,0.35479356192256734,0.07140184098558544,893598700.0,1.0
MSFT,2022-03-30,313.8599853515625,315.95001220703125,311.5799865722656,313.760009765625,28163600.0,-1.550018310546875,1.550018310546875,0.0,70.63318260733007,275.82000732421875,315.95001220703125,94.79185995224262,-5.2081400477573805,4.2027208846350845,1.124379026465071,0.06313929968763987,865435100.0,-1.0
MSFT,2022-03-31,308.3099975585937,315.1400146484375,307.8900146484375,313.8999938964844,33422100.0,-5.549987792968807,5.549987792968807,0.0,58.821114560849246,275.82000732421875,315.95001220703125,80.96183972379794,-19.038160276202063,4.264931851551523,1.7524895914823615,0.02622908855613626,832013000.0,-1.0
MSFT,2022-04-01,309.4200134277344,310.1300048828125,305.5400085449219,309.3699951171875,27110500.0,1.1100158691406818,0.0,1.1100158691406818,60.35125630121763,278.7300109863281,315.95001220703125,82.45567285026135,-17.54432714973865,4.353617700075006,2.2727152132008905,0.03429606110452288,859123500.0,1.0
MSFT,2022-04-04,314.9700012207031,315.1099853515625,309.7099914550781,310.0899963378906,24289600.0,5.54998779296875,0.0,5.54998779296875,67.35041030581942,283.20001220703125,315.95001220703125,97.00760004174617,-2.9923999582538165,4.81622110676102,2.781416391912917,0.03588108843553828,883413100.0,1.0
MSFT,2022-04-05,310.8800048828125,314.8699951171875,309.8699951171875,313.2699890136719,23156700.0,-4.089996337890625,4.089996337890625,0.0,58.560231638422955,289.3699951171875,315.95001220703125,80.92549260942347,-19.074507390576528,4.797506448500826,3.184634403230499,0.038031370061897274,860256400.0,-1.0
MSFT,2022-04-06,299.5,307.0,296.7099914550781,305.19000244140625,40110400.0,-11.3800048828125,11.3800048828125,0.0,41.268357190891635,292.7300109863281,315.95001220703125,29.15585123930012,-70.84414876069988,3.820364871479967,3.3117804968803934,-0.015126622858237626,820146000.0,-1.0
MSFT,2022-04-07,301.3699951171875,303.6499938964844,296.3500061035156,296.6600036621094,31411200.0,1.8699951171875,0.0,1.8699951171875,44.3822158849082,294.8999938964844,315.95001220703125,30.73632110553274,-69.26367889446726,3.160434586906206,3.2815113148855564,-0.007606683398006964,851557200.0,1.0
MSFT,2022-04-08,296.9700012207031,301.1199951171875,296.2799987792969,300.44000244140625,24361900.0,-4.399993896484375,4.399993896484375,0.0,38.797624574846274,296.2799987792969,315.95001220703125,3.507890037499205,-96.49210996250079,2.2563821774846247,3.07648548740537,-0.04419057111970537,827195300.0,-1.0
MSFT,2022-04-11,285.260009765625,292.6099853515625,285.0,291.7900085449219,34569300.0,-11.709991455078125,11.709991455078125,0.0,27.984478973211836,285.0,315.95001220703125,0.8400958419199936,-99.15990415808,0.5882348782166673,2.5788353655676297,-0.09558984669612225,792626000.0,-1.0
MSFT,2022-04-12,282.0599975585937,290.739990234375,280.489990234375,289.239990234375,30966700.0,-3.200012207031307,3.200012207031307,0.0,25.723866472535605,280.489990234375,315.95001220703125,4.427541882036478,-95.57245811796352,-0.9806932944569553,1.8669296335627126,-0.10131902528877279,761659300.0,-1.0
MSFT,2022-04-13,287.6199951171875,288.5799865722656,281.29998779296875,282.7300109863281,21907200.0,5.559997558593807,0.0,5.559997558593807,36.07628412242474,280.489990234375,315.95001220703125,20.10716431115173,-79.89283568884827,-1.7552019630232962,1.1425033142455108,-0.06710778957946084,783566500.0,1.0
MSFT,2022-04-14,279.8299865722656,288.3099975585937,279.32000732421875,288.0899963378906,28221600.0,-7.790008544921875,7.790008544921875,0.0,29.442287010213178,279.32000732421875,315.95001220703125,1.3922445538252357,-98.60775544617476,-2.9634336304349063,0.3213159253094271,-0.09563061719141042,755344900.0,-1.0
MSFT,2022-04-18,280.5199890136719,282.4599914550781,278.3399963378906,278.9100036621094,20778000.0,0.69000244140625,0.0,0.69000244140625,30.743871279966328,278.3399963378906,315.95001220703125,5.796308843277981,-94.20369115672202,-3.821239629457864,-0.5071951856440313,-0.10937553441126513,776122900.0,1.0
MSFT,2022-04-19,285.29998779296875,286.1700134277344,278.4100036621094,279.3800048828125,22297700.0,4.779998779296875,0.0,4.779998779296875,39.64358964662809,278.3399963378906,315.95001220703125,18.505686036651912,-81.49431396334809,-4.0684525223159085,-1.219446652978407,-0.08228260643358598,798420600.0,1.0
MSFT,2022-04-20,286.3599853515625,289.70001220703125,285.3699951171875,289.3999938964844,22906700.0,1.05999755859375,0.0,1.05999755859375,41.56498269403533,278.3399963378906,315.1400146484375,21.793437562973573,-78.20656243702643,-4.131215496122422,-1.8018004216072103,-0.04387317077942399,821327300.0,1.0
MSFT,2022-04-21,280.8099975585937,293.29998779296875,280.0599975585937,288.5799865722656,29454600.0,-5.549987792968807,5.549987792968807,0.0,34.860548945150455,278.3399963378906,315.1099853515625,6.717438016597363,-93.28256198340263,-4.576043456280274,-2.3566490285418236,-0.06822178017622182,791872700.0,-1.0
MSFT,2022-04-22,274.0299987792969,283.20001220703125,273.3800048828125,281.67999267578125,29405800.0,-6.779998779296818,6.779998779296818,0.0,28.40280008931576,273.3800048828125,315.1099853515625,1.5576185015737805,-98.44238149842623,-5.413261350977166,-2.9679714930288923,-0.07724686785571189,762466900.0,-1.0
MSFT,2022-04-25,280.7200012207031,281.1099853515625,270.7699890136719,273.2900085449219,35678900.0,6.69000244140625,0.0,6.69000244140625,40.873093080164715,270.7699890136719,314.8699951171875,22.562382834314487,-77.43761716568551,-5.473836300488188,-3.4691444545207517,-0.015915334745490672,798145800.0,1.0
MSFT,2022-04-26,270.2200012207031,278.3599853515625,270.0,277.5,46518400.0,-10.5,10.5,0.0,31.072236005027193,270.0,307.0,0.5945978937922297,-99.40540210620777,-6.296522243261904,-4.034620012268983,-0.04197687173074227,751627400.0,-1.0
MSFT,2022-04-27,283.2200012207031,290.9700012207031,279.1600036621094,282.1000061035156,63477700.0,13.0,0.0,13.0,48.659208108617605,270.0,303.6499938964844,39.28678638507658,-60.71321361492341,-5.832284480554563,-4.394152905926099,-0.015297941628472866,815105100.0,1.0
MSFT,2022-04-28,289.6300048828125,290.9800109863281,281.4599914550781,285.19000244140625,33646600.0,6.410003662109375,0.0,6.410003662109375,55.16731223150596,270.0,301.1199951171875,63.07843175711456,-36.92156824288544,-4.8907613318201015,-4.493474591104899,0.035021330024672004,848751700.0,1.0
MSFT,2022-04-29,277.5199890136719,289.8800048828125,276.5,288.6099853515625,37073900.0,-12.110015869140625,12.110015869140625,0.0,43.22343030650484,270.0,293.29998779296875,32.27464786887651,-67.7253521311235,-5.063406725286427,-4.607461017941205,-0.010694425058792478,811677800.0,-1.0
MSFT,2022-05-02,284.4700012207031,284.94000244140625,276.2200012207031,277.7099914550781,35151100.0,6.95001220703125,0.0,6.95001220703125,50.342701356242976,270.0,293.29998779296875,62.103042067128236,-37.89695793287177,-4.586550641255712,-4.603278942604106,-0.00290917142579028,846828900.0,1.0
MSFT,2022-05-03,281.7799987792969,284.1300048828125,280.1499938964844,283.9599914550781,25978600.0,-2.69000244140625,2.69000244140625,0.0,47.673051273727786,270.0,293.29998779296875,50.557961162759625,-49.44203883724037,-4.37526415318132,-4.557675984719549,-0.015993807817257677,820850300.0,-1.0
MSFT,2022-05-04,289.9800109863281,290.8800048828125,276.7300109863281,282.5899963378906,33599300.0,8.20001220703125,0.0,8.20001220703125,55.89884030230502,270.0,293.29998779296875,85.75116503862506,-14.248834961374943,-3.505733718337922,-4.347287531443224,0.0326555803121682,854449600.0,1.0
MSFT,2022-05-05,277.3500061035156,286.3500061035156,274.3399963378906,285.5400085449219,43260400.0,-12.6300048828125,12.6300048828125,0.0,43.69226925278377,270.0,293.29998779296875,31.545107099728355,-68.45489290027164,-3.7920480552708113,-4.236239636208742,0.012115488592519652,811189200.0,-1.0
MSFT,2022-05-06,274.7300109863281,279.25,271.2699890136719,274.8099975585937,37780300.0,-2.6199951171875,2.6199951171875,0.0,41.52199809036658,270.0,293.29998779296875,20.300486971737826,-79.69951302826217,-4.182156641358347,-4.225423037238663,-0.021337953150212696,773408900.0,-1.0
MSFT,2022-05-09,264.5799865722656,272.3599853515625,263.32000732421875,270.0599975585937,47726000.0,-10.1500244140625,10.1500244140625,0.0,33.97771353726769,263.32000732421875,293.29998779296875,4.202735386569814,-95.79726461343019,-5.249825923986236,-4.430303614588178,-0.020871936285097537,725682900.0,-1.0
MSFT,2022-05-10,269.5,273.75,265.07000732421875,271.69000244140625,39336400.0,4.920013427734375,0.0,4.920013427734375,40.06810151684384,263.32000732421875,293.29998779296875,20.613731493998273,-79.38626850600173,-5.634012171992367,-4.671045326069016,-0.04844291067568929,765019300.0,1.0
MSFT,2022-05-11,260.54998779296875,271.3599853515625,259.29998779296875,265.67999267578125,48975900.0,-8.95001220703125,8.95001220703125,0.0,33.568439197377984,259.29998779296875,290.9800109863281,3.9457041820033116,-96.05429581799669,-6.584768614472694,-5.053789983749752,-0.10040402099088408,716043400.0,-1.0
MSFT,2022-05-12,255.3500061035156,259.8800048828125,250.0200042724609,257.69000244140625,51033800.0,-5.199981689453153,5.199981689453153,0.0,30.2760078273499,250.0200042724609,290.9800109863281,13.012697649900993,-86.987302350099,-7.66943651911339,-5.57691929082248,-0.07988607591456809,665009600.0,-1.0
MSFT,2022-05-13,261.1199951171875,263.0400085449219,255.3500061035156,257.3500061035156,34925100.0,5.769989013671903,0.0,5.769989013671903,38.05483424217743,250.0200042724609,290.9800109863281,27.099582581290527,-72.90041741870948,-7.9715625456573775,-6.055847941789461,-0.08208249025667824,699934700.0,1.0
MSFT,2022-05-16,261.5,265.82000732421875,255.77999877929688,259.9599914550781,32550900.0,0.3800048828125,0.0,0.3800048828125,38.57559100533247,250.0200042724609,290.9800109863281,28.027328725150042,-71.97267127484996,-8.087113173572504,-6.46210098814607,-0.07197103721751774,732485600.0,1.0
MSFT,2022-05-17,266.82000732421875,268.3299865722656,262.4599914550781,266.1099853515625,28828800.0,5.32000732421875,0.0,5.32000732421875,45.91967674206929,250.0200042724609,290.9800109863281,41.01562572759568,-58.98437427240432,-7.661095409766972,-6.7018998724702525,-0.07986758667721172,761314400.0,1.0
MSFT,2022-05-18,254.0800018310547,263.6000061035156,252.7700042724609,263.0,31356000.0,-12.740005493164062,12.740005493164062,0.0,34.516441987182446,250.0200042724609,290.8800048828125,9.936361962670178,-90.06363803732982,-8.256311612396587,-7.01278222045552,-0.08390122141831091,729958400.0,-1.0
MSFT,2022-05-19,253.13999938964844,257.6700134277344,251.8800048828125,253.8999938964844,32692300.0,-0.94000244140625,0.94000244140625,0.0,33.80181963499443,250.0200042724609,290.8800048828125,7.635817598096413,-92.36418240190358,-8.703546021607224,-7.350934980685861,-0.078586287385087,697266100.0,-1.0
MSFT,2022-05-20,252.55999755859372,258.5400085449219,246.44000244140625,257.239990234375,39199300.0,-0.5800018310547159,0.5800018310547159,0.0,33.31081663664985,246.44000244140625,290.8800048828125,13.77136539372749,-86.22863460627251,-9.001025593447707,-7.680953103238231,-0.04543045439451199,658066800.0,-1.0
MSFT,2022-05-23,260.6499938964844,261.5,253.42999267578125,255.4900054931641,33175400.0,8.089996337890653,0.0,8.089996337890653,45.94734937716761,246.44000244140625,290.8800048828125,31.975676585107916,-68.02432341489208,-8.486162010602754,-7.841994884711136,-0.03283861262900045,691242200.0,1.0
MSFT,2022-05-24,259.6199951171875,261.3299865722656,253.5,257.8900146484375,29043900.0,-1.029998779296875,1.029998779296875,0.0,44.70299120777509,246.44000244140625,286.3500061035156,33.024283303422386,-66.97571669657762,-8.068235607456131,-7.887243029260136,-0.00356934453790958,662198300.0,-1.0
MSFT,2022-05-25,262.5199890136719,264.5799865722656,257.1300048828125,258.1400146484375,28547900.0,2.899993896484375,0.0,2.899993896484375,49.17469676725018,246.44000244140625,279.25,49.00941105999527,-50.99058894000472,-7.417516141938449,-7.7932976517957995,0.028079039509596226,690746200.0,1.0
MSFT,2022-05-26,265.8999938964844,267.1099853515625,261.42999267578125,262.2699890136719,25002100.0,3.3800048828125,0.0,3.3800048828125,54.159924837951706,246.44000244140625,273.75,71.25592528277092,-28.74407471722908,-6.553533081243643,-7.545344737685369,0.018305755471355933,715748300.0,1.0
MSFT,2022-05-27,273.239990234375,273.3399963378906,267.5599975585937,268.4800109863281,26910800.0,7.339996337890625,0.0,7.339996337890625,63.203463808183386,246.44000244140625,273.75,98.13251625332163,-1.8674837466783774,-5.216412364785015,-7.079558263105298,0.04489480013145308,742659100.0,1.0
MSFT,2022-05-31,271.8699951171875,274.7699890136719,268.92999267578125,272.5299987792969,37827700.0,-1.3699951171875,1.3699951171875,0.0,60.627533685592084,246.44000244140625,274.7699890136719,89.76351828093205,-10.236481719067948,-4.218651728876125,-6.5073769562594626,0.01892657092551686,704831400.0,-1.0
MSFT,2022-06-01,272.4200134277344,277.69000244140625,270.0400085449219,275.20001220703125,25292200.0,0.550018310546875,0.0,0.550018310546875,61.35710687611247,246.44000244140625,277.69000244140625,83.13603515625,-16.86396484375,-3.34497852521298,-5.874897270050167,0.07218203504608955,730123600.0,1.0
MSFT,2022-06-02,274.5799865722656,274.6499938964844,261.6000061035156,264.45001220703125,44008200.0,2.15997314453125,0.0,2.15997314453125,64.35040489815466,246.44000244140625,277.69000244140625,90.04794921875,-9.952050781250001,-2.4500517640874477,-5.189928168857623,0.08469616510354605,774131800.0,1.0
MSFT,2022-06-03,270.0199890136719,273.45001220703125,268.4100036621094,270.3099975585937,28059000.0,-4.55999755859375,4.55999755859375,0.0,54.1356520636119,246.44000244140625,277.69000244140625,75.45595703125,-24.54404296875,-2.0847379899414022,-4.568890133074379,0.06913205425980995,746072800.0,-1.0
MSFT,2022-06-06,268.75,274.17999267578125,267.2200012207031,272.0599975585937,22400300.0,-1.269989013671875,1.269989013671875,0.0,51.508191876223734,246.44000244140625,277.69000244140625,71.3919921875,-28.608007812500002,-1.8760754615450992,-4.030327198768523,0.03107617990864986,723672500.0,-1.0
MSFT,2022-06-07,272.5,273.1300048828125,265.94000244140625,266.6400146484375,22860700.0,3.75,0.0,3.75,58.389009351940764,246.44000244140625,277.69000244140625,83.3919921875,-16.6080078125,-1.3920683471429243,-3.5026754284434034,0.04961098961965038,746533200.0,1.0
MSFT,2022-06-08,270.4100036621094,273.0,269.6099853515625,271.7099914550781,17372300.0,-2.089996337890625,2.089996337890625,0.0,53.506527985672506,246.44000244140625,277.69000244140625,76.70400390625,-23.29599609375,-1.1637198218202798,-3.0348843071187788,0.030054910020686387,729160900.0,-1.0
MSFT,2022-06-09,264.7900085449219,272.7099914550781,264.6300048828125,267.7799987792969,26439700.0,-5.6199951171875,5.6199951171875,0.0,42.484161265637596,246.44000244140625,277.69000244140625,58.72001953125,-41.27998046875,-1.419871216493334,-2.71188168899369,-0.0041744466981621375,702721200.0,-1.0
MSFT,2022-06-10,252.9900054931641,260.5799865722656,252.52999877929688,260.5799865722656,31422800.0,-11.800003051757784,11.800003051757784,0.0,28.34032978522343,252.52999877929688,277.69000244140625,1.8283253056913493,-98.17167469430865,-2.545689547314794,-2.678643260657911,-0.0741106187415731,671298400.0,-1.0
MSFT,2022-06-13,242.25999450683597,249.0200042724609,241.52999877929688,245.1100006103516,46135800.0,-10.730010986328125,10.730010986328125,0.0,21.003635144180706,241.52999877929688,277.69000244140625,2.018793289846993,-97.98120671015302,-4.254685531371308,-2.9938517148005905,-0.10891235201438232,625162600.0,-1.0
MSFT,2022-06-14,244.4900054931641,245.7400054931641,241.50999450683597,243.8600006103516,28651500.0,2.230010986328125,0.0,2.230010986328125,25.621064356795287,241.50999450683597,277.69000244140625,8.236623363149405,-91.7633766368506,-5.367263439840997,-3.4685340598086722,-0.10252553614963889,653814100.0,1.0
MSFT,2022-06-15,251.75999450683597,255.3000030517578,246.4199981689453,248.30999755859372,33111700.0,7.269989013671875,0.0,7.269989013671875,39.0272082956627,241.50999450683597,277.69000244140625,28.33056316222099,-71.66943683777902,-5.597833749490576,-3.8943939977450532,-0.08310872307302619,686925800.0,1.0
MSFT,2022-06-16,244.97000122070312,247.4199981689453,243.0200042724609,245.97999572753903,33169200.0,-6.789993286132841,6.789993286132841,0.0,32.67955069300861,241.50999450683597,277.69000244140625,9.563311097455827,-90.43668890254418,-6.256338912360604,-4.366782980668164,-0.09277086442552374,653756600.0,-1.0
MSFT,2022-06-17,247.6499938964844,250.5,244.02999877929688,244.6999969482422,43084800.0,2.6799926757812784,0.0,2.6799926757812784,37.322260115944964,241.50999450683597,277.69000244140625,16.970696636530086,-83.02930336346991,-6.4871758616994555,-4.790861556874423,-0.07851165061773246,696841400.0,1.0
MSFT,2022-06-21,253.7400054931641,254.75,249.50999450683597,250.25999450683597,29928300.0,6.0900115966796875,0.0,6.0900115966796875,46.92035288562361,241.50999450683597,277.69000244140625,33.8032291436903,-66.19677085630971,-6.108290200486806,-5.0543472855969,-0.06884401653884742,726769700.0,1.0
MSFT,2022-06-22,253.1300048828125,257.1700134277344,250.3699951171875,251.88999938964844,25939900.0,-0.6100006103515909,0.6100006103515909,0.0,46.104383450981935,241.50999450683597,274.6499938964844,35.06339948698416,-64.93660051301585,-5.790493332835581,-5.201576495044637,-0.06390295678886604,700829800.0,-1.0
MSFT,2022-06-23,258.8599853515625,259.3699951171875,253.6300048828125,255.57000732421875,25861400.0,5.72998046875,0.0,5.72998046875,54.651942149439506,241.50999450683597,274.17999267578125,53.106800787086364,-46.893199212913636,-5.018426195911246,-5.164946435217959,-0.022395192424163324,726691200.0,1.0
MSFT,2022-06-24,267.70001220703125,267.9800109863281,261.7200012207031,261.8099975585937,33923200.0,8.84002685546875,0.0,8.84002685546875,64.63584385088879,241.50999450683597,274.17999267578125,80.16534792796654,-19.834652072033464,-3.6511529212931464,-4.8621877324329965,0.0581446159708654,760614400.0,1.0
MSFT,2022-06-27,264.8900146484375,268.29998779296875,263.2799987792969,268.2099914550781,24615100.0,-2.80999755859375,2.80999755859375,0.0,59.806478101464464,241.50999450683597,273.1300048828125,73.94058339514217,-26.059416604857837,-2.7624781903401185,-4.442245824014421,0.09341212191335613,735999300.0,-1.0
MSFT,2022-06-28,256.4800109863281,266.9100036621094,256.32000732421875,263.9800109863281,27295500.0,-8.410003662109375,8.410003662109375,0.0,47.540132166749665,241.50999450683597,273.0,47.538945278183284,-52.46105472181672,-2.7056253093304576,-4.094921721077628,0.04904088193289868,708703800.0,-1.0
MSFT,2022-06-29,260.260009765625,261.9700012207031,255.75999450683597,257.5899963378906,20069800.0,3.779998779296875,0.0,3.779998779296875,52.58370165151306,241.50999450683597,272.7099914550781,60.09620863070446,-39.90379136929553,-2.3287107528196316,-3.7416795274260286,0.033762374659402905,728773600.0,1.0
MSFT,2022-06-30,256.8299865722656,259.5299987792969,252.8999938964844,257.04998779296875,31730900.0,-3.430023193359375,3.430023193359375,0.0,47.774627940843644,241.50999450683597,268.29998779296875,57.185501697604735,-42.81449830239526,-2.2804893948775202,-3.4494415009163273,0.04841403148329726,697042700.0,-1.0
MSFT,2022-07-01,259.5799865722656,259.7699890136719,254.6100006103516,256.3900146484375,22837700.0,2.75,0.0,2.75,51.848467630958915,241.50999450683597,268.29998779296875,67.45052853291743,-32.54947146708256,-1.9973474261778392,-3.1590226859686297,0.048172796163152176,719880400.0,1.0
MSFT,2022-07-05,262.8500061035156,262.9800109863281,254.7400054931641,256.1600036621094,22941000.0,3.27001953125,0.0,3.27001953125,56.50368938205658,241.50999450683597,268.29998779296875,79.65665152938213,-20.343348470617876,-1.491894497482349,-2.8255970482713737,0.03590289435300331,742821400.0,1.0
MSFT,2022-07-06,266.2099914550781,267.989990234375,262.3999938964844,263.75,23824400.0,3.3599853515625,0.0,3.3599853515625,60.97660083816991,243.0200042724609,268.29998779296875,91.73260403356213,-8.267395966437876,-0.810849701969687,-2.4226475790110364,0.05167299932823477,766645800.0,1.0
MSFT,2022-07-07,268.3999938964844,269.0599975585937,265.0199890136719,265.1199951171875,20859900.0,2.19000244140625,0.0,2.19000244140625,63.777942721067475,243.0200042724609,269.0599975585937,97.46542307113116,-2.5345769288688467,-0.09332609532231118,-1.9567832822732913,0.03685393295516648,787505700.0,1.0
MSFT,2022-07-08,267.6600036621094,268.1000061035156,263.2900085449219,264.7900085449219,19658800.0,-0.739990234375,0.739990234375,0.0,62.04153056436743,244.02999877929688,269.0599975585937,94.40673605768491,-5.593263942315098,0.41086925979692523,-1.483252773859248,-0.00014945290660250965,767846900.0,-1.0
MSFT,2022-07-11,264.510009765625,266.5299987792969,262.17999267578125,265.6499938964844,19455200.0,-3.149993896484375,3.149993896484375,0.0,54.723595280051,249.50999450683597,269.0599975585937,76.72640878406611,-23.273591215933887,0.549930275514896,-1.0766161639844192,-0.0014345760949759923,748391700.0,-1.0
MSFT,2022-07-12,253.6699981689453,265.94000244140625,252.0399932861328,265.8800048828125,35868500.0,-10.840011596679688,10.840011596679688,0.0,37.26867265893247,250.3699951171875,269.0599975585937,17.656514824454607,-82.3434851755454,-0.21211606775187875,-0.9037161447379111,-0.010956069467466634,712523200.0,-1.0
MSFT,2022-07-13,252.72000122070312,253.5500030517578,248.1100006103516,250.19000244140625,29497400.0,-0.9499969482421875,0.9499969482421875,0.0,36.104168554150554,248.1100006103516,269.0599975585937,22.004779388468386,-77.99522061153161,-0.8825268788007179,-0.8994782915504724,-0.028971060716212138,683025800.0,-1.0
MSFT,2022-07-14,254.0800018310547,255.13999938964844,245.94000244140625,250.57000732421875,25102800.0,1.3600006103515625,0.0,1.3600006103515625,39.24018506507314,245.94000244140625,269.0599975585937,35.2076172524671,-64.7923827475329,-1.2892301506906847,-0.9774286633785149,-0.010707413016342482,708128600.0,1.0
MSFT,2022-07-15,256.7200012207031,260.3699951171875,254.7700042724609,255.72000122070312,29774100.0,2.6399993896484375,0.0,2.6399993896484375,45.25800346087698,245.94000244140625,269.0599975585937,46.62630214520679,-53.3736978547932,-1.3825819918782827,-1.0584593290784685,-0.011017742119985408,737902700.0,1.0
MSFT,2022-07-18,254.25,260.8399963378906,253.3000030517578,259.75,20975000.0,-2.470001220703125,2.470001220703125,0.0,40.88638185481007,245.94000244140625,269.0599975585937,35.94290360561575,-64.05709639438425,-1.637002113071219,-1.1741678858770186,-0.03271830284884514,716927700.0,-1.0
MSFT,2022-07-19,259.5299987792969,259.7200012207031,253.67999267578125,257.5799865722656,25012600.0,5.279998779296875,0.0,5.279998779296875,52.26032792920362,245.94000244140625,269.0599975585937,58.780273391095136,-41.219726608904864,-1.3964823383004727,-1.2186307763617095,-0.025092945006568113,741940300.0,1.0
MSFT,2022-07-20,262.2699890136719,264.8699951171875,258.9100036621094,259.8999938964844,22788300.0,2.739990234375,0.0,2.739990234375,57.192177890105654,245.94000244140625,269.0599975585937,70.63144472779705,-29.36855527220295,-0.9735518711276541,-1.1696149953148984,-0.022839064911367668,764728600.0,1.0
MSFT,2022-07-21,264.8399963378906,264.8900146484375,257.0299987792969,259.7900085449219,22404700.0,2.57000732421875,0.0,2.57000732421875,61.49702707509799,245.94000244140625,269.0599975585937,81.74739570958684,-18.25260429041316,-0.4260866545033082,-1.0209093271525804,-0.010535781534915856,787133300.0,1.0
MSFT,2022-07-22,260.3599853515625,265.3299865722656,259.07000732421875,265.239990234375,21881300.0,-4.480010986328125,4.480010986328125,0.0,51.15084246024673,245.94000244140625,269.0599975585937,62.370181468751305,-37.629818531248695,-0.3496850203935651,-0.8866644658007773,-0.015689479644795723,765252000.0,-1.0
MSFT,2022-07-25,258.8299865722656,261.5,256.8099975585937,261.0,21056000.0,-1.529998779296875,1.529998779296875,0.0,47.970593591829825,245.94000244140625,269.0599975585937,55.752538292176965,-44.247461707823035,-0.40789236044639665,-0.7909100447299012,0.02034134284923894,744196000.0,-1.0
MSFT,2022-07-26,251.8999938964844,259.8800048828125,249.57000732421875,259.8599853515625,39348000.0,-6.929992675781222,6.929992675781222,0.0,36.205968680734635,245.94000244140625,269.0599975585937,25.778515198074093,-74.22148480192591,-1.0016679843626548,-0.833061632656452,-0.0032447266550248433,704848000.0,-1.0
MSFT,2022-07-27,268.739990234375,270.04998779296875,258.8500061035156,261.1600036621094,45994000.0,16.839996337890597,0.0,16.839996337890597,62.19922965046515,245.94000244140625,270.04998779296875,94.56657671295991,-5.4334232870400845,-0.11210025552674097,-0.6888693572305098,0.05769831666275005,750842000.0,1.0
MSFT,2022-07-28,276.4100036621094,277.8399963378906,267.8699951171875,269.75,33459300.0,7.670013427734375,0.0,7.670013427734375,68.86602761274047,245.94000244140625,277.8399963378906,95.51726348154929,-4.482736518450701,1.1979849365773703,-0.31149849846893374,0.07669835754043453,784301300.0,1.0
MSFT,2022-07-29,280.739990234375,282.0,276.6300048828125,277.70001220703125,32152800.0,4.329986572265625,0.0,4.329986572265625,72.07421923088438,245.94000244140625,282.0,96.50579630911618,-3.494203690883825,2.556164743146496,0.2620341498541524,0.10418875215093415,816454100.0,1.0
MSFT,2022-08-01,278.010009765625,281.2799987792969,275.8399963378906,277.82000732421875,21539600.0,-2.72998046875,2.72998046875,0.0,67.04809623590666,245.94000244140625,282.0,88.93513448554266,-11.064865514457344,3.3733594289269035,0.8842992056687029,0.07120568363291002,794914500.0,-1.0
MSFT,2022-08-02,274.82000732421875,277.8900146484375,272.3800048828125,276.0,22754200.0,-3.19000244140625,3.19000244140625,0.0,61.2858384923075,245.94000244140625,282.0,80.08875995037297,-19.911240049627036,3.720695703897036,1.4515785053143697,0.04785152261508907,772160300.0,-1.0
MSFT,2022-08-03,282.4700012207031,283.5,276.6099853515625,276.760009765625,23518900.0,7.649993896484375,0.0,7.649993896484375,68.72358228152576,249.57000732421875,283.5,96.96434128607379,-3.0356587139262,4.5606800967823915,2.073398823607975,0.06656851354249227,795679200.0,1.0
MSFT,2022-08-04,283.6499938964844,283.79998779296875,280.1700134277344,281.79998779296875,18098700.0,1.17999267578125,0.0,1.17999267578125,69.75765930347873,249.57000732421875,283.79998779296875,99.56180548621315,-0.4381945137868565,5.2609444346120995,2.7109079458088,0.08945310283941499,813777900.0,1.0
MSFT,2022-08-05,282.9100036621094,283.6499938964844,278.67999267578125,279.1499938964844,16774600.0,-0.739990234375,0.739990234375,0.0,68.12778271652618,249.57000732421875,283.79998779296875,97.39998644851148,-2.600013551488524,5.690600242595622,3.306846405166165,0.09303410863918815,797003300.0,-1.0
MSFT,2022-08-08,280.32000732421875,285.9200134277344,279.32000732421875,284.04998779296875,18739200.0,-2.589996337890625,2.589996337890625,0.0,62.25358875603084,249.57000732421875,285.9200134277344,84.59420862937897,-15.405791370621023,5.755765623690081,3.7966302488709487,0.11282260466990413,778264100.0,-1.0
MSFT,2022-08-09,282.29998779296875,283.0799865722656,277.6099853515625,279.6400146484375,23405200.0,1.97998046875,0.0,1.97998046875,64.92151899645346,249.57000732421875,285.9200134277344,90.04119662468086,-9.958803375319134,5.899175510958514,4.217139301288462,0.05045768419790342,801669300.0,1.0
MSFT,2022-08-10,289.1600036621094,289.8099975585937,286.94000244140625,288.1700134277344,24687800.0,6.860015869140625,0.0,6.860015869140625,72.6496407912409,249.57000732421875,289.8099975585937,98.38470662468237,-1.6152933753176262,6.49154434654514,4.672020310339798,0.04612712937693075,826357100.0,1.0
MSFT,2022-08-11,287.0199890136719,291.2099914550781,286.510009765625,290.8500061035156,20065900.0,-2.1400146484375,2.1400146484375,0.0,67.31181936393263,249.57000732421875,291.2099914550781,89.93755034046461,-10.06244965953539,6.710959851513508,5.079808218574541,0.022369448592108432,806291200.0,-1.0
MSFT,2022-08-12,291.9100036621094,291.9100036621094,286.94000244140625,288.4800109863281,22619700.0,4.8900146484375,0.0,4.8900146484375,72.61651641040112,249.57000732421875,291.9100036621094,100.0,-0.0,7.196475049851074,5.503141584829848,0.04999817779296034,828910900.0,1.0
MSFT,2022-08-15,293.4700012207031,294.17999267578125,290.1099853515625,291.0,18085700.0,1.55999755859375,0.0,1.55999755859375,74.16007376664218,258.8500061035156,294.17999267578125,97.99039987285057,-2.0096001271494255,7.619297588267216,5.926372785517322,0.06786257695744125,846996600.0,1.0
MSFT,2022-08-16,292.7099914550781,294.0400085449219,290.4200134277344,291.989990234375,18102900.0,-0.760009765625,0.760009765625,0.0,71.88235788010402,267.8699951171875,294.17999267578125,94.41276565142451,-5.587234348575498,7.803111646027503,6.301720557619359,0.036251602613100786,828893700.0,-1.0
MSFT,2022-08-17,291.32000732421875,293.3500061035156,289.4700012207031,289.739990234375,18253400.0,-1.389984130859375,1.389984130859375,0.0,67.50696971775683,272.3800048828125,294.17999267578125,86.88079379344907,-13.119206206550924,7.747319234733823,6.590840293042254,0.027040414569984073,810640300.0,-1.0
MSFT,2022-08-18,290.1700134277344,291.9100036621094,289.0799865722656,290.19000244140625,17186200.0,-1.149993896484375,1.149993896484375,0.0,63.79976190928047,272.3800048828125,294.17999267578125,81.60558947954901,-18.39441052045099,7.523581288448156,6.7773884921234355,0.025661905452788236,793454100.0,-1.0
MSFT,2022-08-19,286.1499938964844,289.25,285.5599975585937,288.8999938964844,20570000.0,-4.02001953125,4.02001953125,0.0,52.23055708395861,272.3800048828125,294.17999267578125,63.16512258834004,-36.83487741165996,6.941863888854584,6.810283571469665,0.02079761137250058,772884100.0,-1.0
MSFT,2022-08-22,277.75,282.4599914550781,277.2200012207031,282.0799865722656,25061100.0,-8.399993896484375,8.399993896484375,0.0,36.34180827767614,276.6099853515625,294.17999267578125,6.488413051860756,-93.51158694813925,5.736907850264231,6.595608427228577,-0.016117562839944588,747823000.0,-1.0
MSFT,2022-08-23,276.44000244140625,278.8599853515625,275.3999938964844,276.44000244140625,17527400.0,-1.30999755859375,1.30999755859375,0.0,34.455704446969165,275.3999938964844,294.17999267578125,5.537852036861596,-94.46214796313839,4.622974876890908,6.201081717161044,-0.04398949045375844,730295600.0,-1.0
MSFT,2022-08-24,275.7900085449219,277.2300109863281,275.1099853515625,275.4100036621094,18137000.0,-0.649993896484375,0.649993896484375,0.0,33.461465612587915,275.1099853515625,294.17999267578125,3.565930425709649,-96.43406957429035,3.6457005284954676,5.690005479427929,-0.03912612674588001,712158600.0,-1.0
MSFT,2022-08-25,278.8500061035156,279.0199890136719,274.5199890136719,277.3299865722656,16583400.0,3.05999755859375,0.0,3.05999755859375,42.47770622177245,274.5199890136719,294.17999267578125,22.024497880379187,-77.97550211962081,3.0825856672929604,5.1685215170009355,-0.044739808142070125,728742000.0,1.0
MSFT,2022-08-26,268.0899963378906,280.3399963378906,267.9800109863281,279.0799865722656,27549300.0,-10.760009765625,10.760009765625,0.0,27.408798965685975,267.9800109863281,294.17999267578125,0.4197917115597638,-99.58020828844023,1.7479212714600294,4.484401467892755,-0.08648245059884518,701192700.0,-1.0
MSFT,2022-08-29,265.2300109863281,267.3999938964844,263.8500061035156,265.8500061035156,20338500.0,-2.8599853515625,2.8599853515625,0.0,24.719386346944816,263.8500061035156,294.17999267578125,4.549968657336648,-95.45003134266335,0.45417772791682864,3.6783567198975695,-0.093881251993297,680854200.0,-1.0
MSFT,2022-08-30,262.9700012207031,267.04998779296875,260.6600036621094,266.6700134277344,22767100.0,-2.260009765625,2.260009765625,0.0,22.689435433487375,260.6600036621094,294.17999267578125,6.891403089814754,-93.10859691018524,-0.7449005023496511,2.7937052754481253,-0.09731568512547806,658087100.0,-1.0
MSFT,2022-08-31,261.4700012207031,267.1099853515625,261.3299865722656,265.3900146484375,24791800.0,-1.5,1.5,0.0,21.346941415323073,260.6600036621094,294.17999267578125,2.4164612890039265,-97.58353871099608,-1.7955184833008957,1.875860523698321,-0.09890757445265397,633295300.0,-1.0
MSFT,2022-09-01,260.3999938964844,260.8900146484375,255.41000366210935,258.8699951171875,23263400.0,-1.07000732421875,1.07000732421875,0.0,20.355615833466743,255.41000366210935,294.17999267578125,12.870754832082493,-87.1292451679175,-2.683547189587273,0.963978981041202,-0.08998777057222351,610031900.0,-1.0
MSFT,2022-09-02,256.0599975585937,264.739990234375,254.47000122070312,261.70001220703125,22855400.0,-4.339996337890682,4.339996337890682,0.0,16.721447468608957,254.47000122070312,294.0400085449219,4.018185604220028,-95.98181439577998,-3.69492497571639,0.03219818968968343,-0.07809181797085984,587176500.0,-1.0
MSFT,2022-09-06,253.25,257.8299865722656,251.94000244140625,256.20001220703125,21328200.0,-2.809997558593693,2.809997558593693,0.0,14.753632558147643,251.94000244140625,293.3500061035156,3.163480904959235,-96.83651909504076,-4.669366921366759,-0.9081148325216054,-0.08388801272102997,565848300.0,-1.0
MSFT,2022-09-07,258.0899963378906,258.8299865722656,253.22000122070312,254.6999969482422,24126700.0,4.839996337890625,0.0,4.839996337890625,30.91207587379614,251.94000244140625,291.9100036621094,15.386524164775064,-84.61347583522493,-4.993509855576065,-1.7251938371324975,-0.06417930910701641,589975000.0,1.0
MSFT,2022-09-08,258.5199890136719,260.42999267578125,254.7899932861328,257.510009765625,20319900.0,0.42999267578125,0.0,0.42999267578125,32.22891287621647,251.94000244140625,289.25,17.635987678455457,-82.36401232154455,-5.156260489659758,-2.41140716763795,-0.07290664028996574,610294900.0,1.0
MSFT,2022-09-09,264.4599914550781,265.2300109863281,260.2900085449219,260.5,22084700.0,5.94000244140625,0.0,5.94000244140625,48.020769596280125,251.94000244140625,282.4599914550781,41.02225924151992,-58.97774075848008,-4.751164518306439,-2.879358637771648,-0.013540247425858354,632379600.0,1.0
MSFT,2022-09-12,266.6499938964844,267.45001220703125,265.1600036621094,265.7799987792969,18747700.0,2.19000244140625,0.0,2.19000244140625,52.708648165614086,251.94000244140625,280.3399963378906,51.79575569169073,-48.20424430830927,-4.204936260315662,-3.144474162280451,0.0053537791778375254,651127300.0,1.0
MSFT,2022-09-13,251.9900054931641,260.3999938964844,251.58999633789065,258.8399963378906,33353300.0,-14.659988403320284,14.659988403320284,0.0,31.067222396750694,251.58999633789065,280.3399963378906,1.3913361922554361,-98.60866380774456,-4.8985179107551176,-3.495282911975385,-0.0417537957811539,617774000.0,-1.0
MSFT,2022-09-14,252.22000122070312,254.22999572753903,249.8600006103516,253.52999877929688,23913000.0,0.22999572753903408,0.0,0.22999572753903408,31.575789001014115,249.8600006103516,280.3399963378906,7.742785240023002,-92.257214759977,-5.367751534278568,-3.869776636436022,-0.035376907319445094,641687000.0,1.0
MSFT,2022-09-15,245.3800048828125,251.3999938964844,244.0200042724609,249.7700042724609,31530900.0,-6.839996337890625,6.839996337890625,0.0,25.196804657491015,244.0200042724609,280.3399963378906,3.7444958905871397,-96.25550410941285,-6.219854490953139,-4.339792207339445,-0.057680450713231246,610156100.0,-1.0
MSFT,2022-09-16,244.7400054931641,245.3000030517578,242.05999755859372,244.25999450683597,39791800.0,-0.6399993896484091,0.6399993896484091,0.0,24.658975974692254,242.05999755859372,267.45001220703125,10.55536190773838,-89.44463809226161,-6.867629072240447,-4.845359580319646,-0.04420835809326007,570364300.0,-1.0
MSFT,2022-09-19,244.5200042724609,245.13999938964844,240.8500061035156,242.47000122070312,26826900.0,-0.22000122070318184,0.22000122070318184,0.0,24.451959175116784,240.8500061035156,267.45001220703125,13.796982431745603,-86.20301756825441,-7.314431145587321,-5.339173893373181,-0.03447184887478416,543537400.0,-1.0
MSFT,2022-09-20,242.4499969482422,243.50999450683597,239.63999938964844,242.07000732421875,26660300.0,-2.0700073242187216,2.0700073242187216,0.0,22.409482616644482,239.63999938964844,267.45001220703125,10.104265600472303,-89.8957343995277,-7.746263198767252,-5.820591754451996,-0.060599014342162305,516877100.0,-1.0
MSFT,2022-09-21,238.9499969482422,247.66000366210935,238.8999938964844,244.2700042724609,28625600.0,-3.5,3.5,0.0,19.269309195902395,238.8999938964844,267.45001220703125,0.17514192535320416,-99.8248580746468,-8.275518930475044,-6.311577189656607,-0.07570011177895697,488251500.0,-1.0
MSFT,2022-09-22,240.97999572753903,243.8600006103516,237.57000732421875,237.8699951171875,31061200.0,2.0299987792968466,0.0,2.0299987792968466,26.190920860532955,237.57000732421875,267.45001220703125,11.412275254619415,-88.58772474538058,-8.433932846934937,-6.736048321112274,-0.08878468005065887,519312700.0,1.0
MSFT,2022-09-23,237.9199981689453,241.1300048828125,235.1999969482422,239.5399932861328,34176000.0,-3.0599975585937216,3.0599975585937216,0.0,22.792114727602183,235.1999969482422,267.45001220703125,8.434108321737448,-91.56589167826256,-8.706035488756413,-7.1300457546411025,-0.1077442204581196,485136700.0,-1.0
MSFT,2022-09-26,237.4499969482422,241.4499969482422,236.8999938964844,237.0500030517578,27694200.0,-0.470001220703125,0.470001220703125,0.0,22.27971248747663,235.1999969482422,267.45001220703125,6.976740885066124,-93.02325911493388,-8.85750021447032,-7.475536646606946,-0.05770073506076545,457442500.0,-1.0
MSFT,2022-09-27,236.41000366210935,241.8000030517578,234.5,239.97999572753903,27018700.0,-1.039993286132841,1.039993286132841,0.0,21.070294404719633,234.5,267.45001220703125,5.79667057513796,-94.20332942486203,-8.958191413117504,-7.772067599909059,-0.0626833616766157,430423800.0,-1.0
MSFT,2022-09-28,241.07000732421875,242.3300018310547,234.72999572753903,236.80999755859372,29029700.0,4.660003662109403,0.0,4.660003662109403,38.36763502438318,234.5,267.45001220703125,19.939316814021595,-80.0606831859784,-8.56325469356318,-7.930305018639885,-0.017564583392408406,459453500.0,1.0
MSFT,2022-09-29,237.5,239.9499969482422,234.41000366210935,238.88999938964844,27484200.0,-3.57000732421875,3.57000732421875,0.0,32.141293229866505,234.41000366210935,267.45001220703125,9.352286739543146,-90.64771326045685,-8.441031298766688,-8.032450274665246,-0.02958243577127939,431969300.0,-1.0
MSFT,2022-09-30,232.8999938964844,240.5399932861328,232.72999572753903,238.2899932861328,35694800.0,-4.600006103515597,4.600006103515597,0.0,25.893856438938855,232.72999572753903,260.3999938964844,0.6143772323633983,-99.3856227676366,-8.616030193736322,-8.149166258479461,-0.04752171672232053,396274500.0,-1.0
MSFT,2022-10-03,240.7400054931641,241.6100006103516,234.66000366210935,235.41000366210935,28880400.0,7.8400115966796875,0.0,7.8400115966796875,46.387213529813934,232.72999572753903,254.22999572753903,37.25585937500027,-62.74414062499973,-8.029535181299508,-8.12524004304347,-0.007052965463402949,425154900.0,1.0
MSFT,2022-10-04,248.8800048828125,250.3600006103516,244.97999572753903,245.08999633789065,34888400.0,8.139999389648409,0.0,8.139999389648409,59.72883608317389,232.72999572753903,251.3999938964844,86.50246780493256,-13.497532195067445,-6.829181186839435,-7.866028271802664,0.04155684478506694,460043300.0,1.0
MSFT,2022-10-05,249.1999969482422,250.5800018310547,244.1000061035156,245.9900054931641,20347100.0,0.3199920654296875,0.0,0.3199920654296875,60.178328633247474,232.72999572753903,250.5800018310547,92.26888285186244,-7.731117148137562,-5.785381041380987,-7.449898825718329,0.03411072025246864,480390400.0,1.0
MSFT,2022-10-06,246.7899932861328,250.33999633789065,246.0800018310547,247.92999267578125,20239900.0,-2.410003662109375,2.410003662109375,0.0,54.85737205544417,232.72999572753903,250.5800018310547,78.76746639220805,-21.232533607791947,-5.093909640732761,-6.978700988721216,0.03728141890321046,460150500.0,-1.0
MSFT,2022-10-07,234.2400054931641,241.32000732421875,233.1699981689453,240.8999938964844,37769600.0,-12.549987792968722,12.549987792968722,0.0,35.82453118566009,232.72999572753903,250.5800018310547,8.45943557031979,-91.5405644296802,-5.495246918402103,-6.682010174657393,-0.013518599689760324,422380900.0,-1.0
MSFT,2022-10-10,229.25,234.55999755859372,226.72999572753903,233.0500030517578,29743600.0,-4.990005493164091,4.990005493164091,0.0,30.905202526017803,226.72999572753903,250.5800018310547,10.56605294574537,-89.43394705425463,-6.145124176219895,-6.5746329749698935,-0.030286381926303063,392637300.0,-1.0
MSFT,2022-10-11,225.41000366210935,229.05999755859372,224.1100006103516,227.6199951171875,30474000.0,-3.8399963378906534,3.8399963378906534,0.0,27.54651446596553,224.1100006103516,250.5800018310547,4.9112315519690215,-95.08876844803098,-6.890581859000406,-6.637822751775996,-0.06496039816785681,362163300.0,-1.0
MSFT,2022-10-12,225.75,227.8600006103516,223.9600067138672,225.3999938964844,21903900.0,0.3399963378906534,0.0,0.3399963378906534,28.34211197793637,223.9600067138672,250.5800018310547,6.724243480334387,-93.2757565196656,-7.368982536686161,-6.78405470875803,-0.049473684210526336,384067200.0,1.0
MSFT,2022-10-13,234.2400054931641,236.1000061035156,219.1300048828125,219.8500061035156,42551800.0,8.490005493164091,0.0,8.490005493164091,45.564639138001155,219.1300048828125,250.5800018310547,48.04452170605417,-51.95547829394583,-6.982555478020174,-6.82375486261046,0.005753592236139138,426619000.0,1.0
MSFT,2022-10-14,228.55999755859372,237.2400054931641,228.33999633789065,235.5399932861328,30198600.0,-5.680007934570369,5.680007934570369,0.0,38.43387702409953,219.1300048828125,250.5800018310547,29.984081369865716,-70.0159186301343,-7.053331999737367,-6.869670290035842,-0.05059403363233794,396420400.0,-1.0
MSFT,2022-10-17,237.52999877929688,238.9600067138672,235.13999938964844,235.82000732421875,28142300.0,8.970001220703153,0.0,8.970001220703153,52.09485127112259,219.1300048828125,250.5800018310547,58.50555065797166,-41.49444934202834,-6.312848185759009,-6.758305869180475,-0.04560433092590099,424562700.0,1.0
MSFT,2022-10-18,238.5,243.92999267578125,235.3699951171875,243.2400054931641,26329600.0,0.970001220703125,0.0,0.970001220703125,53.38544368342999,219.1300048828125,250.5800018310547,61.58981556998254,-38.410184430017466,-5.58337674482803,-6.523320044309986,-0.04293738795857427,450892300.0,1.0
MSFT,2022-10-19,236.47999572753903,239.6100006103516,234.2899932861328,237.0399932861328,19985700.0,-2.020004272460966,2.020004272460966,0.0,50.13968358118237,219.1300048828125,250.5800018310547,55.1669078800857,-44.83309211991429,-5.109365253071871,-6.240529086062364,-0.04177640033662211,430906600.0,-1.0
MSFT,2022-10-20,236.1499938964844,241.30999755859372,234.8699951171875,235.7700042724609,21811000.0,-0.33000183105463066,0.33000183105463066,0.0,49.57156607911568,219.1300048828125,250.5800018310547,54.117617377457925,-45.88238262254207,-4.706087275933072,-5.933640724036506,0.008153980355742663,409095600.0,-1.0
MSFT,2022-10-21,242.1199951171875,243.0,234.5,234.7400054931641,26299700.0,5.970001220703097,0.0,5.970001220703097,59.21735844791212,219.1300048828125,250.5800018310547,73.10013502452807,-26.89986497547192,-3.8602587089912106,-5.518964321027448,0.056139564306161294,435395300.0,1.0
MSFT,2022-10-24,247.25,247.83999633789065,241.3000030517578,243.75999450683597,24911200.0,5.1300048828125,0.0,5.1300048828125,65.71880058676655,219.1300048828125,250.5800018310547,89.41175785633642,-10.588242143663575,-2.7443497988381864,-4.964041416589596,0.09689009353209066,460306500.0,1.0
MSFT,2022-10-25,250.66000366210935,251.0399932861328,245.8300018310547,247.25999450683597,34775500.0,3.4100036621093466,0.0,3.4100036621093466,69.45369253515504,219.1300048828125,251.0399932861328,98.80918282006041,-1.19081717993958,-1.566764465429344,-4.2845860263575455,0.11034331633271033,495082000.0,1.0
MSFT,2022-10-26,231.32000732421875,238.3000030517578,230.05999755859372,231.1699981689453,82543200.0,-19.339996337890597,19.339996337890597,0.0,40.5457640650667,219.1300048828125,251.0399932861328,38.20121238319801,-61.79878761680199,-2.169091738682283,-3.8614871688224928,-0.01246583888519659,412538800.0,-1.0
MSFT,2022-10-27,226.75,233.69000244140625,225.77999877929688,231.0399932861328,40424600.0,-4.57000732421875,4.57000732421875,0.0,36.41346236169751,219.1300048828125,251.0399932861328,23.87965492458349,-76.12034507541651,-2.9808405656565355,-3.6853578481893017,-0.007919135360201057,372114200.0,-1.0
MSFT,2022-10-28,235.8699951171875,236.6000061035156,226.0500030517578,226.2400054931641,40647700.0,9.1199951171875,0.0,9.1199951171875,48.49949217661375,219.1300048828125,251.0399932861328,52.46003233468165,-47.53996766531835,-2.85533544279059,-3.5193533671095594,-0.00698860636820775,412761900.0,1.0
MSFT,2022-10-31,232.1300048828125,234.9199981689453,231.1499938964844,233.75999450683597,28357300.0,-3.739990234375,3.739990234375,0.0,44.49748622712532,219.1300048828125,251.0399932861328,40.73959487446043,-59.26040512553957,-3.02281258240086,-3.420045210167819,-0.02670857491483225,384404600.0,-1.0
MSFT,2022-11-01,228.1699981689453,235.7400054931641,227.3300018310547,234.6000061035156,30592300.0,-3.9600067138671875,3.9600067138671875,0.0,40.42240688632877,219.1300048828125,251.0399932861328,28.329666472684078,-71.67033352731592,-3.4354768304108063,-3.4231315342164166,-0.03514038273312603,353812300.0,-1.0
MSFT,2022-11-02,220.1000061035156,231.3000030517578,220.0399932861328,229.4600067138672,38407000.0,-8.069992065429716,8.069992065429716,0.0,33.26015008757088,220.0399932861328,251.0399932861328,0.19358973349285188,-99.80641026650716,-4.363398593126277,-3.6111849459983887,-0.06796522637220248,315405300.0,-1.0
MSFT,2022-11-03,214.25,220.41000366210935,213.97999572753903,220.08999633789065,36633900.0,-5.850006103515597,5.850006103515597,0.0,28.9671180758764,213.97999572753903,251.0399932861328,0.7285598765463358,-99.27144012345367,-5.50734463663818,-3.990416884126347,-0.11510819295902541,278771400.0,-1.0
MSFT,2022-11-04,221.38999938964844,221.58999633789065,213.42999267578125,217.5500030517578,36789100.0,7.1399993896484375,0.0,7.1399993896484375,39.89296240685187,213.42999267578125,251.0399932861328,21.16460139507767,-78.83539860492232,-5.771264296208187,-4.346586366542716,-0.10459049791850983,315560500.0,1.0
MSFT,2022-11-07,227.8699951171875,228.41000366210935,221.27999877929688,221.9900054931641,33498000.0,6.4799957275390625,0.0,6.4799957275390625,48.231429147358625,213.42999267578125,251.0399932861328,38.394050005497384,-61.605949994502616,-5.3953468284754535,-4.556338458929264,-0.09092000403719325,349058500.0,1.0
MSFT,2022-11-08,228.8699951171875,231.6499938964844,225.83999633789065,228.6999969482422,28192500.0,1.0,0.0,1.0,49.4793947323456,213.42999267578125,251.0399932861328,41.05291728486873,-58.94708271513127,-4.959567082206519,-4.6369841835847145,-0.010591440988488743,377251000.0,1.0
MSFT,2022-11-09,224.50999450683597,228.6300048828125,224.3300018310547,227.3699951171875,27852900.0,-4.360000610351534,4.360000610351534,0.0,44.12780056497433,213.42999267578125,251.0399932861328,29.460254323965952,-70.53974567603404,-4.909431237582766,-4.691473594384325,-0.009878745284075174,349398100.0,-1.0
MSFT,2022-11-10,242.97999572753903,243.3300018310547,235.0,235.42999267578125,46268000.0,18.470001220703068,0.0,18.470001220703068,63.4505208351391,213.42999267578125,251.0399932861328,78.5695362196421,-21.430463780357904,-3.3408126723361704,-4.421341409974694,0.030143726449051167,395666100.0,1.0
MSFT,2022-11-11,247.1100006103516,247.9900054931641,241.92999267578125,242.9900054931641,34620200.0,4.130004882812557,0.0,4.130004882812557,66.44462017614009,213.42999267578125,251.0399932861328,89.55067106619627,-10.44932893380372,-1.7443069946982348,-3.885934526919402,0.06453278513090766,430286300.0,1.0
MSFT,2022-11-14,241.5500030517578,243.91000366210935,239.2100067138672,241.9900054931641,31123300.0,-5.559997558593778,5.559997558593778,0.0,58.944009407145,213.42999267578125,247.9900054931641,81.3657405874366,-18.6342594125634,-0.9171378844743572,-3.2921751984303937,0.05864050922639463,399163000.0,-1.0
MSFT,2022-11-15,241.97000122070312,247.0,240.02999877929688,245.66000366210935,31390100.0,0.4199981689453125,0.0,0.4199981689453125,59.3440295319979,213.42999267578125,247.9900054931641,82.58101261631174,-17.41898738368827,-0.22511507655428886,-2.678763174055173,0.09936390054847077,430553100.0,1.0
MSFT,2022-11-16,241.72999572753903,243.8000030517578,240.4199981689453,242.7899932861328,24093300.0,-0.24000549316409092,0.24000549316409092,0.0,58.96521824757034,213.42999267578125,247.9900054931641,81.886552534852,-18.113447465148003,0.30048771169538213,-2.082912996905062,0.12826135695467467,406459800.0,-1.0
MSFT,2022-11-17,241.67999267578125,243.25,237.6300048828125,237.77999877929688,23123500.0,-0.05000305175778408,0.05000305175778408,0.0,58.874874291454944,213.42999267578125,247.9900054931641,81.74186783226811,-18.25813216773189,0.7048715591958512,-1.5253560856848791,0.09164819252030543,383336300.0,-1.0
MSFT,2022-11-18,241.22000122070312,243.7400054931641,239.02999877929688,243.50999450683597,27613500.0,-0.459991455078125,0.459991455078125,0.0,57.93270667330968,213.42999267578125,247.9900054931641,80.41087453226922,-19.589125467730785,0.9769693115709117,-1.0248910062337209,0.05858606393812438,355722800.0,-1.0
MSFT,2022-11-21,242.0500030517578,244.6699981689453,241.19000244140625,241.42999267578125,26394700.0,0.8300018310546875,0.0,0.8300018310546875,59.289101308443264,213.42999267578125,247.9900054931641,82.81249931013161,-17.187500689868386,1.245228730164655,-0.5708670589540455,0.05758731251696747,382117500.0,1.0
MSFT,2022-11-22,245.02999877929688,245.30999755859372,240.7100067138672,243.58999633789065,19665700.0,2.9799957275390625,0.0,2.9799957275390625,64.08628475284505,213.42999267578125,247.9900054931641,91.43516893495362,-8.564831065046379,1.6789333044202408,-0.12090698627918814,0.09139906807951093,401783200.0,1.0
MSFT,2022-11-23,247.5800018310547,248.27999877929688,244.2700042724609,245.1100006103516,19508500.0,2.5500030517578125,0.0,2.5500030517578125,67.82920362614327,213.42999267578125,248.27999877929688,97.99140078723954,-2.008599212760461,2.203016239325734,0.3438776588417965,0.018931624760886834,421291700.0,1.0
MSFT,2022-11-25,247.4900054931641,248.6999969482422,246.72999572753903,247.30999755859372,9200800.0,-0.08999633789059658,0.08999633789059658,0.0,67.54254859590675,221.27999877929688,248.6999969482422,95.58719352341723,-4.412806476582773,2.5813377341427213,0.7913696739019817,0.0015377964545097988,412090900.0,-1.0
MSFT,2022-11-28,241.75999450683597,246.6499938964844,240.8000030517578,246.0800018310547,24778200.0,-5.730010986328125,5.730010986328125,0.0,51.540657021608475,224.3300018310547,248.6999969482422,71.52234783784743,-28.477652162152566,2.3912316159687066,1.1113420623153267,0.0008693498340928141,387312700.0,-1.0
MSFT,2022-11-29,240.3300018310547,242.7899932861328,238.2100067138672,241.3999938964844,17956300.0,-1.4299926757812784,1.4299926757812784,0.0,48.249043392480225,224.3300018310547,248.6999969482422,65.65450638402316,-34.34549361597684,2.1009640835367804,1.3092664665596176,-0.0067776971582216294,369356400.0,-1.0
MSFT,2022-11-30,255.13999938964844,255.3300018310547,239.8600006103516,240.57000732421875,47594200.0,14.80999755859375,0.0,14.80999755859375,70.64910845144769,235.0,255.3300018310547,99.06540863603851,-0.9345913639614906,3.0310281971769655,1.6536188126830875,0.055475132996006815,416950600.0,1.0
MSFT,2022-12-01,254.69000244140625,256.1199951171875,250.9199981689453,253.8699951171875,26041500.0,-0.4499969482421875,0.4499969482421875,0.0,69.59302293286275,237.6300048828125,256.1199951171875,92.26612530534099,-7.733874694659009,3.689272082964891,2.0607494667394484,0.0538315547827668,390909100.0,-1.0
MSFT,2022-12-02,255.0200042724609,256.0599975585937,249.69000244140625,249.82000732421875,21528500.0,0.3300018310546591,0.0,0.3300018310546591,69.97282866218463,237.6300048828125,256.1199951171875,94.0508846636296,-5.949115336370392,4.189272172792073,2.4864540079499733,0.0572091989964445,412437600.0,1.0
MSFT,2022-12-05,250.1999969482422,253.82000732421875,248.05999755859372,252.00999450683597,23435300.0,-4.820007324218722,4.820007324218722,0.0,57.80454078180308,237.6300048828125,256.1199951171875,67.98268634052947,-32.01731365947052,4.148767132715676,2.818916632903114,0.03367070354773616,389002300.0,-1.0
MSFT,2022-12-06,245.1199951171875,251.8600006103516,243.77999877929688,250.82000732421875,22463700.0,-5.0800018310546875,5.0800018310546875,0.0,47.71408617297797,237.6300048828125,256.1199951171875,40.50835148874364,-59.49164851125636,3.664510705874079,2.9880354474973077,0.0003672870192996669,366538600.0,-1.0
MSFT,2022-12-07,244.3699951171875,246.16000366210935,242.2100067138672,244.8300018310547,20481500.0,-0.75,0.75,0.0,46.33619645137349,237.6300048828125,256.1199951171875,36.45210272661253,-63.54789727338746,3.1835176568571626,3.027131889369279,-0.01296553312111881,346057100.0,-1.0
MSFT,2022-12-08,247.3999938964844,248.7400054931641,243.05999755859372,244.83999633789065,22611800.0,3.0299987792969034,0.0,3.0299987792969034,52.703117476010455,238.2100067138672,256.1199951171875,51.31207779516761,-48.68792220483239,3.0121011517666716,3.0241257418487577,-0.00036369790570056626,368668900.0,1.0
MSFT,2022-12-09,245.4199981689453,248.30999755859372,244.16000366210935,244.6999969482422,20609700.0,-1.979995727539091,1.979995727539091,0.0,48.375551959930306,238.2100067138672,256.1199951171875,40.256818110175175,-59.743181889824825,2.6855261549630995,2.9564058244716263,0.01513899629909976,348059200.0,-1.0
MSFT,2022-12-12,252.50999450683597,252.5399932861328,247.1699981689453,247.4499969482422,30665100.0,7.089996337890653,0.0,7.089996337890653,61.45310323451536,238.2100067138672,256.1199951171875,79.84364629916634,-20.156353700833666,2.9646420202625166,2.9580530636298046,0.050680283705666795,378724300.0,1.0
MSFT,2022-12-13,256.9200134277344,263.9200134277344,253.07000732421875,261.69000244140625,42196900.0,4.410018920898409,0.0,4.410018920898409,67.38311830715693,238.2100067138672,263.9200134277344,72.77324709439141,-27.2267529056086,3.5013338284148006,3.066709216586804,0.006976616925390422,420921200.0,1.0
MSFT,2022-12-14,257.2200012207031,262.5899963378906,254.30999755859372,257.1300048828125,35410900.0,0.29998779296875,0.0,0.29998779296875,67.77225955802783,238.2100067138672,263.9200134277344,73.94006045351412,-26.05993954648588,3.9058482732334596,3.2345370279161356,0.00993363993499874,456332100.0,1.0
MSFT,2022-12-15,249.00999450683597,254.1999969482422,247.33999633789065,253.72000122070312,35560400.0,-8.210006713867159,8.210006713867159,0.0,49.226282814787275,238.2100067138672,263.9200134277344,42.00694271753572,-57.99305728246428,3.523335142874231,3.292296650907755,-0.023566816974890714,420771700.0,-1.0
MSFT,2022-12-16,244.69000244140625,249.83999633789065,243.50999450683597,248.5500030517578,86102000.0,-4.319992065429716,4.319992065429716,0.0,42.212862151616434,238.2100067138672,263.9200134277344,25.204177500443635,-74.79582249955637,2.838878649277916,3.201613050581788,-0.02202236040784511,334669700.0,-1.0
MSFT,2022-12-19,240.4499969482422,245.2100067138672,238.7100067138672,244.8600006103516,29696400.0,-4.2400054931640625,4.2400054931640625,0.0,36.34815193774697,238.7100067138672,263.9200134277344,6.901982431515534,-93.09801756848447,1.9320376118286333,2.9476979628311577,-0.019051885859873163,304973300.0,-1.0
MSFT,2022-12-20,241.8000030517578,242.91000366210935,238.4199981689453,239.3999938964844,25150800.0,1.350006103515625,0.0,1.350006103515625,39.439232662020395,238.4199981689453,263.9200134277344,13.254913177542187,-86.74508682245782,1.3072248914655518,2.619603348558037,-0.010516806959861236,330124100.0,1.0
MSFT,2022-12-21,244.42999267578125,245.6199951171875,240.1100006103516,241.69000244140625,23690600.0,2.6299896240234375,0.0,2.6299896240234375,45.3994556952143,238.4199981689453,263.9200134277344,23.568591806095014,-76.43140819390499,1.012601848180509,2.2982030484825313,-0.012004855674919046,353814700.0,1.0
MSFT,2022-12-22,238.19000244140625,241.9900054931641,233.8699951171875,241.25999450683597,28651700.0,-6.239990234375,6.239990234375,0.0,35.763602355384776,233.8699951171875,263.9200134277344,14.37605554703614,-85.62394445296387,0.27245520755769803,1.8930534802975647,-0.02945968454682324,325163000.0,-1.0
MSFT,2022-12-23,238.72999572753903,238.8699951171875,233.94000244140625,236.1100006103516,21207000.0,0.5399932861327841,0.0,0.5399932861327841,37.09671010234993,233.8699951171875,263.9200134277344,16.17303710143093,-83.82696289856906,-0.2674602767436909,1.4609507288893135,-0.054572092507506165,346370000.0,1.0
MSFT,2022-12-27,236.9600067138672,238.92999267578125,235.8300018310547,238.6999969482422,16688600.0,-1.7699890136718466,1.7699890136718466,0.0,34.396898401357646,233.8699951171875,263.9200134277344,10.2828942223811,-89.7171057776189,-0.8286187082499907,1.0030368414614528,-0.07768957524004438,329681400.0,-1.0
MSFT,2022-12-28,234.52999877929688,239.72000122070312,234.1699981689453,236.88999938964844,17457100.0,-2.4300079345703125,2.4300079345703125,0.0,30.841277387895772,233.8699951171875,263.9200134277344,2.196350282680955,-97.80364971731905,-1.4526765885895827,0.5118941554512455,-0.0882124342342161,312224300.0,-1.0
MSFT,2022-12-29,241.00999450683597,241.9199981689453,235.6499938964844,235.6499938964844,19770700.0,6.479995727539091,0.0,6.479995727539091,47.5299732703981,233.8699951171875,263.9200134277344,23.760382825265992,-76.23961717473401,-1.4081333702646361,0.12788865030806904,-0.03212722451499983,331995000.0,1.0
MSFT,2022-12-30,239.82000732421875,239.9600067138672,236.66000366210935,238.2100067138672,21938500.0,-1.189987182617216,1.189987182617216,0.0,45.217901496594095,233.8699951171875,263.9200134277344,19.800361336029304,-80.1996386639707,-1.4521154859137937,-0.1881121769363036,-0.01990271391800602,310056500.0,-1.0
MSFT,2023-01-03,239.5800018310547,245.75,237.3999938964844,243.0800018310547,25740000.0,-0.2400054931640625,0.2400054931640625,0.0,44.711748052801404,233.8699951171875,263.9200134277344,19.00167465742643,-80.99832534257358,-1.4891718211515865,-0.4483241057793603,-0.003618195584235262,284316500.0,-1.0
MSFT,2023-01-04,229.1000061035156,232.8699951171875,225.9600067138672,232.27999877929688,50623400.0,-10.479995727539091,10.479995727539091,0.0,28.588536634106987,225.9600067138672,262.5899963378906,8.572209334149168,-91.42779066585082,-2.3372449985785693,-0.8261082843392022,-0.05252273278724384,233693100.0,-1.0
MSFT,2023-01-05,222.30999755859372,227.5500030517578,221.75999450683597,227.1999969482422,39585600.0,-6.790008544921875,6.790008544921875,0.0,22.5181128295971,221.75999450683597,254.1999969482422,1.69544701098954,-98.30455298901046,-3.516707628367527,-1.3642281531448675,-0.09049623933233142,194107500.0,-1.0
MSFT,2023-01-06,224.92999267578125,225.75999450683597,219.3500061035156,223.0,43613600.0,2.6199951171875284,0.0,2.6199951171875284,29.210400623313177,219.3500061035156,249.83999633789065,18.30104414390615,-81.69895585609385,-4.191709136621768,-1.9297243498402479,-0.055669883831026445,237721100.0,1.0
MSFT,2023-01-09,227.1199951171875,231.2400054931641,226.41000366210935,226.4499969482422,27369800.0,2.19000244140625,0.0,2.19000244140625,34.653991849497885,219.3500061035156,245.75,29.431783371384064,-70.56821662861594,-4.498086657601988,-2.443396811392596,-0.048632349592139024,265090900.0,1.0
MSFT,2023-01-10,228.8500061035156,231.30999755859372,227.3300018310547,227.75999450683597,27033900.0,1.7300109863280966,0.0,1.7300109863280966,38.9342127199273,219.3500061035156,245.75,35.984856804323286,-64.01514319567671,-4.5488592046731355,-2.8644892900487045,-0.0342251872913919,292124800.0,1.0
MSFT,2023-01-11,235.7700042724609,235.9499969482422,231.1100006103516,231.2899932861328,28669300.0,6.9199981689453125,0.0,6.9199981689453125,53.10962876023926,219.3500061035156,245.75,62.196977140710274,-37.803022859289726,-3.984776768477701,-3.088546785734504,0.005287193534379897,320794100.0,1.0
MSFT,2023-01-12,238.50999450683597,239.8999938964844,233.55999755859372,235.25999450683597,27269500.0,2.739990234375057,0.0,2.739990234375057,57.60572883280329,219.3500061035156,245.75,72.57573042799771,-27.42426957200229,-3.27884655881914,-3.126606740351432,-0.010373013804326203,348063600.0,1.0
MSFT,2023-01-13,239.22999572753903,239.3699951171875,234.9199981689453,237.0,21333300.0,0.7200012207030682,0.0,0.7200012207030682,58.80342198205906,219.3500061035156,245.75,75.30300840967537,-24.696991590324618,-2.6309655671636563,-3.0274785057138773,-0.002460226747812877,369396900.0,1.0
MSFT,2023-01-17,240.3500061035156,240.91000366210935,237.08999633789065,237.97000122070312,29831300.0,1.1200103759765625,0.0,1.1200103759765625,60.79159548839415,219.3500061035156,245.75,79.54547293587252,-20.454527064127472,-2.004038428983449,-2.822790490367792,0.003213975567976979,399228200.0,1.0
MSFT,2023-01-18,235.80999755859372,242.3800048828125,235.5200042724609,241.57000732421875,30028700.0,-4.540008544921875,4.540008544921875,0.0,49.596523184139976,219.3500061035156,245.75,62.34846689593381,-37.65153310406619,-1.8521840772521898,-2.628669207744672,0.029288482218749134,369199500.0,-1.0
MSFT,2023-01-19,231.92999267578125,235.5200042724609,230.67999267578125,233.77999877929688,28623000.0,-3.8800048828124716,3.8800048828124716,0.0,41.97417120552159,219.3500061035156,245.75,47.651475305609395,-52.348524694390605,-2.0216184182312418,-2.507259049841986,0.043272885712897446,340576500.0,-1.0
MSFT,2023-01-20,240.22000122070312,240.7400054931641,234.50999450683597,234.8600006103516,35389800.0,8.290008544921875,0.0,8.290008544921875,57.918322941103305,219.3500061035156,245.75,79.05303008409678,-20.946969915903225,-1.4700165117881738,-2.299810542231224,0.06797674406614695,375966300.0,1.0
MSFT,2023-01-23,242.5800018310547,245.1699981689453,239.6499938964844,241.1000061035156,31934000.0,2.3600006103515625,0.0,2.3600006103515625,61.40208846306525,219.3500061035156,245.75,87.99242840216166,-12.007571597838325,-0.8328352940991977,-2.0064154926048188,0.06806977389150726,407900300.0,1.0
MSFT,2023-01-24,242.0399932861328,243.9499969482422,240.44000244140625,242.5,40234400.0,-0.540008544921875,0.540008544921875,0.0,60.08872393560297,219.3500061035156,245.1699981689453,87.87759161629158,-12.122408383708418,-0.3672058445748405,-1.678573562998823,0.0576359485725817,367665900.0,-1.0
MSFT,2023-01-25,240.6100006103516,243.3000030517578,230.8999938964844,234.47999572753903,66526600.0,-1.4299926757812216,1.4299926757812216,0.0,56.40250106349437,219.3500061035156,245.1699981689453,82.33927591054885,-17.66072408945115,-0.11228525461578442,-1.3653159013222151,0.020528465242327654,301139300.0,-1.0
MSFT,2023-01-26,248.0,248.30999755859372,242.0,243.6499938964844,33454500.0,7.389999389648409,0.0,7.389999389648409,68.07921552582121,219.3500061035156,248.30999755859372,98.92956612547839,-1.0704338745216158,0.6782340791943682,-0.9566059052188984,0.03978871205286971,334593800.0,1.0
MSFT,2023-01-27,248.16000366210935,249.8300018310547,246.8300018310547,248.9900054931641,26498900.0,0.16000366210934658,0.0,0.16000366210934658,68.29137863517792,226.41000366210935,249.8300018310547,92.86934970319622,-7.130650296803781,1.3026214952059831,-0.504760425133922,0.03732812813632602,361092700.0,1.0
MSFT,2023-01-30,242.7100067138672,245.6000061035156,242.1999969482422,244.50999450683597,25867400.0,-5.449996948242159,5.449996948242159,0.0,54.14697198574968,227.3300018310547,249.8300018310547,68.35557725694444,-31.644422743055557,1.3422116344412416,-0.1353660132188892,0.00981901622808845,335225300.0,-1.0
MSFT,2023-01-31,247.80999755859372,247.9499969482422,242.9499969482422,243.4499969482422,26541100.0,5.099990844726534,0.0,5.099990844726534,62.52720327314434,230.67999267578125,249.8300018310547,89.45167986039992,-10.548320139600072,1.7647705672169707,0.24466130286828291,0.050888427650393586,361766400.0,1.0
MSFT,2023-02-01,252.75,255.17999267578125,245.47000122070312,248.0,31259900.0,4.940002441406278,0.0,4.940002441406278,68.88325981378361,230.67999267578125,255.17999267578125,90.08166254783163,-9.918337452168368,2.4697981814729246,0.6896886785892115,0.08976849903722184,393026300.0,1.0
MSFT,2023-02-02,264.6000061035156,264.69000244140625,257.25,258.82000732421875,39940400.0,11.850006103515625,0.0,11.850006103515625,78.82456338270187,230.67999267578125,264.69000244140625,99.73538279315171,-0.26461720684828255,3.9393240278915016,1.3396157484496698,0.1014903203685078,432966700.0,1.0
MSFT,2023-02-03,258.3500061035156,264.20001220703125,257.1000061035156,259.5400085449219,29077300.0,-6.25,6.25,0.0,65.99357163931973,230.67999267578125,264.69000244140625,81.35844011342019,-18.641559886579806,4.547193861662294,1.9811313710921952,0.06500949853007243,403889400.0,-1.0
MSFT,2023-02-06,256.7699890136719,258.29998779296875,254.77999877929688,257.44000244140625,22518000.0,-1.58001708984375,1.58001708984375,0.0,63.002110118054674,230.67999267578125,264.69000244140625,76.71269875453143,-23.287301245468576,4.84558403352753,2.5540219035792626,0.060857693505740995,381371400.0,-1.0
MSFT,2023-02-07,267.5599975585937,268.7699890136719,260.0799865722656,260.5299987792969,50841400.0,10.790008544921818,0.0,10.790008544921818,72.7391853973709,230.67999267578125,268.7699890136719,96.8233353336542,-3.1766646663458036,5.884886598731612,3.220194842609733,0.11200696928589204,432212800.0,1.0
MSFT,2023-02-08,266.7300109863281,276.760009765625,266.2099914550781,273.20001220703125,54686000.0,-0.8299865722655682,0.8299865722655682,0.0,71.07887494609777,230.8999938964844,276.760009765625,78.12909876019884,-21.87090123980115,6.56588100047739,3.8893320741832653,0.07552423784809736,377526800.0,-1.0
MSFT,2023-02-09,263.6199951171875,273.9800109863281,262.79998779296875,273.79998779296875,42375100.0,-3.110015869140625,3.110015869140625,0.0,64.6943756951746,230.8999938964844,276.760009765625,71.34755756314625,-28.652442436853743,6.776506334215924,4.4667669261897975,0.06229848173329433,335151700.0,-1.0
MSFT,2023-02-10,263.1000061035156,264.0899963378906,260.6600036621094,261.5299987792969,25818500.0,-0.519989013671875,0.519989013671875,0.0,63.59240258224033,230.8999938964844,276.760009765625,70.21369617252738,-29.786303827472615,6.822820434097537,4.937977627771346,0.08400971869975837,309333200.0,-1.0
MSFT,2023-02-13,271.32000732421875,274.6000061035156,267.1499938964844,267.6400146484375,44630900.0,8.220001220703125,0.0,8.220001220703125,72.22261448251952,230.8999938964844,276.760009765625,88.1378095094231,-11.862190490576893,7.43708006347282,5.437798114911641,0.0948711109206406,353964100.0,1.0
MSFT,2023-02-14,272.1700134277344,274.9700012207031,269.2799987792969,272.6700134277344,37047900.0,0.850006103515625,0.0,0.850006103515625,72.98663700693277,242.0,276.760009765625,86.7951811036895,-13.204818896310499,7.901391313395152,5.930516754608344,0.07683487013940415,391012000.0,1.0
MSFT,2023-02-15,269.32000732421875,270.7300109863281,266.17999267578125,268.32000732421875,28922400.0,-2.850006103515625,2.850006103515625,0.0,65.96702150767388,242.1999969482422,276.760009765625,78.47222314204664,-21.527776857953356,7.947772674012356,6.333967938489147,0.0178382506115915,362089600.0,-1.0
MSFT,2023-02-16,262.1499938964844,266.739990234375,261.8999938964844,264.0199890136719,29603600.0,-7.170013427734375,7.170013427734375,0.0,51.569571492712406,242.1999969482422,276.760009765625,57.72566420521651,-42.27433579478349,7.321571555770532,6.531488661945425,0.014708680871662771,332486000.0,-1.0
MSFT,2023-02-17,258.0599975585937,260.0899963378906,256.0,259.3900146484375,30000100.0,-4.089996337890682,4.089996337890682,0.0,45.09204115840714,242.9499969482422,276.760009765625,44.69090470910135,-55.30909529089865,6.421253917022597,6.509441712960861,0.005023984889656052,302485900.0,-1.0
MSFT,2023-02-21,252.6699981689453,255.4900054931641,251.58999633789065,254.47999572753903,28397400.0,-5.389999389648381,5.389999389648381,0.0,37.86070804462758,245.47000122070312,276.760009765625,23.010530463439874,-76.98946953656012,5.2127287055299405,6.250099111474678,-0.05565106714574397,274088500.0,-1.0
MSFT,2023-02-22,251.50999450683597,254.33999633789065,250.33999633789065,254.08999633789065,22491100.0,-1.1600036621093466,1.1600036621093466,0.0,36.41071399661878,250.33999633789065,276.760009765625,4.428454104103936,-95.57154589589607,4.113938248203283,5.8228669388203995,-0.05706150733924087,251597400.0,-1.0
MSFT,2023-02-23,254.7700042724609,256.8399963378906,250.47999572753903,255.55999755859372,29219100.0,3.260009765624943,0.0,3.260009765624943,43.43543941354626,250.33999633789065,276.760009765625,16.767621813242023,-83.23237818675798,3.4662378056957266,5.3515411121954655,-0.033571015130291926,280816500.0,1.0
MSFT,2023-02-24,249.22000122070312,251.0,248.1000061035156,249.9600067138672,24990900.0,-5.550003051757784,5.550003051757784,0.0,35.69046718200157,248.1000061035156,276.760009765625,3.907868018412862,-96.09213198158713,2.476543622329359,4.7765416142222445,-0.05275562356829244,255825600.0,-1.0
MSFT,2023-02-27,250.16000366210935,252.82000732421875,249.38999938964844,252.4600067138672,21190000.0,0.9400024414062216,0.0,0.9400024414062216,37.85596986660064,248.1000061035156,276.760009765625,7.187708637027201,-92.8122913629728,1.7479054270140182,4.1708143767806,-0.07798910176507501,277015600.0,1.0
MSFT,2023-02-28,249.4199981689453,251.4900054931641,248.72999572753903,249.07000732421875,22491000.0,-0.7400054931640341,0.7400054931640341,0.0,36.732433983460645,248.1000061035156,276.760009765625,4.605693987313899,-95.3943060126861,1.0980841186710677,3.556268325158693,-0.08358751565711908,254524600.0,-1.0
MSFT,2023-03-01,246.2700042724609,250.92999267578125,245.7899932861328,250.75999450683597,27565300.0,-3.1499938964844034,3.1499938964844034,0.0,32.05910232535432,245.7899932861328,274.9700012207031,1.6449995058411726,-98.35500049415883,0.32516951647576775,2.910048563422108,-0.08558592909887042,226959300.0,-1.0
MSFT,2023-03-02,251.1100006103516,251.3999938964844,245.6100006103516,246.5500030517578,24808200.0,4.839996337890682,0.0,4.839996337890682,44.56333907544584,245.6100006103516,274.9700012207031,18.73296963781687,-81.26703036218314,0.10200058140833335,2.348438967019353,-0.04211326928541592,251767500.0,1.0
MSFT,2023-03-03,255.2899932861328,255.6199951171875,251.38999938964844,252.19000244140625,30760100.0,4.179992675781222,0.0,4.179992675781222,53.1548397841073,245.6100006103516,274.9700012207031,32.970001616308956,-67.02999838369104,0.2594374345499375,1.9306386605254697,-0.01073395450153769,282527600.0,1.0
MSFT,2023-03-06,256.8699951171875,260.1199951171875,255.97999572753903,256.42999267578125,24109800.0,1.5800018310546875,0.0,1.5800018310546875,56.12077007688609,245.6100006103516,274.9700012207031,38.35147913064396,-61.64852086935604,0.5058688765592478,1.6456847037322253,0.016622460041472387,306637400.0,1.0
MSFT,2023-03-07,254.1499938964844,257.69000244140625,253.38999938964844,256.29998779296875,21473200.0,-2.7200012207030966,2.7200012207030966,0.0,49.85128357624186,245.6100006103516,270.7300109863281,33.99677451686093,-66.00322548313908,0.47619690182031604,1.4117871433498437,0.010496598335286711,285164200.0,-1.0
MSFT,2023-03-08,253.6999969482422,254.5399932861328,250.80999755859372,254.0399932861328,17340200.0,-0.4499969482422159,0.4499969482422159,0.0,48.81038372110005,245.6100006103516,266.739990234375,38.28679749417767,-61.71320250582233,0.41162569039221353,1.2117548527583177,-0.004199895224221151,267824000.0,-1.0
MSFT,2023-03-09,252.32000732421875,259.5599975585937,251.5800018310547,255.82000732421875,26653400.0,-1.3799896240234375,1.3799896240234375,0.0,45.452220022773645,245.6100006103516,260.1199951171875,46.244033453671946,-53.75596654632806,0.2462601764977137,1.0186559175061969,0.012438833513889413,241170600.0,-1.0
MSFT,2023-03-10,248.58999633789065,252.7899932861328,247.6000061035156,251.0800018310547,28333900.0,-3.7300109863280966,3.7300109863280966,0.0,37.42243558018277,245.6100006103516,260.1199951171875,20.53753863335465,-79.46246136664536,-0.18365681679048862,0.7781933706468597,-0.0062760125569045755,212836700.0,-1.0
MSFT,2023-03-13,253.9199981689453,257.9100036621094,245.72999572753903,247.3999938964844,33339700.0,5.330001831054659,0.0,5.330001831054659,51.538428549277,245.6100006103516,260.1199951171875,57.27085254704085,-42.72914745295914,-0.0932080835071929,0.6039130798160492,0.01804185724094154,246176400.0,1.0
MSFT,2023-03-14,260.7900085449219,261.07000732421875,255.8600006103516,256.75,33620300.0,6.8700103759765625,0.0,6.8700103759765625,63.712330431866306,245.6100006103516,261.07000732421875,98.1888831972775,-1.8111168027225018,0.5267535247955948,0.5884811688119583,0.058959694727567236,279796700.0,1.0
MSFT,2023-03-15,265.44000244140625,266.4800109863281,259.2099914550781,259.9800109863281,46028000.0,4.649993896484375,0.0,4.649993896484375,69.66393933916342,245.6100006103516,266.4800109863281,95.01673201792448,-4.983267982075508,1.3774152264641089,0.7462679803423885,0.057066631341738505,325824700.0,1.0
MSFT,2023-03-16,276.20001220703125,276.5599975585937,263.2799987792969,265.2099914550781,54768800.0,10.760009765625,0.0,10.760009765625,78.90265056169245,245.6100006103516,276.5599975585937,98.83688081726002,-1.1631191827399827,2.886539387405662,1.1743222617550433,0.08190692730154203,380593500.0,1.0
MSFT,2023-03-17,279.42999267578125,283.3299865722656,276.32000732421875,278.260009765625,69527400.0,3.22998046875,0.0,3.22998046875,80.91573832352218,245.6100006103516,283.3299865722656,89.66066980930955,-10.339330190690443,4.293668845623074,1.7981915785286495,0.08782651920206397,450120900.0,1.0
MSFT,2023-03-20,272.2300109863281,277.4800109863281,269.8500061035156,276.9800109863281,43466600.0,-7.199981689453125,7.199981689453125,0.0,64.97051741734674,245.6100006103516,283.3299865722656,70.57269428163315,-29.427305718366846,4.772832487567769,2.393119760336474,0.07113916003951481,406654300.0,-1.0
MSFT,2023-03-21,273.7799987792969,275.0,269.5199890136719,274.8800048828125,34558700.0,1.54998779296875,0.0,1.54998779296875,66.60515601936655,245.6100006103516,283.3299865722656,74.68188932357664,-25.318110676423363,5.217500093800425,2.957995827029264,0.07914860887897945,441213000.0,1.0
MSFT,2023-03-22,272.2900085449219,281.0400085449219,272.17999267578125,273.3999938964844,34873300.0,-1.489990234375,1.489990234375,0.0,63.32735613216031,245.72999572753903,283.3299865722656,70.63834916094905,-29.361650839050963,5.387568084616021,3.443910278546616,0.07914553202688634,406339700.0,-1.0
MSFT,2023-03-23,277.6600036621094,281.0599975585937,275.20001220703125,277.94000244140625,36610900.0,5.3699951171875,0.0,5.3699951171875,69.55744284816954,245.72999572753903,283.3299865722656,84.92025454588251,-15.079745454117488,5.887791128539334,3.9326864485451596,0.11693957018570433,442950600.0,1.0
MSFT,2023-03-24,280.57000732421875,280.6300048828125,275.2799987792969,277.239990234375,28172000.0,2.910003662109375,0.0,2.910003662109375,72.48063783869051,245.72999572753903,283.3299865722656,92.65962787213294,-7.340372127867055,6.444743479262399,4.435097854688609,0.10495435313268198,471122600.0,1.0
MSFT,2023-03-27,276.3800048828125,281.4599914550781,275.5199890136719,280.5,26840200.0,-4.19000244140625,4.19000244140625,0.0,62.50857708154427,245.72999572753903,283.3299865722656,81.51600164437842,-18.483998355621573,6.473412579468743,4.842760799644636,0.059779883534936795,444282400.0,-1.0
MSFT,2023-03-28,275.2300109863281,276.1400146484375,272.04998779296875,275.7900085449219,21878600.0,-1.149993896484375,1.149993896484375,0.0,59.89876093265241,245.72999572753903,283.3299865722656,78.45750649411787,-21.542493505882128,6.330365636839986,5.140281767083707,0.03688218977877278,422403800.0,-1.0
MSFT,2023-03-29,280.510009765625,281.1400146484375,278.4100036621094,278.9599914550781,25087000.0,5.279998779296875,0.0,5.279998779296875,67.16203908788209,245.72999572753903,283.3299865722656,92.50005985829614,-7.499940141703858,6.567347386270285,5.425694890921023,0.015604624794017363,447490800.0,1.0
MSFT,2023-03-30,284.04998779296875,284.4599914550781,281.4800109863281,284.2300109863281,25053400.0,3.53997802734375,0.0,3.53997802734375,71.19771659905285,245.72999572753903,284.4599914550781,98.94137953178796,-1.0586204682120337,6.9605666920078875,5.732669251138397,0.016533640762564916,472544200.0,1.0
MSFT,2023-03-31,288.29998779296875,289.2699890136719,283.0,283.7300109863281,32766000.0,4.25,0.0,4.25,75.38783554766486,255.8600006103516,289.2699890136719,97.09667297996809,-2.9033270200319086,7.528353137334932,6.091806028377705,0.05903087888222469,505310200.0,1.0
MSFT,2023-04-03,287.2300109863281,288.2699890136719,283.95001220703125,286.5199890136719,24883300.0,-1.069976806640625,1.069976806640625,0.0,72.3311001666731,259.2099914550781,289.2699890136719,93.21364539911431,-6.78635460088568,7.8020525941146275,6.433855341525091,0.049127081112575244,480426900.0,-1.0
MSFT,2023-04-04,287.17999267578125,290.45001220703125,285.6700134277344,287.2300109863281,25824300.0,-0.050018310546875,0.050018310546875,0.0,72.17325350032716,263.2799987792969,290.45001220703125,87.96460097471996,-12.035399025280045,7.923587145518184,6.73180170232371,0.05468428390167257,454602600.0,-1.0
MSFT,2023-04-05,284.3399963378906,287.1499938964844,282.9200134277344,285.8500061035156,22064800.0,-2.839996337890625,2.839996337890625,0.0,63.14532311731028,269.5199890136719,290.45001220703125,70.80740994554084,-29.19259005445916,7.70195681957216,6.9258327257734,0.024058173981407416,432537800.0,-1.0
MSFT,2023-04-06,291.6000061035156,292.0799865722656,282.0299987792969,283.2099914550781,29770300.0,7.260009765625,0.0,7.260009765625,73.07833851724794,269.5199890136719,292.0799865722656,97.87242676997914,-2.1275732300208587,8.019689316791755,7.144604043977071,0.03931282208133857,462308100.0,1.0
MSFT,2023-04-10,289.3900146484375,289.6000061035156,284.7099914550781,289.2099914550781,23103000.0,-2.209991455078125,2.209991455078125,0.0,66.75862780679722,269.5199890136719,292.0799865722656,88.07636429551191,-11.923635704488087,8.00093694848988,7.315870624879634,0.04707290518770102,439205100.0,-1.0
MSFT,2023-04-11,282.8299865722656,285.9800109863281,281.6400146484375,285.75,27276600.0,-6.560028076171875,6.560028076171875,0.0,51.503704957237275,272.04998779296875,292.0799865722656,53.81926827893342,-46.18073172106658,7.371759070399264,7.3270483139835605,0.027613179095919982,411928500.0,-1.0
MSFT,2023-04-12,283.489990234375,287.010009765625,281.9599914550781,284.7900085449219,27403400.0,0.660003662109375,0.0,0.660003662109375,52.75693060472888,272.04998779296875,292.0799865722656,57.11434417674904,-42.88565582325095,6.847454653825309,7.23112958195191,0.010623437185859563,439331900.0,1.0
MSFT,2023-04-13,289.8399963378906,289.8999938964844,283.1700134277344,283.5899963378906,24222700.0,6.350006103515625,0.0,6.350006103515625,63.288602760216136,272.04998779296875,292.0799865722656,88.81682291119125,-11.183177088808748,6.865194362444413,7.157942538050412,0.020383766216325094,463554600.0,1.0
MSFT,2023-04-14,286.1400146484375,288.4800109863281,283.69000244140625,287.0,20987900.0,-3.699981689453125,3.699981689453125,0.0,55.03949454355927,272.04998779296875,292.0799865722656,70.34462163838116,-29.65537836161885,6.505701926876839,7.027494415815698,-0.0074921027956558195,442566700.0,-1.0
MSFT,2023-04-17,288.79998779296875,291.6000061035156,286.1600036621094,289.92999267578125,23836200.0,2.65997314453125,0.0,2.65997314453125,59.426330225472086,272.04998779296875,292.0799865722656,83.6245682516611,-16.375431748338904,6.362100845846328,6.894415701821824,0.005465921897400028,466402900.0,1.0
MSFT,2023-04-18,288.3699951171875,291.760009765625,287.010009765625,291.57000732421875,20161800.0,-0.42999267578125,0.42999267578125,0.0,58.364150364523745,278.4100036621094,292.0799865722656,72.8603065602829,-27.139693439717107,6.1427888926023115,6.744090339977921,0.004143751207451807,446241100.0,-1.0
MSFT,2023-04-19,288.45001220703125,289.04998779296875,284.5400085449219,285.989990234375,17150300.0,0.08001708984375,0.0,0.08001708984375,58.52333187214908,281.4800109863281,292.0799865722656,65.75487994472276,-34.24512005527725,5.907343125659622,6.576740897114262,0.014454582267971139,463391400.0,1.0
MSFT,2023-04-20,286.1099853515625,289.0299987792969,285.0799865722656,285.25,23244400.0,-2.34002685546875,2.34002685546875,0.0,51.83613934578395,281.6400146484375,292.0799865722656,42.81592647699337,-57.18407352300663,5.468888110374678,6.355170339766346,-0.018827231265572064,440147000.0,-1.0
MSFT,2023-04-21,285.760009765625,286.2699890136719,283.0599975585937,285.010009765625,21676400.0,-0.3499755859375,0.3499755859375,0.0,50.83376062807263,281.6400146484375,292.0799865722656,39.46366089150153,-60.536339108498474,5.035127432166405,6.091161758246359,-0.012543642486152695,418470600.0,-1.0
MSFT,2023-04-24,281.7699890136719,284.95001220703125,278.7200012207031,282.0899963378906,26611000.0,-3.990020751953125,3.990020751953125,0.0,40.5249797777393,278.7200012207031,292.0799865722656,22.8292749782996,-77.17072502170039,4.319613821651785,5.7368521709274445,-0.0037478259340189,391859600.0,-1.0
MSFT,2023-04-25,275.4200134277344,281.6000061035156,275.3699951171875,279.510009765625,45772200.0,-6.3499755859375,6.3499755859375,0.0,29.528729111205607,275.3699951171875,292.0799865722656,0.2993317541863527,-99.70066824581365,3.2032491077362124,5.230131558289198,-0.02846653174586089,346087400.0,-1.0
MSFT,2023-04-26,295.3699951171875,299.57000732421875,292.7300109863281,296.70001220703125,64599200.0,19.949981689453125,0.0,19.949981689453125,64.47392200405581,275.3699951171875,299.57000732421875,82.64458641136162,-17.35541358863839,3.883551656303041,4.960815577891967,0.019079488163014302,410686600.0,1.0
MSFT,2023-04-27,304.8299865722656,305.20001220703125,295.25,295.9700012207031,46462600.0,9.459991455078125,0.0,9.459991455078125,72.0556129303278,275.3699951171875,305.20001220703125,98.75955272284571,-1.240447277154286,5.126938422607452,4.994040146835065,0.06531757519755255,457149200.0,1.0
MSFT,2023-04-28,307.260009765625,308.92999267578125,303.3099975585937,304.010009765625,36446700.0,2.430023193359375,0.0,2.430023193359375,73.71804554611997,275.3699951171875,308.92999267578125,95.02388846351803,-4.976111536481967,6.2365231988392225,5.2425367572358965,0.06391974637439946,493595900.0,1.0
MSFT,2023-05-01,305.5599975585937,308.6000061035156,305.1499938964844,306.9700012207031,21294100.0,-1.7000122070313068,1.7000122070313068,0.0,70.34017920556528,275.3699951171875,308.92999267578125,89.95829749002887,-10.041702509971124,6.899171001891887,5.573863606167095,0.05961092600643325,472301800.0,-1.0
MSFT,2023-05-02,305.4100036621094,309.17999267578125,303.9100036621094,307.760009765625,26404400.0,-0.14999389648431816,0.14999389648431816,0.0,70.01357606007714,275.3699951171875,309.17999267578125,88.84948451374962,-11.150515486250391,7.327751152120868,5.924641115357851,0.05879698643557463,445897400.0,-1.0
MSFT,2023-05-03,304.3999938964844,308.6099853515625,304.0899963378906,306.6199951171875,22360800.0,-1.010009765625,1.010009765625,0.0,67.5757232123791,275.3699951171875,309.17999267578125,85.86217354493152,-14.137826455068481,7.4994556058729245,6.239604013460866,0.06392649498914804,423536600.0,-1.0
MSFT,2023-05-04,305.4100036621094,307.760009765625,303.3999938964844,306.239990234375,22519900.0,1.010009765625,0.0,1.010009765625,68.82810387703398,275.3699951171875,309.17999267578125,88.84948451374962,-11.150515486250391,7.629088585348256,6.517500927838345,0.06876397405151602,446056500.0,1.0
MSFT,2023-05-05,310.6499938964844,311.9700012207031,304.2699890136719,305.7200012207031,28181200.0,5.239990234375,0.0,5.239990234375,74.68203559379336,275.3699951171875,311.9700012207031,96.39342321286675,-3.6065767871332572,8.061716624028634,6.826344067076404,0.10249496400914149,474237700.0,1.0
MSFT,2023-05-08,308.6499938964844,310.20001220703125,306.0899963378906,310.1300048828125,21318600.0,-2.0,2.0,0.0,68.97726934035168,275.3699951171875,311.9700012207031,90.92894324982136,-9.071056750178645,8.149254641524294,7.090926181965983,0.12065201818555926,452919100.0,-1.0
MSFT,2023-05-09,307.0,310.0400085449219,306.3099975585937,308.0,21340800.0,-1.649993896484375,1.649993896484375,0.0,64.30160055061224,275.3699951171875,311.9700012207031,86.42076395657833,-13.57923604342167,7.993346114868075,7.271410168546401,0.03937436122514182,431578300.0,-1.0
MSFT,2023-05-10,312.3099975585937,313.0,307.6700134277344,308.6199951171875,30078000.0,5.309997558593693,0.0,5.309997558593693,71.48025792767412,275.3699951171875,313.0,98.16635038035442,-1.8336496196455858,8.203692845211947,7.457866703879511,0.02453830435266191,461656300.0,1.0
MSFT,2023-05-11,310.1099853515625,311.1199951171875,306.260009765625,310.1000061035156,31680200.0,-2.200012207031193,2.200012207031193,0.0,65.21129131163433,275.3699951171875,313.0,92.31991954973805,-7.680080450261951,8.099505488137424,7.586194460731094,0.009275452370490544,429976100.0,-1.0
MSFT,2023-05-12,308.9700012207031,310.6499938964844,306.6000061035156,310.54998779296875,19758100.0,-1.139984130859375,1.139984130859375,0.0,61.9622257290673,275.3699951171875,313.0,89.2904643731854,-10.70953562681459,7.834636255054477,7.635882819595771,0.011159849749166062,410218000.0,-1.0
MSFT,2023-05-15,309.4599914550781,309.8999938964844,307.5899963378906,309.1000061035156,16336500.0,0.489990234375,0.0,0.489990234375,62.87947281034471,292.7300109863281,313.0,82.53571552241998,-17.46428447758003,7.576921561164056,7.624090567909428,0.013260822318870158,426554500.0,1.0
MSFT,2023-05-16,311.739990234375,313.7099914550781,309.8299865722656,309.8299865722656,26730300.0,2.279998779296875,0.0,2.279998779296875,67.13453680239755,295.25,313.7099914550781,89.32826580393025,-10.671734196069744,7.470541899499665,7.593380834227475,0.02411299765132946,453284800.0,1.0
MSFT,2023-05-17,314.0,314.42999267578125,310.739990234375,312.2900085449219,24315000.0,2.260009765625,0.0,2.260009765625,70.94390394062016,303.3099975585937,314.42999267578125,96.13315769251882,-3.866842307481181,7.482347309419254,7.571174129265832,0.028126113208112757,477599800.0,1.0
MSFT,2023-05-18,318.5199890136719,319.0400085449219,313.7200012207031,314.5299987792969,27276000.0,4.519989013671875,0.0,4.519989013671875,77.07566017613556,303.3999938964844,319.0400085449219,96.67507004987395,-3.3249299501260507,7.76689657116583,7.610318617645832,0.02533396192439641,504875800.0,1.0
MSFT,2023-05-19,318.3399963378906,318.75,316.3699951171875,316.739990234375,27529500.0,-0.17999267578125,0.17999267578125,0.0,76.33547667313354,303.3999938964844,319.0400085449219,95.52422281713666,-4.475777182863342,7.886963995022654,7.665647693121197,0.03139479226640152,477346300.0,-1.0
MSFT,2023-05-22,321.17999267578125,322.5899963378906,318.010009765625,318.6000061035156,24115700.0,2.839996337890625,0.0,2.839996337890625,79.85718349180141,303.3999938964844,322.5899963378906,92.65240498840683,-7.347595011593179,8.11770639685028,7.756059433867014,0.046188901224043066,501462000.0,1.0
MSFT,2023-05-23,315.260009765625,322.7200012207031,315.25,320.0299987792969,30797200.0,-5.91998291015625,5.91998291015625,0.0,58.80774398789514,303.3999938964844,322.7200012207031,61.38722242756817,-38.61277757243183,7.7337286573369965,7.751593278561012,0.009445782171855877,470664800.0,-1.0
MSFT,2023-05-24,313.8500061035156,316.5,312.6099853515625,314.7300109863281,23384900.0,-1.410003662109375,1.410003662109375,0.0,54.835498865524265,304.2699890136719,322.7200012207031,51.92417751459715,-48.075822485402846,7.232278812509151,7.647730385350641,0.01206030417792947,447279900.0,-1.0
MSFT,2023-05-25,325.9200134277344,326.8999938964844,320.0,323.239990234375,43301700.0,12.07000732421875,0.0,12.07000732421875,72.90948593647323,306.0899963378906,326.8999938964844,95.29081891532802,-4.70918108467199,7.719835457809495,7.662151399842412,0.0548597344080779,490581600.0,1.0
MSFT,2023-05-26,332.8900146484375,333.3999938964844,323.8800048828125,324.0199890136719,36630600.0,6.970001220703125,0.0,6.970001220703125,78.61235026713807,306.260009765625,333.3999938964844,98.1209301907181,-1.879069809281892,8.569860443011862,7.843693208476303,0.07571260854494177,527212200.0,1.0
MSFT,2023-05-30,331.2099914550781,335.739990234375,330.5199890136719,335.2300109863281,29503100.0,-1.680023193359375,1.680023193359375,0.0,74.26437888540147,306.260009765625,335.739990234375,84.63364389233955,-15.366356107660456,9.004153262796933,8.075785219340428,0.062455898603400284,497709100.0,-1.0
MSFT,2023-05-31,328.3900146484375,335.94000244140625,327.3299865722656,332.2900085449219,45950600.0,-2.819976806640625,2.819976806640625,0.0,67.07883608601125,306.260009765625,335.94000244140625,74.56202946057495,-25.43797053942506,9.016844322066902,8.263997039885723,0.045828072128781816,451758500.0,-1.0
MSFT,2023-06-01,332.5799865722656,333.5299987792969,324.7200012207031,325.92999267578125,26773900.0,4.189971923828125,0.0,4.189971923828125,71.76280554963374,306.6000061035156,335.94000244140625,88.54800174326746,-11.451998256732539,9.258274173571635,8.462852466622905,0.04414164901277284,478532400.0,1.0
MSFT,2023-06-02,335.3999938964844,337.5,332.54998779296875,334.25,25864000.0,2.82000732421875,0.0,2.82000732421875,74.57232798858297,307.5899963378906,337.5,92.9789172638051,-7.021082736194904,9.566879066869774,8.68365778667228,0.05359049366981217,504396400.0,1.0
MSFT,2023-06-05,335.94000244140625,338.5599975585937,334.6600036621094,335.2200012207031,21307100.0,0.540008544921875,0.0,0.540008544921875,75.11930832303852,309.8299865722656,338.5599975585937,90.88063308282675,-9.119366917173254,9.74271686928381,8.895469603194586,0.04595557040355458,525703500.0,1.0
MSFT,2023-06-06,333.67999267578125,335.3699951171875,332.1700134277344,335.3299865722656,20396200.0,-2.260009765625,2.260009765625,0.0,68.05038473756986,310.739990234375,338.5599975585937,82.45864989918907,-17.541350100810927,9.589167737515254,9.03420923005872,0.05842790820139321,505307300.0,-1.0
MSFT,2023-06-07,323.3800048828125,334.489990234375,322.5,331.6499938964844,40717100.0,-10.29998779296875,10.29998779296875,0.0,45.523135122438205,312.6099853515625,338.5599975585937,41.5029459151154,-58.4970540848846,8.537935998513717,8.93495458374972,0.03036481948053127,464590200.0,-1.0
MSFT,2023-06-08,325.260009765625,326.6400146484375,323.3500061035156,323.94000244140625,23277700.0,1.8800048828125,0.0,1.8800048828125,49.0736421591665,312.6099853515625,338.5599975585937,48.74766267213916,-51.25233732786084,7.766994871731015,8.701362641345979,-0.0020250479716420466,487867900.0,1.0
MSFT,2023-06-09,326.7900085449219,329.989990234375,324.4100036621094,324.989990234375,22514900.0,1.529998779296875,0.0,1.529998779296875,52.01063755449305,312.6099853515625,338.5599975585937,54.64360895181882,-45.35639104818118,7.196519591013498,8.400394031279482,-0.01832438894256949,510382800.0,1.0
MSFT,2023-06-12,331.8500061035156,332.1000061035156,325.1600036621094,328.5799865722656,24260300.0,5.05999755859375,0.0,5.05999755859375,60.6668271249465,312.6099853515625,338.5599975585937,74.14262698011377,-25.857373019886236,7.071200933119485,8.134555411647483,0.001932353083992977,534643100.0,1.0
MSFT,2023-06-13,334.2900085449219,336.9800109863281,330.3900146484375,334.4700012207031,22951300.0,2.44000244140625,0.0,2.44000244140625,64.25433617776167,312.6099853515625,338.5599975585937,83.54532946032735,-16.45467053967265,7.087077382424582,7.925059805802903,0.017966422952295558,557594400.0,1.0
MSFT,2023-06-14,337.3399963378906,339.0400085449219,332.8099975585937,334.3399963378906,26003800.0,3.04998779296875,0.0,3.04998779296875,68.40999146072126,320.0,339.0400085449219,91.0713684659314,-8.928631534068597,7.262055650892705,7.792458974820863,0.014312375842828073,583598200.0,1.0
MSFT,2023-06-15,348.1000061035156,349.8399963378906,337.20001220703125,337.4800109863281,38899100.0,10.760009765625,0.0,10.760009765625,78.55741456000018,322.5,349.8399963378906,93.6357334768054,-6.3642665231945905,8.174736775287784,7.868914534914248,0.03786527262415773,622497300.0,1.0
MSFT,2023-06-16,342.3299865722656,351.4700012207031,341.95001220703125,351.32000732421875,46533600.0,-5.77001953125,5.77001953125,0.0,65.5324899175302,322.5,351.4700012207031,68.45007157988768,-31.549928420112316,8.336354482502884,7.962402524431977,0.019021206419065573,575963700.0,-1.0
MSFT,2023-06-20,338.04998779296875,342.0799865722656,335.8599853515625,339.3099975585937,26375400.0,-4.279998779296875,4.279998779296875,0.0,57.38866499885352,322.5,351.4700012207031,53.67617237743195,-46.32382762256805,8.026552447556526,7.975232509056887,0.01309636541928838,549588300.0,-1.0
MSFT,2023-06-21,333.5599975585937,337.7300109863281,332.07000732421875,336.3699951171875,25117800.0,-4.489990234375057,4.489990234375057,0.0,49.88473030710567,322.5,351.4700012207031,38.17741488629892,-61.82258511370108,7.334183513188975,7.847022709883305,0.03147996945411102,524470500.0,-1.0
MSFT,2023-06-22,339.7099914550781,340.1199951171875,333.3399963378906,334.1199951171875,23556800.0,6.149993896484432,0.0,6.149993896484432,58.46751201139166,322.5,351.4700012207031,59.40625036211312,-40.59374963788688,7.198746584692572,7.717367484845158,0.04442594003445266,548027300.0,1.0
MSFT,2023-06-23,335.0199890136719,337.9599914550781,333.45001220703125,334.3599853515625,23084700.0,-4.69000244140625,4.69000244140625,0.0,50.81052411772184,322.5,351.4700012207031,43.217081415670044,-56.782918584329956,6.636466784024037,7.501187344680934,0.025184308741246886,524942600.0,-1.0
MSFT,2023-06-26,328.6000061035156,336.1099853515625,328.489990234375,333.7200012207031,21520600.0,-6.41998291015625,6.41998291015625,0.0,42.1018301097091,322.5,351.4700012207031,21.056285282985478,-78.94371471701453,5.608169536718265,7.122583783088402,-0.009793581257269035,503422000.0,-1.0
MSFT,2023-06-27,334.57000732421875,336.1499938964844,329.29998779296875,331.8599853515625,24354100.0,5.970001220703125,0.0,5.970001220703125,51.095494601637355,322.5,351.4700012207031,41.663813654219105,-58.336186345780895,5.214852194905518,6.741037465451824,0.0008375924261561085,527776100.0,1.0
MSFT,2023-06-28,335.8500061035156,337.9800109863281,333.8099975585937,334.6600036621094,20259500.0,1.279998779296875,0.0,1.279998779296875,52.905280110114134,323.3500061035156,351.4700012207031,44.452354802720976,-55.547645197279024,4.949377232062773,6.382705418774014,-0.004416879855783762,548035600.0,1.0
MSFT,2023-06-29,335.04998779296875,336.1099853515625,332.6199951171875,334.7099914550781,16997000.0,-0.800018310546875,0.800018310546875,0.0,51.53004474092649,324.4100036621094,351.4700012207031,39.31997446718289,-60.68002553281712,4.621161743728464,6.030396683764905,-0.03748927917762268,531038600.0,-1.0
MSFT,2023-06-30,340.5400085449219,342.7300109863281,337.20001220703125,337.75,26823800.0,5.490020751953125,0.0,5.490020751953125,59.80352050548867,325.1600036621094,351.4700012207031,58.45688449252198,-41.54311550747802,4.749300418337725,5.77417743067947,-0.005228808744646374,557862400.0,1.0
MSFT,2023-07-03,337.989990234375,340.8999938964844,336.57000732421875,339.19000244140625,12508700.0,-2.550018310546875,2.550018310546875,0.0,54.79115158722488,328.489990234375,351.4700012207031,41.34027614543784,-58.65972385456216,4.592150621041128,5.537772068751802,-0.0001774813215804638,545353700.0,-1.0
MSFT,2023-07-05,338.1499938964844,341.6499938964844,334.7300109863281,335.0899963378906,18172400.0,0.160003662109375,0.0,0.160003662109375,55.063827568987165,328.489990234375,351.4700012207031,42.03654936395183,-57.96345063604817,4.429459184569168,5.316109491915276,0.013760631884776275,563526100.0,1.0
MSFT,2023-07-06,341.2699890136719,342.989990234375,335.5,337.29998779296875,28161200.0,3.1199951171875,0.0,3.1199951171875,60.433229810665246,328.489990234375,351.4700012207031,55.61354512363066,-44.38645487636934,4.500404715945649,5.1529685367213505,0.004592145058530228,591687300.0,1.0
MSFT,2023-07-07,337.2200012207031,341.7900085449219,337.0,339.32000732421875,21185300.0,-4.04998779296875,4.04998779296875,0.0,51.25939268251315,328.489990234375,351.4700012207031,37.989585781843246,-62.010414218156754,4.181626208998807,4.9587000711768425,0.006566808785076539,570502000.0,-1.0
MSFT,2023-07-10,331.8299865722656,335.2300109863281,327.5899963378906,334.6000061035156,32791400.0,-5.3900146484375,5.3900146484375,0.0,41.56922511851986,327.5899963378906,342.989990234375,27.532415031300346,-72.46758496869965,3.4542444300739135,4.657808942956257,0.009829520416175797,537710600.0,-1.0
MSFT,2023-07-11,332.4700012207031,332.8599853515625,327.0,331.0599975585937,26698200.0,0.6400146484375,0.0,0.6400146484375,43.04439545887291,327.0,342.989990234375,34.20890907702878,-65.79109092297122,2.896049111645482,4.305456976694102,-0.00627673149876995,564408800.0,1.0
MSFT,2023-07-12,337.20001220703125,341.6499938964844,335.6700134277344,336.6000061035156,29995300.0,4.730010986328125,0.0,4.730010986328125,53.13408434172398,327.0,342.989990234375,63.78998396824185,-36.21001603175815,2.8030360022517016,4.0049727818056216,0.004019669730479514,594404100.0,1.0
MSFT,2023-07-13,342.6600036621094,343.739990234375,339.0199890136719,339.5599975585937,20567200.0,5.459991455078125,0.0,5.459991455078125,62.08104269696858,327.0,343.739990234375,93.54846354660405,-6.451536453395948,3.1337739271801865,3.8307330108805346,0.022713076097298446,614971300.0,1.0
MSFT,2023-07-14,345.239990234375,351.42999267578125,344.3099975585937,347.5899963378906,28302200.0,2.579986572265625,0.0,2.579986572265625,65.65578912360371,327.0,351.42999267578125,74.66228286043358,-25.337717139566436,3.562997453305684,3.777185899365565,0.01380155509343961,643273500.0,1.0
MSFT,2023-07-17,345.7300109863281,346.989990234375,342.20001220703125,345.67999267578125,20363900.0,0.490020751953125,0.0,0.490020751953125,66.35098336260859,327.0,351.42999267578125,76.66809906535985,-23.33190093464015,3.897769706655936,3.8013026608236395,0.022900147861141917,663637400.0,1.0
MSFT,2023-07-18,359.489990234375,366.7799987792969,342.1700134277344,345.8299865722656,64872700.0,13.759979248046875,0.0,13.759979248046875,79.67869207582808,327.0,366.7799987792969,81.67418610199684,-18.32581389800316,5.213298794376783,4.083701887534269,0.06310807843581778,728510100.0,1.0
MSFT,2023-07-19,355.0799865722656,362.4599914550781,352.44000244140625,361.75,39732900.0,-4.410003662109375,4.410003662109375,0.0,69.49907957516265,327.0,366.7799987792969,70.58820370522382,-29.411796294776188,5.832778000663609,4.433517110160137,0.040466486955114345,688777200.0,-1.0
MSFT,2023-07-20,346.8699951171875,357.9700012207031,345.3699951171875,353.57000732421875,33778400.0,-8.209991455078125,8.209991455078125,0.0,54.53321492450929,327.0,366.7799987792969,49.94971273736854,-50.050287262631464,5.596726459307604,4.666158979989631,0.028616315347702814,654998800.0,-1.0
MSFT,2023-07-21,343.7699890136719,350.29998779296875,339.8299865722656,349.1499938964844,69368900.0,-3.100006103515625,3.100006103515625,0.0,49.85579701463723,327.0,366.7799987792969,42.15683642101985,-57.84316357898015,5.100711500308819,4.753069484053469,0.03598228889662436,585629900.0,-1.0
MSFT,2023-07-24,345.1099853515625,346.9200134277344,342.3099975585937,345.8500061035156,26678100.0,1.339996337890625,0.0,1.339996337890625,51.912929953470815,327.0,366.7799987792969,45.52535421642012,-54.47464578357989,4.760862320066735,4.754628051256123,0.0380184199610496,612308000.0,1.0
MSFT,2023-07-25,350.9800109863281,351.8900146484375,345.07000732421875,347.1099853515625,41637700.0,5.870025634765625,0.0,5.870025634765625,60.17173644980528,327.0,366.7799987792969,60.28157798438218,-39.71842201561782,4.908608029259312,4.785424046856761,0.04086594982338365,653945700.0,1.0
MSFT,2023-07-26,337.7699890136719,344.6700134277344,333.1099853515625,341.44000244140625,58383700.0,-13.21002197265625,13.21002197265625,0.0,41.61356015998005,327.0,366.7799987792969,27.073879698752062,-72.92612030124793,3.9146337348905718,4.6112659844635235,-0.014270748252426468,595562000.0,-1.0
MSFT,2023-07-27,330.7200012207031,341.3299865722656,329.04998779296875,340.4800109863281,39635300.0,-7.04998779296875,7.04998779296875,0.0,34.971667873153095,327.0,366.7799987792969,9.351436236441426,-90.64856376355857,2.528875546588324,4.194787896888483,-0.042057668359376965,555926700.0,-1.0
MSFT,2023-07-28,338.3699951171875,340.010009765625,333.1700134277344,333.6700134277344,28484900.0,7.649993896484375,0.0,7.649993896484375,45.80239639980259,327.0,366.7799987792969,28.582190714155846,-71.41780928584416,2.024604393118466,3.7607511961344797,-0.02128833377277073,584411600.0,1.0
MSFT,2023-07-31,335.9200134277344,337.70001220703125,333.3599853515625,336.9200134277344,25446000.0,-2.449981689453125,2.449981689453125,0.0,43.146850503749945,329.04998779296875,366.7799987792969,18.20838493064593,-81.79161506935407,1.4110076065617818,3.2908024782199403,-0.06556504338625346,558965600.0,-1.0
MSFT,2023-08-01,336.3399963378906,338.5400085449219,333.70001220703125,335.19000244140625,18311900.0,0.41998291015625,0.0,0.41998291015625,43.791442248709885,329.04998779296875,366.7799987792969,19.321511853159777,-80.67848814684022,0.9476924349238516,2.8221804695607227,-0.05277681351539942,577277500.0,1.0
MSFT,2023-08-02,327.5,333.6300048828125,326.3599853515625,333.6300048828125,27761300.0,-8.839996337890625,8.839996337890625,0.0,34.33657291941768,326.3599853515625,366.7799987792969,2.8204212511598867,-97.17957874884011,-0.13128858901092144,2.231486657846394,-0.05584223308402181,549516200.0,-1.0
MSFT,2023-08-03,326.6600036621094,329.8800048828125,325.95001220703125,326.0,18253700.0,-0.839996337890625,0.839996337890625,0.0,33.54254547411308,325.95001220703125,366.7799987792969,1.7388971064722252,-98.26110289352778,-1.0421561807115722,1.5767580901348006,-0.04977160862893715,531262500.0,-1.0
MSFT,2023-08-04,327.7799987792969,335.1400146484375,327.239990234375,331.8800048828125,23727700.0,1.1199951171875,0.0,1.1199951171875,35.82565453910101,325.95001220703125,366.7799987792969,4.4819671175416715,-95.51803288245833,-1.6545781172176248,0.9304908486643155,-0.05021583642273242,554990200.0,1.0
MSFT,2023-08-07,330.1099853515625,331.1099853515625,327.5199890136719,328.3699951171875,17741500.0,2.329986572265625,0.0,2.329986572265625,40.71460741697533,325.95001220703125,362.4599914550781,11.394071511979263,-88.60592848802074,-1.9296724079493401,0.35845819734158424,-0.05946214878766587,572731700.0,1.0
MSFT,2023-08-08,326.04998779296875,328.75,323.0,326.9599914550781,22327600.0,-4.05999755859375,4.05999755859375,0.0,35.30667252943168,323.0,357.9700012207031,8.721726298262409,-91.27827370173759,-2.447086003277093,-0.20265064278215136,-0.034698172134614125,550404100.0,-1.0
MSFT,2023-08-09,322.2300109863281,327.1099853515625,321.04998779296875,326.4700012207031,22373300.0,-3.819976806640625,3.819976806640625,0.0,30.857092115951303,321.04998779296875,351.8900146484375,3.826271614125153,-96.17372838587485,-3.1293074998239945,-0.7879820141905202,-0.025671233076433375,528030800.0,-1.0
MSFT,2023-08-10,322.92999267578125,328.260009765625,321.17999267578125,326.0199890136719,20113700.0,0.699981689453125,0.0,0.699981689453125,32.65167261843729,321.04998779296875,351.8900146484375,6.095989772068326,-93.90401022793168,-3.5723109022353583,-1.344847791799488,-0.04563053067414835,548144500.0,1.0
MSFT,2023-08-11,321.010009765625,322.4100036621094,319.2099914550781,320.260009765625,24342600.0,-1.91998291015625,1.91998291015625,0.0,30.17314124517918,319.2099914550781,351.8900146484375,5.508008057083146,-94.49199194291685,-4.031844274140099,-1.8822470882676108,-0.044385577119884556,523801900.0,-1.0
MSFT,2023-08-14,324.0400085449219,324.0599975585937,320.0799865722656,321.3900146484375,18836100.0,3.029998779296875,0.0,3.029998779296875,38.652771773738095,319.2099914550781,344.6700134277344,18.970985551509457,-81.02901444849054,-4.104221295100103,-2.3266419296341097,-0.036570101465458915,542638000.0,1.0
MSFT,2023-08-15,321.8599853515625,325.0899963378906,320.8999938964844,323.0,16966300.0,-2.180023193359375,2.180023193359375,0.0,35.112898809323,319.2099914550781,341.3299865722656,11.980083550856204,-88.01991644914379,-4.288060169737264,-2.718925577654741,-0.01722141877385497,525671700.0,-1.0
MSFT,2023-08-16,320.3999938964844,324.4200134277344,319.79998779296875,320.79998779296875,20698900.0,-1.459991455078125,1.459991455078125,0.0,32.792220382855504,319.2099914550781,340.010009765625,5.7211605472618565,-94.27883945273814,-4.499693248336939,-3.075079111791181,-0.019163686081691944,504972800.0,-1.0
MSFT,2023-08-17,316.8800048828125,321.8699951171875,316.2099914550781,320.5400085449219,21257200.0,-3.519989013671875,3.519989013671875,0.0,27.699408090458263,316.2099914550781,338.5400085449219,3.0005056648125623,-96.99949433518744,-4.895020929260966,-3.439067475285138,-0.033253993340282006,483715600.0,-1.0
MSFT,2023-08-18,316.4800109863281,318.3800048828125,311.54998779296875,314.489990234375,24744800.0,-0.399993896484375,0.399993896484375,0.0,27.1466151416941,311.54998779296875,338.5400085449219,18.266096342303165,-81.73390365769684,-5.180875224527824,-3.787429025133676,-0.04128919139091969,458970800.0,-1.0
MSFT,2023-08-21,321.8800048828125,322.7699890136719,317.0400085449219,317.92999267578125,24040000.0,5.399993896484375,0.0,5.399993896484375,44.4236690773657,311.54998779296875,335.1400146484375,43.789764009738704,-56.210235990261296,-4.9150250854927435,-4.01294823720549,-0.012789397534969549,483010800.0,1.0
MSFT,2023-08-22,322.4599914550781,326.0799865722656,321.4599914550781,325.5,16102000.0,0.579986572265625,0.0,0.579986572265625,46.01039771350125,311.54998779296875,335.1400146484375,46.24837321700703,-53.751626782992965,-4.604459522529623,-4.131250494270317,0.0007137152372804767,499112800.0,1.0
MSFT,2023-08-23,327.0,329.20001220703125,323.4599914550781,323.82000732421875,21166400.0,4.540008544921875,0.0,4.540008544921875,57.07852335800388,311.54998779296875,335.1400146484375,65.49383051443859,-34.50616948556141,-3.946500527763817,-4.094300500969017,0.01260337353769736,520279200.0,1.0
MSFT,2023-08-24,319.9700012207031,332.9800109863281,319.9599914550781,332.8500061035156,23281400.0,-7.029998779296875,7.029998779296875,0.0,41.776664266462056,311.54998779296875,332.9800109863281,39.2907340872292,-60.7092659127708,-3.9468288472757536,-4.064806170230364,-0.003239800982160035,496997800.0,-1.0
MSFT,2023-08-25,322.9800109863281,325.3599853515625,318.79998779296875,321.4700012207031,21684100.0,3.010009765625,0.0,3.010009765625,48.58612013167791,311.54998779296875,332.9800109863281,53.33649474024485,-46.66350525975515,-3.6619932320027715,-3.9842435825848455,-0.0032711934657501107,518681900.0,1.0
MSFT,2023-08-28,323.70001220703125,326.1499938964844,321.7200012207031,325.6600036621094,14808500.0,0.720001220703125,0.0,0.720001220703125,50.19384445183576,311.54998779296875,332.9800109863281,56.696272815175895,-43.30372718482411,-3.3396633137469394,-3.855327528817264,0.005716854965549523,533490400.0,1.0
MSFT,2023-08-29,328.4100036621094,328.9800109863281,321.8800048828125,321.8800048828125,19284600.0,4.709991455078125,0.0,4.709991455078125,59.70471424558565,311.54998779296875,332.9800109863281,78.67474391891987,-21.32525608108012,-2.6733409732412383,-3.6189302177020592,0.02500003095572123,552775000.0,1.0
MSFT,2023-08-30,328.7900085449219,329.8099975585937,326.45001220703125,328.6700134277344,15222100.0,0.3800048828125,0.0,0.3800048828125,60.408524941612164,311.54998779296875,332.9800109863281,80.44797990370526,-19.552020096294743,-2.090514351444142,-3.313247044450476,0.037585216733740934,567997100.0,1.0
MSFT,2023-08-31,327.760009765625,330.9100036621094,326.7799987792969,329.20001220703125,26411000.0,-1.029998779296875,1.029998779296875,0.0,57.27958706282582,311.54998779296875,332.9800109863281,75.64164455817914,-24.358355441820855,-1.6922254267156518,-2.9890427209035115,0.0356420575951768,541586100.0,-1.0
MSFT,2023-09-01,328.6600036621094,331.989990234375,326.7799987792969,331.3099975585937,14931200.0,0.899993896484375,0.0,0.899993896484375,59.39979147843396,311.54998779296875,332.9800109863281,79.84133155041377,-20.15866844958624,-1.2890966942121622,-2.649053515565242,0.02106374635406527,556517300.0,1.0
MSFT,2023-09-05,333.54998779296875,334.8500061035156,328.6600036621094,329.0,18553900.0,4.889984130859375,0.0,4.889984130859375,69.03445941654499,311.54998779296875,334.8500061035156,94.42052665701806,-5.579473342981945,-0.568480329883414,-2.2329388784288766,0.034391852111165244,575071200.0,1.0
MSFT,2023-09-06,332.8800048828125,334.4599914550781,330.17999267578125,333.3800048828125,17535800.0,-0.66998291015625,0.66998291015625,0.0,66.53823323479367,311.54998779296875,334.8500061035156,91.54506578301103,-8.454934216988978,-0.050862381092656506,-1.7965235789616325,0.017981666308295008,557535400.0,-1.0
MSFT,2023-09-07,329.9100036621094,333.0799865722656,329.0299987792969,331.2900085449219,18381000.0,-2.970001220703125,2.970001220703125,0.0,56.15268670586326,311.54998779296875,334.8500061035156,78.79828944524849,-21.201710554751504,0.11833520085076543,-1.4135518229991528,0.031065419894004354,539154400.0,-1.0
MSFT,2023-09-08,334.2699890136719,336.1600036621094,329.4599914550781,330.0899963378906,19530100.0,4.3599853515625,0.0,4.3599853515625,65.32119235041685,317.0400085449219,336.1600036621094,90.11498362393141,-9.885016376068595,0.5973539588986227,-1.0113706666195976,0.03495565559263558,558684500.0,1.0
MSFT,2023-09-11,337.94000244140625,338.4200134277344,335.42999267578125,337.239990234375,16583300.0,3.670013427734375,0.0,3.670013427734375,71.17519009642345,318.79998779296875,338.4200134277344,97.55346402056901,-2.4465359794309927,1.2586107070585513,-0.5573743918839676,0.04399131818774049,575267800.0,1.0
MSFT,2023-09-12,331.7699890136719,336.7900085449219,331.4800109863281,335.82000732421875,17565500.0,-6.170013427734375,6.170013427734375,0.0,53.61768461926739,318.79998779296875,338.4200134277344,66.10593412131422,-33.89406587868579,1.2701514105889942,-0.19186923138937517,0.010231068828888246,557702300.0,-1.0
MSFT,2023-09-13,336.0599975585937,336.8500061035156,331.1700134277344,331.3099975585937,16544400.0,4.290008544921818,0.0,4.290008544921818,61.2804338626798,318.79998779296875,338.4200134277344,87.97139252989119,-12.028607470108813,1.606941516248014,0.16789291813810278,0.022111344094200236,574246700.0,1.0
MSFT,2023-09-14,338.70001220703125,340.8599853515625,336.57000732421875,339.1499938964844,20267000.0,2.640014648437557,0.0,2.640014648437557,65.3456700386678,318.79998779296875,340.8599853515625,90.20864286682658,-9.791357133173413,2.063095143448834,0.5469333632002491,0.033378087977326,594513700.0,1.0
MSFT,2023-09-15,330.2200012207031,337.3999938964844,329.6499938964844,336.9200134277344,37666900.0,-8.480010986328125,8.480010986328125,0.0,47.040759537230414,321.7200012207031,340.8599853515625,44.4096501955582,-55.5903498044418,1.720501295269969,0.7816469496141932,0.004746539101841973,556846800.0,-1.0
MSFT,2023-09-18,329.0599975585937,330.3999938964844,326.3599853515625,327.79998779296875,16834200.0,-1.1600036621094318,1.1600036621094318,0.0,45.048956536161846,321.8800048828125,340.8599853515625,37.829294332535525,-62.170705667464475,1.3399445546166362,0.8933064706146818,-0.013461221402178425,540012600.0,-1.0
MSFT,2023-09-19,328.6499938964844,329.3900146484375,324.510009765625,326.1700134277344,16505900.0,-0.41000366210931816,0.41000366210931816,0.0,44.28424510000888,324.510009765625,340.8599853515625,25.3210416682221,-74.6789583317779,0.9938106958213098,0.9134073156560074,-0.012707314720862395,523506700.0,-1.0
MSFT,2023-09-20,320.7699890136719,329.5899963378906,320.510009765625,329.510009765625,21436500.0,-7.8800048828125,7.8800048828125,0.0,32.17295395973956,320.510009765625,340.8599853515625,1.2775408351179014,-98.72245916488211,0.08269334348290158,0.7472645212213862,-0.027704569570429327,502070200.0,-1.0
MSFT,2023-09-21,319.5299987792969,325.3500061035156,315.0,319.260009765625,35529500.0,-1.239990234375,1.239990234375,0.0,30.650919815050614,315.0,340.8599853515625,17.51740659444405,-82.48259340555595,-0.7310040121566885,0.45161081454577123,-0.04409606222164364,466540700.0,-1.0
MSFT,2023-09-22,317.010009765625,321.45001220703125,316.1499938964844,321.32000732421875,21447900.0,-2.519989013671875,2.519989013671875,0.0,27.590244275404075,315.0,340.8599853515625,7.772663976020204,-92.2273360239798,-1.5612104199489067,0.04904656764683552,-0.061934049016319714,445092800.0,-1.0
MSFT,2023-09-25,317.5400085449219,317.6700134277344,315.0,316.5899963378906,17836000.0,0.529998779296875,0.0,0.529998779296875,29.303398442105504,315.0,340.8599853515625,9.822157709646204,-90.1778422903538,-2.1515863591020548,-0.3910800177029427,-0.04289110208869318,462928800.0,1.0
MSFT,2023-09-26,312.1400146484375,315.8800048828125,310.0199890136719,315.1300048828125,26297600.0,-5.399993896484375,5.399993896484375,0.0,22.926569732216464,310.0199890136719,340.8599853515625,6.87427330255847,-93.12572669744154,-3.0203808517865696,-0.9169401845196683,-0.07117771553868335,436631200.0,-1.0
MSFT,2023-09-27,312.7900085449219,314.29998779296875,309.69000244140625,312.29998779296875,19410100.0,0.649993896484375,0.0,0.649993896484375,25.18769040148227,309.69000244140625,340.8599853515625,9.945485412844217,-90.0545145871558,-3.614788638053028,-1.4565098752263403,-0.07649838419926547,456041300.0,1.0
MSFT,2023-09-28,313.6400146484375,315.4800109863281,309.45001220703125,310.989990234375,19683600.0,0.850006103515625,0.0,0.850006103515625,28.359019029099485,309.45001220703125,340.8599853515625,13.339719910380648,-86.66028008961935,-3.97149181689241,-1.9595062635595546,-0.050208910759419356,475724900.0,1.0
MSFT,2023-09-29,315.75,319.4700012207031,314.9800109863281,317.75,24140300.0,2.1099853515625,0.0,2.1099853515625,36.115567798549144,309.45001220703125,340.8599853515625,20.057284875665783,-79.94271512433421,-4.037383033614731,-2.37508161757059,-0.0404485432971039,499865200.0,1.0
MSFT,2023-10-02,321.79998779296875,321.8900146484375,315.17999267578125,316.2799987792969,20570000.0,6.04998779296875,0.0,6.04998779296875,52.964024434417844,309.45001220703125,340.8599853515625,39.31864420612451,-60.68135579387549,-3.560377034358396,-2.612140700928151,-0.02084286088766274,520435200.0,1.0
MSFT,2023-10-03,313.3900146484375,321.3900146484375,311.2099914550781,320.8299865722656,21033500.0,-8.40997314453125,8.40997314453125,0.0,37.21965056397229,309.45001220703125,340.8599853515625,12.543794365173595,-87.45620563482642,-3.816961336677423,-2.853104828078006,-0.023007059943253694,499401700.0,-1.0
MSFT,2023-10-04,318.9599914550781,320.0400085449219,314.0,314.0299987792969,20720100.0,5.569976806640625,0.0,5.569976806640625,48.84136172270179,309.45001220703125,337.3999938964844,34.02499276640116,-65.97500723359883,-3.530162154925449,-2.988516293447495,-0.0017838929878144505,520121800.0,1.0
MSFT,2023-10-05,319.3599853515625,319.9800109863281,314.8999938964844,319.0899963378906,16965600.0,0.399993896484375,0.0,0.399993896484375,49.61422413064027,309.45001220703125,330.3999938964844,47.303015780296555,-52.696984219703445,-3.2333238281361787,-3.037477800385232,0.007412938120392232,537087400.0,1.0
MSFT,2023-10-06,327.260009765625,329.19000244140625,316.29998779296875,316.54998779296875,25645500.0,7.9000244140625,0.0,7.9000244140625,62.5182680792613,309.45001220703125,329.5899963378906,88.4310406744784,-11.568959325521595,-2.333709814536917,-2.896724203215569,0.030610319831014365,562732900.0,1.0
MSFT,2023-10-09,329.82000732421875,330.29998779296875,323.17999267578125,324.75,19891200.0,2.55999755859375,0.0,2.55999755859375,65.79379932605192,309.45001220703125,330.29998779296875,97.6979327061,-2.30206729389999,-1.39807270730455,-2.5969939040333654,0.056641224598179774,582624100.0,1.0
MSFT,2023-10-10,328.3900146484375,331.1000061035156,327.6700134277344,330.9599914550781,20557100.0,-1.42999267578125,1.42999267578125,0.0,62.28554144603883,309.45001220703125,331.1000061035156,87.4827149234523,-12.517285076547694,-0.763164728967638,-2.23022806902022,0.0498737353411185,562067000.0,-1.0
MSFT,2023-10-11,332.4200134277344,332.82000732421875,329.1400146484375,331.2099914550781,20063200.0,4.029998779296875,0.0,4.029998779296875,67.85856429723096,309.45001220703125,332.82000732421875,98.28842969594717,-1.7115703040528187,0.06444871484666237,-1.7712927122468436,0.05987755994829791,582130200.0,1.0
MSFT,2023-10-12,331.1600036621094,333.6300048828125,328.7200012207031,330.57000732421875,19313100.0,-1.260009765625,1.260009765625,0.0,64.4241810539902,309.45001220703125,333.6300048828125,89.784938093976,-10.215061906024005,0.6116157483284042,-1.294711020131794,0.048804445485698844,562817100.0,-1.0
MSFT,2023-10-13,327.7300109863281,333.8299865722656,326.3599853515625,332.3800048828125,21072400.0,-3.42999267578125,3.42999267578125,0.0,55.58751333819693,309.45001220703125,333.8299865722656,74.97956521793554,-25.02043478206446,0.7597202391895621,-0.8838247682675227,0.01842766755222658,541744700.0,-1.0
MSFT,2023-10-16,332.6400146484375,336.1400146484375,330.6000061035156,331.04998779296875,22158000.0,4.910003662109375,0.0,4.910003662109375,63.7909107203701,309.45001220703125,336.1400146484375,86.88647553448635,-13.113524465513654,1.2587799445146857,-0.4553038257110809,0.06142505855393887,563902700.0,1.0
MSFT,2023-10-17,332.0599975585937,333.4599914550781,327.4100036621094,329.5899963378906,18338500.0,-0.5800170898438068,0.5800170898438068,0.0,62.224319472341634,309.45001220703125,336.1400146484375,84.71331316360555,-15.28668683639445,1.589166897992584,-0.046409680970347825,0.04107100092320071,545564200.0,-1.0
MSFT,2023-10-18,330.1099853515625,335.5899963378906,328.29998779296875,332.489990234375,23153600.0,-1.9500122070311932,1.9500122070311932,0.0,56.81202281383498,311.2099914550781,336.1400146484375,75.81217935456546,-24.18782064543455,1.6743503818033787,0.2977423315843976,0.0336610736882581,522410600.0,-1.0
MSFT,2023-10-19,331.32000732421875,336.8800048828125,330.9100036621094,332.1499938964844,25052100.0,1.21002197265625,0.0,1.21002197265625,59.34394583326972,311.2099914550781,336.8800048828125,78.34049610357188,-21.659503896428127,1.8185346318178972,0.6019007916310977,0.012406030182243732,547462700.0,1.0
MSFT,2023-10-20,326.6700134277344,331.9200134277344,325.45001220703125,331.7200012207031,25012600.0,-4.649993896484375,4.649993896484375,0.0,47.1001303534939,311.2099914550781,336.8800048828125,60.22599877549322,-39.774001224506776,1.5398357746246347,0.7894877882298051,-0.00955064528086036,522450100.0,-1.0
MSFT,2023-10-23,329.32000732421875,332.7300109863281,324.3900146484375,325.4700012207031,24374700.0,2.649993896484375,0.0,2.649993896484375,53.41964273569521,314.0,336.8800048828125,66.95805967999232,-33.04194032000768,1.5153295076016207,0.9346561321041683,0.0028319761085819906,546824800.0,1.0
MSFT,2023-10-24,330.5299987792969,331.8399963378906,327.6000061035156,331.29998779296875,31153600.0,1.209991455078125,0.0,1.209991455078125,56.17773699717216,314.8999938964844,336.8800048828125,71.11008676262529,-28.889913237374714,1.5753842633864679,1.0628017583606284,-0.005685622321438211,577978400.0,1.0
MSFT,2023-10-25,340.6700134277344,346.20001220703125,337.6199951171875,345.0199890136719,55053800.0,10.1400146484375,0.0,10.1400146484375,72.13292349971772,316.29998779296875,346.20001220703125,81.50503590660608,-18.49496409339392,2.4133726706329526,1.3329159408150935,0.028717265552781868,633032200.0,1.0
MSFT,2023-10-26,327.8900146484375,341.6300048828125,326.94000244140625,340.5400085449219,37828500.0,-12.779998779296875,12.779998779296875,0.0,47.16181840209008,323.17999267578125,346.20001220703125,20.46054724785237,-79.53945275214764,2.022926389977556,1.4709180306475862,0.00048821791336051135,595203700.0,-1.0
MSFT,2023-10-27,329.8099975585937,336.7200012207031,328.3999938964844,330.42999267578125,29856500.0,1.9199829101561932,0.0,1.9199829101561932,50.153097017722146,324.3900146484375,346.20001220703125,24.850910210306594,-75.1490897896934,1.8471289220123595,1.546160208920541,-0.008507747009435462,625060200.0,1.0
MSFT,2023-10-30,337.3099975585937,339.45001220703125,331.8299865722656,333.4100036621094,22828100.0,7.5,0.0,7.5,60.28656803759799,324.3900146484375,346.20001220703125,59.23880952047772,-40.76119047952228,2.2866365591106614,1.6942554789585655,0.015810395827861257,647888300.0,1.0
MSFT,2023-10-31,338.1099853515625,339.0,334.69000244140625,338.8500061035156,20265300.0,0.7999877929688068,0.0,0.7999877929688068,61.255950293752775,324.3900146484375,346.20001220703125,62.906796143674704,-37.093203856325296,2.668738303181158,1.8891520438030842,0.02423434720243356,668153600.0,1.0
MSFT,2023-11-01,346.07000732421875,347.4200134277344,339.6499938964844,339.7900085449219,28158800.0,7.96002197265625,0.0,7.96002197265625,69.73698213575867,324.3900146484375,347.4200134277344,94.13805395105261,-5.861946048947388,3.5726803021584033,2.2258576954741485,0.04451889313634516,696312400.0,1.0
MSFT,2023-11-02,348.32000732421875,348.8299865722656,344.7699890136719,347.239990234375,24348100.0,2.25,0.0,2.25,71.7535971122256,324.3900146484375,348.8299865722656,97.91333946848907,-2.086660531510934,4.419669842073233,2.6646201247939656,0.06627481252200629,720660500.0,1.0
MSFT,2023-11-03,352.79998779296875,354.3900146484375,347.3299865722656,349.6300048828125,23624000.0,4.47998046875,0.0,4.47998046875,75.50377168154893,324.3900146484375,354.3900146484375,94.69991048177083,-5.300089518229167,5.390276386897369,3.209751377214647,0.07129837224142199,744284500.0,1.0
MSFT,2023-11-06,356.5299987792969,357.5400085449219,353.3500061035156,353.45001220703125,23828300.0,3.730010986328125,0.0,3.730010986328125,78.27476067977291,324.3900146484375,357.5400085449219,96.95321281572811,-3.0467871842718908,6.386846192869541,3.8451703403456263,0.07866154387203106,768112800.0,1.0
MSFT,2023-11-07,360.5299987792969,362.4599914550781,357.6300048828125,359.3999938964844,25833900.0,4.0,0.0,4.0,80.9422624117061,324.3900146484375,362.4599914550781,94.93040753456778,-5.069592465432229,7.41393824948176,4.558923922172854,0.058296840252349824,793946700.0,1.0
MSFT,2023-11-08,363.2000122070313,363.8699951171875,360.5499877929688,361.6799926757813,26767800.0,2.670013427734432,0.0,2.670013427734432,82.58879499984307,324.3900146484375,363.8699951171875,98.30298064436352,-1.6970193556364896,8.347143202607128,5.316567778259709,0.10768854183148302,820714500.0,1.0
MSFT,2023-11-09,360.6900024414063,364.7900085449219,360.3599853515625,362.2999877929688,24847300.0,-2.510009765625,2.510009765625,0.0,75.51217552920838,324.3900146484375,364.7900085449219,89.85146850759214,-10.148531492407855,8.782933846087303,6.009840991825229,0.09362968106303837,795867200.0,-1.0
MSFT,2023-11-10,369.6700134277344,370.1000061035156,361.0700073242188,361.489990234375,28042100.0,8.980010986328068,0.0,8.980010986328068,81.91065649934299,326.94000244140625,370.1000061035156,99.00372419069383,-0.9962758093061636,9.740629000474485,6.755998593555081,0.09593553734949545,823909300.0,1.0
MSFT,2023-11-13,366.6799926757813,368.4700012207031,365.8999938964844,368.2200012207031,19986500.0,-2.990020751953068,2.990020751953068,0.0,74.43813139210224,326.94000244140625,370.1000061035156,92.07596585368971,-7.92403414631029,10.141435468850204,7.4330859686141055,0.08449915282600151,803922800.0,-1.0
MSFT,2023-11-14,370.2699890136719,371.9500122070313,367.3500061035156,371.010009765625,27683900.0,3.589996337890568,0.0,3.589996337890568,77.30627254418627,326.94000244140625,371.9500122070313,96.26744539246359,-3.7325546075364224,10.626267190755811,8.071722213042447,0.06992799484868728,831606700.0,1.0
MSFT,2023-11-15,369.6700134277344,373.1300048828125,367.1099853515625,371.2799987792969,26860100.0,-0.5999755859375,0.5999755859375,0.0,75.66902797873612,328.3999938964844,373.1300048828125,92.2647203101835,-7.735279689816492,10.83716274162407,8.624810318758772,0.06129422845252441,804746600.0,-1.0
MSFT,2023-11-16,376.1700134277344,376.3500061035156,370.1799926757813,370.9599914550781,27182300.0,6.5,0.0,6.5,80.76214037414177,331.8299865722656,376.3500061035156,99.59570396042862,-0.40429603957138316,11.39741238698673,9.179330732404365,0.06624157155152655,831928900.0,1.0
MSFT,2023-11-17,369.8500061035156,374.3699951171875,367.0,373.6099853515625,40157000.0,-6.32000732421875,6.32000732421875,0.0,65.402808319931,334.69000244140625,376.3500061035156,84.39750497210858,-15.602495027891422,11.202309246954371,9.583926435314368,0.0373601306196516,791771900.0,-1.0
MSFT,2023-11-20,377.4400024414063,378.8699951171875,371.0,371.2200012207031,52465100.0,7.589996337890682,0.0,7.589996337890682,72.61870603814857,339.6499938964844,378.8699951171875,96.35391985906838,-3.646080140931614,11.527258810955004,9.972592910442495,0.0469031806489455,844237000.0,1.0
MSFT,2023-11-21,373.0700073242188,376.2200012207031,371.1199951171875,375.6700134277344,28423100.0,-4.3699951171875,4.3699951171875,0.0,63.78120401294938,344.7699890136719,378.8699951171875,82.99124118816292,-17.008758811837072,11.301880553334229,10.238450439020843,0.0271750957749457,815813900.0,-1.0
MSFT,2023-11-22,377.8500061035156,379.7900085449219,374.9700012207031,378.0,23345300.0,4.779998779296818,0.0,4.779998779296818,68.60353016905994,347.3299865722656,379.7900085449219,94.0234099562826,-5.976590043717389,11.37781623071669,10.466323597360013,0.04757549016040974,839159200.0,1.0
MSFT,2023-11-24,377.4299926757813,377.9700012207031,375.1400146484375,377.3299865722656,10176600.0,-0.42001342773431816,0.42001342773431816,0.0,67.68977688701511,353.3500061035156,379.7900085449219,91.07407091065667,-8.925929089343335,11.274142926958177,10.627887463279647,0.02099163839688578,828982600.0,-1.0
MSFT,2023-11-27,378.6099853515625,380.6400146484375,376.2000122070313,376.7799987792969,22179200.0,1.1799926757811932,0.0,1.1799926757811932,69.02707653039509,357.6300048828125,380.6400146484375,91.17762522679286,-8.822374773207143,11.158567612657464,10.734023493155211,0.03253516121434452,851161800.0,1.0
MSFT,2023-11-28,382.7000122070313,383.0,378.1600036621094,378.3500061035156,20453100.0,4.090026855468807,0.0,4.090026855468807,73.42594829988722,360.3599853515625,383.0,98.67496643607782,-1.3250335639221718,11.26712393764268,10.840643582052707,0.03357016113153177,871614900.0,1.0
MSFT,2023-11-29,378.8500061035156,384.2999877929688,377.4400024414063,383.760009765625,28963400.0,-3.850006103515682,3.850006103515682,0.0,63.6132224816726,360.3599853515625,384.2999877929688,77.23483235729765,-22.76516764270235,10.916651922605354,10.855845250163236,0.02483293841082901,842651500.0,-1.0
MSFT,2023-11-30,378.9100036621094,380.0899963378906,375.4700012207031,378.489990234375,30554400.0,0.05999755859375,0.0,0.05999755859375,63.7004515812667,361.0700073242188,384.2999877929688,76.79729374671547,-23.202706253284532,10.52244542635168,10.789165285400927,0.007283914550784365,873205900.0,1.0
MSFT,2023-12-01,374.510009765625,378.1600036621094,371.30999755859375,376.760009765625,33020400.0,-4.399993896484375,4.399993896484375,0.0,52.95774568504084,365.8999938964844,384.2999877929688,46.793580028228625,-53.20641997177138,9.742683610748372,10.579868950470416,0.012599712275805919,840185500.0,-1.0
MSFT,2023-12-04,369.1400146484375,369.5199890136719,362.8999938964844,369.1000061035156,32063300.0,-5.3699951171875,5.3699951171875,0.0,42.794567494948225,362.8999938964844,384.2999877929688,29.158983792879628,-70.84101620712038,8.592355699024324,10.182366300181199,-0.021990217622090302,808122200.0,-1.0
MSFT,2023-12-05,372.5199890136719,373.0799865722656,365.6199951171875,366.4500122070313,23065000.0,3.379974365234375,0.0,3.379974365234375,49.79230654179479,362.8999938964844,384.2999877929688,44.95326103232143,-55.04673896767858,7.862810638358667,9.718455167816693,-0.001474303213200745,831187200.0,1.0
MSFT,2023-12-06,368.7999877929688,374.1799926757813,368.0299987792969,373.5400085449219,21182100.0,-3.720001220703068,3.720001220703068,0.0,43.097338566848705,362.8999938964844,384.2999877929688,27.57007280013139,-72.42992719986862,6.904872836603204,9.155738701573995,-0.023951351500223317,810005100.0,-1.0
MSFT,2023-12-07,370.9500122070313,371.4500122070313,366.3200073242188,368.2300109863281,23118900.0,2.1500244140625,0.0,2.1500244140625,47.77978809551587,362.8999938964844,384.2999877929688,37.61691872196926,-62.38308127803074,6.247175676388338,8.574026096536864,-0.01716869510769492,833124000.0,1.0
MSFT,2023-12-08,374.2300109863281,374.4599914550781,368.2300109863281,369.2000122070313,20144800.0,3.279998779296818,0.0,3.279998779296818,54.38685547494682,362.8999938964844,384.2999877929688,52.94402019294516,-47.05597980705484,5.922345317572535,8.043689940743999,-0.01156856536989459,853268800.0,1.0
MSFT,2023-12-11,371.2999877929688,371.6000061035156,366.1000061035156,368.4800109863281,27708800.0,-2.930023193359318,2.930023193359318,0.0,48.11244641372678,362.8999938964844,384.2999877929688,39.25231912269084,-60.747680877309165,5.366623439057719,7.508276640406742,-0.02978840880698841,825560000.0,-1.0
MSFT,2023-12-12,374.3800048828125,374.4200134277344,370.4599914550781,370.8500061035156,24838300.0,3.080017089843693,0.0,3.080017089843693,54.48178167031282,362.8999938964844,384.2999877929688,53.64492645118955,-46.35507354881045,5.115770072014527,7.029775326728299,-0.011798868018182751,850398300.0,1.0
MSFT,2023-12-13,374.3699951171875,377.6400146484375,370.7699890136719,376.0199890136719,30955500.0,-0.010009765625,0.010009765625,0.0,54.456714746494264,362.8999938964844,384.2999877929688,53.59815183212461,-46.40184816787539,4.86013465987088,6.595847193356816,-0.011981759523484126,819442800.0,-1.0
MSFT,2023-12-14,365.9299926757813,373.760009765625,364.1300048828125,373.30999755859375,43277500.0,-8.440002441406193,8.440002441406193,0.0,37.61791771755858,362.8999938964844,384.2999877929688,14.158876838720486,-85.84112316127951,3.9311878070549824,6.06291531609645,-0.022909980684396758,776165300.0,-1.0
MSFT,2023-12-15,370.7300109863281,372.3999938964844,366.2799987792969,366.8500061035156,78478200.0,4.800018310546818,0.0,4.800018310546818,48.14077892530755,362.8999938964844,384.2999877929688,36.58887534136193,-63.41112465863807,3.5414880262649717,5.558629858130154,0.004307298788523095,854643500.0,1.0
MSFT,2023-12-18,372.6499938964844,373.0,368.6799926757813,369.4500122070313,21802900.0,1.91998291015625,0.0,1.91998291015625,51.88656295104041,362.8999938964844,384.2999877929688,45.56076065798187,-54.43923934201813,3.3489698771541043,5.116697861934945,0.0003489876695119687,876446400.0,1.0
MSFT,2023-12-19,373.260009765625,373.260009765625,369.8399963378906,371.489990234375,20603700.0,0.610015869140625,0.0,0.610015869140625,53.12771376850107,362.8999938964844,380.0899963378906,60.26768119698481,-39.73231880301519,3.208633905136594,4.735085070575275,0.012093335467136423,897050100.0,1.0
MSFT,2023-12-20,370.6199951171875,376.0299987792969,370.5299987792969,375.0,26316700.0,-2.6400146484375,2.6400146484375,0.0,47.064971757986484,362.8999938964844,378.1600036621094,50.58975281977441,-49.41024718022558,2.8515189818270983,4.35837185282564,-0.0008896538050512381,870733400.0,-1.0
MSFT,2023-12-21,373.5400085449219,374.4100036621094,370.0400085449219,372.55999755859375,17708000.0,2.920013427734375,0.0,2.920013427734375,53.794275932566336,362.8999938964844,377.6400146484375,72.184529638655,-27.815470361345007,2.7721676887762783,4.041131020015768,-0.001843792376746256,888441400.0,1.0
MSFT,2023-12-22,374.5799865722656,375.1799926757813,372.7099914550781,373.6799926757813,17091100.0,1.03997802734375,0.0,1.03997802734375,56.08828249550237,364.1300048828125,377.6400146484375,77.34991958364205,-22.65008041635795,2.7613674278689473,3.7851783015864036,0.008833824096772469,905532500.0,1.0
MSFT,2023-12-26,374.6600036621094,376.9400024414063,373.5,375.0,12673100.0,0.08001708984375,0.0,0.08001708984375,56.28097986711491,364.1300048828125,377.6400146484375,77.94219961327865,-22.057800386721365,2.7278202399904217,3.5737066892672074,0.0007478999296035571,918205600.0,1.0
MSFT,2023-12-27,374.0700073242188,375.05999755859375,372.80999755859375,373.6900024414063,14905400.0,-0.5899963378905682,0.5899963378905682,0.0,54.25538455399195,364.1300048828125,377.6400146484375,73.57509442145442,-26.424905578545577,2.6233853252111885,3.383642416456004,-0.0008013136653080011,903300200.0,-1.0
MSFT,2023-12-28,375.2799987792969,376.4599914550781,374.1600036621094,375.3699951171875,14327000.0,1.2099914550780682,0.0,1.2099914550780682,57.84555679668505,364.1300048828125,377.6400146484375,82.53135334405552,-17.468646655944486,2.6081905043481015,3.2285520340344234,0.025551352145654294,917627200.0,1.0
MSFT,2023-12-29,376.0400085449219,377.1600036621094,373.4800109863281,376.0,18723000.0,0.760009765625,0.0,0.760009765625,60.114260245226745,364.1300048828125,377.6400146484375,88.15688418237345,-11.843115817626543,2.6271903211081735,3.108279691449174,0.014323085267541336,936350200.0,1.0
MSFT,2024-01-02,370.8699951171875,375.8999938964844,366.7699890136719,373.8599853515625,25258600.0,-5.170013427734375,5.170013427734375,0.0,42.26166432473214,364.1300048828125,377.6400146484375,49.88886278620092,-50.11113721379908,2.1997140030113655,2.926566553761613,-0.0047765968293329575,911091600.0,-1.0
MSFT,2024-01-03,370.6000061035156,373.260009765625,368.510009765625,369.010009765625,23083500.0,-0.269989013671875,0.269989013671875,0.0,41.51869666843405,364.1300048828125,377.6400146484375,47.89042593563077,-52.10957406436923,1.8181911087905291,2.7048914647673965,-0.007126409453237725,888008100.0,-1.0
MSFT,2024-01-04,367.9400024414063,373.1000061035156,367.1700134277344,370.6700134277344,20901500.0,-2.660003662109318,2.660003662109318,0.0,34.60319671901057,364.1300048828125,377.1600036621094,29.24019889124964,-70.75980110875035,1.28636300940326,2.421185773694569,-0.007231106554123734,867106600.0,-1.0
MSFT,2024-01-05,367.75,372.05999755859375,366.5,368.9700012207031,20987000.0,-0.19000244140630684,0.19000244140630684,0.0,34.134599682056546,366.2799987792969,377.1600036621094,13.511034567873532,-86.48896543212646,0.8398722751340983,2.104923073982475,-0.01550037054257225,846119600.0,-1.0
MSFT,2024-01-08,374.6900024414063,375.2000122070313,369.010009765625,369.2999877929688,23134000.0,6.940002441406307,0.0,6.940002441406307,58.067047026733,366.5,377.1600036621094,76.82926480145026,-23.17073519854974,1.0341048316435035,1.8907594255146807,0.00029370461072253384,869253600.0,1.0
MSFT,2024-01-09,375.7900085449219,375.989990234375,371.1900024414063,372.010009765625,20830000.0,1.1000061035155682,0.0,1.1000061035155682,60.67997218880779,366.5,377.1600036621094,87.14826785606931,-12.851732143930697,1.262246440224601,1.7650568284566648,0.003016080904733043,890083600.0,1.0
MSFT,2024-01-10,382.7699890136719,384.1700134277344,376.3200073242188,376.3699951171875,25514200.0,6.97998046875,0.0,6.97998046875,72.99864853884897,366.5,384.1700134277344,92.07683446428479,-7.923165535715211,1.983412849694389,1.8087280327042097,0.023257629639129362,915597800.0,1.0
MSFT,2024-01-11,384.6300048828125,390.6799926757813,380.3800048828125,386.0,27850800.0,1.860015869140625,0.0,1.860015869140625,75.37114114433966,366.5,390.6799926757813,74.97936465866476,-25.020635341335222,2.67420360622242,1.981823147407852,0.024914746679623567,943448600.0,1.0
MSFT,2024-01-12,388.4700012207031,388.6799926757813,384.6499938964844,385.489990234375,21645700.0,3.839996337890625,0.0,3.839996337890625,79.63388814721272,366.5,390.6799926757813,90.8602476240958,-9.139752375904193,3.491270674830048,2.2837126528922918,0.03305497392120271,965094300.0,1.0
MSFT,2024-01-16,390.2699890136719,394.0299987792969,387.6199951171875,393.6600036621094,27202300.0,1.79998779296875,0.0,1.79998779296875,81.37720668216426,366.5,394.0299987792969,86.34213609754097,-13.657863902459033,4.2352251459721515,2.674015151508264,0.05230941880416706,992296600.0,1.0
MSFT,2024-01-17,389.4700012207031,390.1099853515625,384.80999755859375,387.9800109863281,22234100.0,-0.79998779296875,0.79998779296875,0.0,77.95524100984484,366.5,394.0299987792969,83.43625949586688,-16.563740504133122,4.706014094054922,3.080414940017596,0.05091741717866238,970062500.0,-1.0
MSFT,2024-01-18,393.8699951171875,393.989990234375,390.1199951171875,391.7200012207031,23392100.0,4.399993896484375,0.0,4.399993896484375,82.5989495782469,366.5,394.0299987792969,99.41880250924784,-0.5811974907521646,5.3722327078672265,3.538778493587523,0.07047342638399456,993454600.0,1.0
MSFT,2024-01-19,398.6700134277344,398.6700134277344,393.5,395.760009765625,29272000.0,4.800018310546875,0.0,4.800018310546875,86.24590428875455,366.5,398.6700134277344,100.0,-0.0,6.215884276705424,4.074199650211104,0.08407889443299621,1022726600.0,1.0
MSFT,2024-01-22,396.510009765625,400.6199951171875,393.5899963378906,400.0199890136719,27016900.0,-2.160003662109375,2.160003662109375,0.0,77.78159983131475,366.5,400.6199951171875,87.95432022353324,-12.04567977646676,6.633720578086127,4.586103835786108,0.05823482660878021,995709700.0,-1.0
MSFT,2024-01-23,398.8999938964844,399.3800048828125,393.9299926757813,395.75,20525900.0,2.389984130859375,0.0,2.389984130859375,80.25552633811414,366.5,400.6199951171875,94.95896404792656,-5.041035952073442,7.07614125111013,5.084111318850913,0.0614970723704058,1016235600.0,1.0
MSFT,2024-01-24,402.55999755859375,405.6300048828125,400.4500122070313,401.5400085449219,24867000.0,3.660003662109375,0.0,3.660003662109375,83.5015492657397,366.5,405.6300048828125,92.15433953199627,-7.845660468003731,7.634093452295872,5.5941077455399055,0.05170209032300854,1041102600.0,1.0
MSFT,2024-01-25,404.8699951171875,407.010009765625,402.5299987792969,404.3200073242188,21021200.0,2.30999755859375,0.0,2.30999755859375,85.26561927711835,366.5,407.010009765625,94.71731885324446,-5.2826811467555395,8.168510583798877,6.1089883131917,0.052621974306299,1062123800.0,1.0
MSFT,2024-01-26,403.9299926757813,406.1700134277344,402.4299926757813,404.3699951171875,17803300.0,-0.9400024414061932,0.9400024414061932,0.0,81.18958040364745,369.010009765625,407.010009765625,91.8946918688324,-8.105308131167615,8.419139075162832,6.571018465585928,0.039797130811897174,1044320500.0,-1.0
MSFT,2024-01-29,409.7200012207031,409.9800109863281,404.3299865722656,406.05999755859375,24510200.0,5.790008544921818,0.0,5.790008544921818,85.95977883623824,371.1900024414063,409.9800109863281,99.32969912774345,-0.6703008722565468,8.981436847476914,7.053102141964126,0.04983732481246439,1068830700.0,1.0
MSFT,2024-01-30,408.5899963378906,413.0499877929688,406.4500122070313,412.260009765625,33477600.0,-1.1300048828125,1.1300048828125,0.0,81.31608634605304,376.3200073242188,413.0499877929688,87.85735413370895,-12.14264586629105,9.22948813886643,7.488379341344587,0.049092343588107656,1035353100.0,-1.0
MSFT,2024-01-31,397.5799865722656,415.3200073242188,397.2099914550781,406.9599914550781,47871100.0,-11.010009765625,11.010009765625,0.0,50.59084128520267,380.3800048828125,415.3200073242188,49.2271908632438,-50.7728091367562,8.440359589405375,7.678775390956745,0.009419329984692748,987482000.0,-1.0
MSFT,2024-02-01,403.7799987792969,408.0,401.7999877929688,401.8299865722656,30657700.0,6.20001220703125,0.0,6.20001220703125,60.33022310688541,384.6499938964844,415.3200073242188,62.373643649968294,-37.626356350031706,8.22049791515309,7.787119895796015,0.012817581406806111,1018139700.0,1.0
MSFT,2024-02-02,411.2200012207031,412.6499938964844,403.55999755859375,403.80999755859375,28245000.0,7.44000244140625,0.0,7.44000244140625,68.83587048047163,384.80999755859375,415.3200073242188,86.56176731829478,-13.438232681705223,8.548065198000415,7.9393089562368955,0.03709866357162861,1046384700.0,1.0
MSFT,2024-02-05,405.6499938964844,411.1600036621094,403.989990234375,409.8999938964844,25352300.0,-5.57000732421875,5.57000732421875,0.0,58.078761730557034,384.80999755859375,415.3200073242188,68.30543974905764,-31.69456025094236,8.262961314561267,8.00403942790177,0.016921534478016698,1021032400.0,-1.0
MSFT,2024-02-06,405.489990234375,407.9700012207031,402.9100036621094,405.8800048828125,18382600.0,-0.160003662109375,0.160003662109375,0.0,57.7794825803219,390.1199951171875,415.3200073242188,60.99201457092535,-39.00798542907465,7.932660699908695,7.989763682303154,0.007278399974043115,1002649800.0,-1.0
MSFT,2024-02-07,414.0499877929688,414.2999877929688,407.3999938964844,407.4400024414063,22340500.0,8.559997558593807,0.0,8.559997558593807,67.96842364868328,393.5,415.3200073242188,94.17956413864096,-5.820435861359038,8.266326283417243,8.045076202525973,0.02267392690615222,1024990300.0,1.0
MSFT,2024-02-08,414.1099853515625,415.55999755859375,412.5299987792969,414.0499877929688,21225300.0,0.05999755859369316,0.0,0.05999755859369316,68.03081794172493,393.5899963378906,415.55999755859375,93.40003583766372,-6.599964162336282,8.43832816937686,8.12372659589615,0.02520236887670846,1046215600.0,1.0
MSFT,2024-02-09,420.5499877929688,420.8200073242188,415.0899963378906,415.25,22032800.0,6.440002441406307,0.0,6.440002441406307,74.24436023528875,393.9299926757813,420.8200073242188,98.99583717309099,-1.0041628269090215,8.990656586245109,8.297112593965942,0.02643265288489527,1068248400.0,1.0
MSFT,2024-02-12,415.260009765625,420.739990234375,414.75,420.55999755859375,21202900.0,-5.289978027343807,5.289978027343807,0.0,62.69503467451952,397.2099914550781,420.8200073242188,76.45068267039598,-23.549317329604026,8.898942351282642,8.417478545429281,0.016324465815405143,1047045500.0,-1.0
MSFT,2024-02-13,406.3200073242188,410.0700073242188,403.3900146484375,404.9400024414063,27824900.0,-8.940002441406193,8.940002441406193,0.0,48.10348619194809,397.2099914550781,420.8200073242188,38.585386471712916,-61.41461352828708,8.012511432823374,8.3364851229081,0.021983050070767396,1019220600.0,-1.0
MSFT,2024-02-14,409.489990234375,409.8399963378906,404.5700073242188,408.0700073242188,20401200.0,3.169982910156193,0.0,3.169982910156193,52.61551240855284,397.2099914550781,420.8200073242188,52.01181925230033,-47.98818074769968,7.479579732472303,8.16510404482094,0.01414134298959957,1039621800.0,1.0
MSFT,2024-02-15,406.55999755859375,409.1300048828125,404.2900085449219,408.1400146484375,21825500.0,-2.92999267578125,2.92999267578125,0.0,48.15079089277117,397.2099914550781,420.8200073242188,39.60186285065776,-60.39813714934225,6.743071665667969,7.880697568990345,-0.011332142522922473,1017796300.0,-1.0
MSFT,2024-02-16,404.05999755859375,408.2900085449219,403.4400024414063,407.9599914550781,22281100.0,-2.5,2.5,0.0,44.43834740412823,397.2099914550781,420.8200073242188,29.013136380263433,-70.98686361973657,5.889761110015968,7.482510277195471,-0.003919626184676783,995515200.0,-1.0
MSFT,2024-02-20,402.7900085449219,404.489990234375,398.010009765625,403.239990234375,24307900.0,-1.269989013671875,1.269989013671875,0.0,42.51691109353346,397.2099914550781,420.8200073242188,23.63410986579249,-76.36589013420752,5.052783504240551,6.996564922604487,-0.006658565573696484,971207300.0,-1.0
MSFT,2024-02-21,402.1799926757813,402.2900085449219,397.2200012207031,400.1700134277344,18631100.0,-0.6100158691405682,0.6100158691405682,0.0,41.521885534762426,397.2200012207031,420.8200073242188,21.01690750977939,-78.98309249022061,4.2907880058327805,6.455409539250146,-0.028668024313824314,952576200.0,-1.0
MSFT,2024-02-22,411.6499938964844,412.8299865722656,408.5700073242188,410.1900024414063,27009900.0,9.470001220703068,0.0,9.470001220703068,58.79524122816682,397.2200012207031,420.8200073242188,61.144020948501456,-38.855979051498544,4.4003268095199815,6.044392993304114,-0.005940430180619072,979586100.0,1.0
MSFT,2024-02-23,410.3399963378906,415.8599853515625,408.9700012207031,415.6700134277344,16295900.0,-1.30999755859375,1.30999755859375,0.0,56.148043736406365,397.2200012207031,420.8200073242188,55.593185271392876,-44.406814728607124,4.331500405347015,5.701814475712695,-0.024277711928277212,963290200.0,-1.0
MSFT,2024-02-26,407.5400085449219,412.1600036621094,407.3599853515625,411.4599914550781,16193500.0,-2.79998779296875,2.79998779296875,0.0,50.53649379987967,397.2200012207031,420.8200073242188,43.72883328484133,-56.27116671515867,4.004853906851054,5.362422361940367,-0.018590764916323943,947096700.0,-1.0
MSFT,2024-02-27,407.4800109863281,408.3200073242188,403.8500061035156,407.989990234375,14835800.0,-0.05999755859375,0.05999755859375,0.0,50.41192570075041,397.2200012207031,420.8200073242188,43.47460640739653,-56.525393592603464,3.6985087947301736,5.029639648498328,0.002854901656820674,932260900.0,-1.0
MSFT,2024-02-28,407.7200012207031,409.2999877929688,405.3200073242188,408.1799926757813,13183100.0,0.239990234375,0.0,0.239990234375,50.96971991100783,397.2200012207031,420.8200073242188,44.49151391717572,-55.50848608282427,3.435491089745369,4.7108099367477365,-0.0043224231504628285,945444000.0,1.0
MSFT,2024-02-29,413.6400146484375,414.2000122070313,405.9200134277344,408.6400146484375,31947300.0,5.920013427734375,0.0,5.920013427734375,62.860489483672694,397.2200012207031,420.8200073242188,69.57631008954822,-30.42368991045179,3.6625239750638343,4.501152744410956,0.017414445917846022,977391300.0,1.0
MSFT,2024-03-01,415.5,415.8699951171875,410.8800048828125,411.2699890136719,17800300.0,1.8599853515625,0.0,1.8599853515625,65.8618636269359,397.2200012207031,420.739990234375,77.7211195492946,-22.278880450705397,3.9470354776451586,4.390329291057797,0.028312633050856073,995191600.0,1.0
MSFT,2024-03-04,414.9200134277344,417.3500061035156,412.3200073242188,413.4400024414063,17596000.0,-0.579986572265625,0.579986572265625,0.0,64.00094797068117,397.2200012207031,417.3500061035156,87.92850429034898,-12.071495709651012,4.078696153644785,4.3280026635751945,0.030114959719661716,977595600.0,-1.0
MSFT,2024-03-05,402.6499938964844,414.25,400.6400146484375,413.9599914550781,26919200.0,-12.27001953125,12.27001953125,0.0,37.87683410712305,397.2200012207031,417.3500061035156,26.97462175191777,-73.02537824808223,3.1565632602268465,4.093714782905525,0.0011686340177592403,950676400.0,-1.0
MSFT,2024-03-06,402.0899963378906,405.1600036621094,398.3900146484375,402.9700012207031,22344100.0,-0.55999755859375,0.55999755859375,0.0,37.07979205127479,397.2200012207031,417.3500061035156,24.192717018889663,-75.80728298111033,2.353450068285383,3.7456618399814965,-0.02322360670554935,928332300.0,-1.0
MSFT,2024-03-07,409.1400146484375,409.7799987792969,402.239990234375,406.1199951171875,18718500.0,7.050018310546875,0.0,7.050018310546875,51.81019826278547,397.2200012207031,417.3500061035156,59.21515417967921,-40.78484582032079,2.2598050102747607,3.4484904740401494,-0.0029243595558864355,947050800.0,1.0
MSFT,2024-03-08,406.2200012207031,410.4200134277344,404.3299865722656,407.9599914550781,17971700.0,-2.920013427734375,2.920013427734375,0.0,46.596775445360024,397.2200012207031,417.3500061035156,44.70937812680028,-55.29062187319972,1.927748067338655,3.1443419926998506,-0.0032389637742112898,929079100.0,-1.0
MSFT,2024-03-11,404.5199890136719,405.6799926757813,401.260009765625,403.760009765625,16120800.0,-1.70001220703125,1.70001220703125,0.0,43.6464385888543,397.2200012207031,417.3500061035156,36.26421272854067,-63.73578727145932,1.5100073454763674,2.8174750632551544,-0.007264213931602037,912958300.0,-1.0
MSFT,2024-03-12,415.2799987792969,415.5700073242188,406.7900085449219,407.6199951171875,22457000.0,10.760009765625,0.0,10.760009765625,61.46519633927048,398.3900146484375,417.3500061035156,89.08223493073183,-10.917765069268173,2.0238579025801755,2.658751631120159,0.018542130717059013,935415300.0,1.0
MSFT,2024-03-13,415.1000061035156,418.1799926757813,411.4500122070313,418.1000061035156,17115900.0,-0.17999267578125,0.17999267578125,0.0,61.092347373337894,398.3900146484375,418.1799926757813,84.43663470464664,-15.563365295353362,2.3890250725840474,2.604806319412937,0.0035296185170068384,918299400.0,-1.0
MSFT,2024-03-14,425.2200012207031,427.8200073242188,417.989990234375,420.239990234375,34157300.0,10.1199951171875,0.0,10.1199951171875,72.07977377530422,398.3900146484375,427.8200073242188,91.16545446626871,-8.834545533731285,3.455192408031337,2.7748835371366174,0.023393504742967863,952456700.0,1.0
MSFT,2024-03-15,416.4200134277344,422.6000061035156,412.7900085449219,419.2900085449219,45049800.0,-8.79998779296875,8.79998779296875,0.0,56.16568767616659,398.3900146484375,427.8200073242188,61.264027408794504,-38.735972591205496,3.5491399562158676,2.9297348209524676,0.0036151546116278688,907406900.0,-1.0
MSFT,2024-03-18,417.3200073242188,420.7300109863281,413.7799987792969,414.25,20106000.0,0.8999938964844318,0.0,0.8999938964844318,57.27874540039793,398.3900146484375,427.8200073242188,64.3221114062977,-35.67788859370229,3.6540939306528912,3.0746066428925527,0.036433661120347294,927512900.0,1.0
MSFT,2024-03-19,421.4100036621094,421.6700134277344,415.5499877929688,417.8299865722656,19837900.0,4.089996337890568,0.0,4.089996337890568,62.29861113335106,398.3900146484375,427.8200073242188,78.21948604362248,-21.78051395637753,4.020948246061778,3.263874963526398,0.04804896291919558,947350800.0,1.0
MSFT,2024-03-20,425.2300109863281,425.9599914550781,420.6600036621094,422.0,17860100.0,3.82000732421875,0.0,3.82000732421875,66.53614563927707,398.3900146484375,427.8200073242188,91.1994665903466,-8.800533409653397,4.567276875210837,3.524555345863287,0.03932638158532664,965210900.0,1.0
MSFT,2024-03-21,429.3699951171875,430.8200073242188,427.1600036621094,429.8299865722656,21296200.0,4.139984130859375,0.0,4.139984130859375,70.65995900783977,398.3900146484375,430.8200073242188,95.5287926780379,-4.471207321962101,5.273518530992078,3.8743479828890455,0.0569888085936634,986507100.0,1.0
MSFT,2024-03-22,428.739990234375,429.8599853515625,426.0700073242188,429.7000122070313,17636500.0,-0.6300048828125,0.6300048828125,0.0,69.16340446658937,398.3900146484375,430.8200073242188,93.5861314843985,-6.413868515601491,5.716487888533777,4.2427759640179925,0.059873434882063536,968870600.0,-1.0
MSFT,2024-03-25,422.8599853515625,427.4100036621094,421.6099853515625,425.239990234375,18060500.0,-5.8800048828125,5.8800048828125,0.0,56.317993113844416,398.3900146484375,430.8200073242188,75.45475248102402,-24.54524751897599,5.529338273294684,4.500088425873331,0.018252712855294728,950810100.0,-1.0
MSFT,2024-03-26,421.6499938964844,425.989990234375,421.3500061035156,425.6099853515625,16725600.0,-1.209991455078125,1.209991455078125,0.0,53.93934685571759,401.260009765625,430.8200073242188,68.97830113294955,-31.021698867050436,5.223175145015148,4.6447057697016945,0.015779300642398297,934084500.0,-1.0
MSFT,2024-03-27,421.4299926757813,424.4500122070313,419.010009765625,424.4400024414063,16705000.0,-0.22000122070306816,0.22000122070306816,0.0,53.465598390630674,401.260009765625,430.8200073242188,68.23404795678816,-31.765952043211843,4.906230429811103,4.697010701723577,-0.008913053323083675,917379500.0,-1.0
MSFT,2024-03-28,420.7200012207031,421.8699951171875,419.1199951171875,420.9599914550781,21871200.0,-0.7099914550781818,0.7099914550781818,0.0,51.77236782851805,401.260009765625,430.8200073242188,65.83218221349492,-34.167817786505076,4.545362967866481,4.666681154952157,0.010326083411730469,895508300.0,-1.0
MSFT,2024-04-01,424.5700073242188,427.8900146484375,422.2200012207031,423.9500122070313,16316000.0,3.850006103515682,0.0,3.850006103515682,59.74830988487958,406.7900085449219,430.8200073242188,73.99084345611914,-26.009156543880867,4.517956036220369,4.6369361312057995,0.017372759208180932,911824300.0,1.0
MSFT,2024-04-02,421.4400024414063,422.3800048828125,417.8399963378906,420.1099853515625,17912000.0,-3.1300048828125,3.1300048828125,0.0,51.723968567406025,411.4500122070313,430.8200073242188,51.57456248148778,-48.42543751851222,4.1953096913021,4.54861084322506,7.118668051608878e-05,893912300.0,-1.0
MSFT,2024-04-03,420.4500122070313,423.260009765625,419.0899963378906,419.7300109863281,16502300.0,-0.989990234375,0.989990234375,0.0,49.307237940257764,412.7900085449219,430.8200073242188,42.484770830406724,-57.515229169593276,3.815740716429616,4.402036817865971,-0.011240972310984199,877410000.0,-1.0
MSFT,2024-04-04,417.8800048828125,428.6700134277344,417.5700073242188,424.989990234375,19370900.0,-2.570007324218807,2.570007324218807,0.0,43.25367849131785,412.7900085449219,430.8200073242188,28.230708166964757,-71.76929183303524,3.2698585624872294,4.175601166790223,-0.02676011450506466,858039100.0,-1.0
MSFT,2024-04-05,425.5199890136719,426.510009765625,418.3200073242188,420.010009765625,16544300.0,7.639984130859375,0.0,7.639984130859375,60.06930378253582,413.7799987792969,430.8200073242188,68.89662175594165,-31.103378244058348,3.4143671923446277,4.023354371901104,-0.007510382269083182,874583400.0,1.0
MSFT,2024-04-08,424.5899963378906,427.2799987792969,423.2999877929688,425.1700134277344,14272400.0,-0.92999267578125,0.92999267578125,0.0,57.669071648853595,415.5499877929688,430.8200073242188,59.20102804335971,-40.79897195664029,3.414488586987318,3.901581214918347,0.00409121469578122,860311000.0,-1.0
MSFT,2024-04-09,426.2799987792969,427.739990234375,421.6199951171875,426.4400024414063,12512300.0,1.69000244140625,0.0,1.69000244140625,60.94151231887297,417.5700073242188,430.8200073242188,65.73578456662693,-34.26421543337307,3.510487155472049,3.8233624030290874,0.010980682911972739,872823300.0,1.0
MSFT,2024-04-10,423.260009765625,424.0299987792969,419.7000122070313,422.1900024414063,16216600.0,-3.019989013671875,3.019989013671875,0.0,52.56311384838513,417.5700073242188,430.8200073242188,42.943414652122215,-57.056585347877785,3.304783352989432,3.7196465930211566,0.004342398789000335,856606700.0,-1.0
MSFT,2024-04-11,427.9299926757813,429.3699951171875,422.3599853515625,425.8200073242188,17966400.0,4.669982910156307,0.0,4.669982910156307,61.907401825433055,417.5700073242188,429.8599853515625,84.29620727158994,-15.70379272841006,3.4784923056666344,3.671415735550252,0.017137268097924263,874573100.0,1.0
MSFT,2024-04-12,421.8999938964844,425.1799926757813,419.7699890136719,424.0499877929688,19232100.0,-6.029998779296932,6.029998779296932,0.0,47.86108599180261,417.5700073242188,429.3699951171875,36.69483942047546,-63.30516057952455,3.093922581858237,3.555917104811849,-0.006288747159889474,855341000.0,-1.0
MSFT,2024-04-15,413.6400146484375,426.8200073242188,413.4299926757813,426.6000061035156,20273500.0,-8.259979248046875,8.259979248046875,0.0,35.22782816046217,413.4299926757813,429.3699951171875,1.3175780457262305,-98.68242195427376,2.098447415704186,3.264423166990316,-0.018507943592880105,835067500.0,-1.0
MSFT,2024-04-16,414.5799865722656,418.3999938964844,413.7300109863281,414.5700073242188,16765600.0,0.939971923828125,0.0,0.939971923828125,37.39756889380736,413.4299926757813,429.3699951171875,7.2145151841198105,-92.7854848158802,1.3695863145987914,2.8854557965120113,-0.01396129257780887,851833100.0,1.0
MSFT,2024-04-17,411.8399963378906,418.8800048828125,410.3299865722656,417.25,15855500.0,-2.739990234375,2.739990234375,0.0,33.6107101038134,410.3299865722656,429.3699951171875,7.93071999974355,-92.06928000025644,0.5643587515650097,2.4212363875226113,-0.014453930492835387,835977600.0,-1.0
MSFT,2024-04-18,404.2699890136719,411.8900146484375,403.9500122070313,410.6300048828125,21029900.0,-7.57000732421875,7.57000732421875,0.0,25.408798840085126,403.9500122070313,429.3699951171875,1.2587609038585386,-98.74123909614147,-0.6768242111663199,1.8016242677848249,-0.04993889957850428,814947700.0,-1.0
MSFT,2024-04-19,399.1199951171875,405.4800109863281,397.7699890136719,404.0299987792969,30276500.0,-5.149993896484375,5.149993896484375,0.0,21.324049733505703,397.7699890136719,429.3699951171875,4.2721703884906255,-95.72782961150938,-2.0523736328415225,1.0308246876595553,-0.059987285240780786,784671200.0,-1.0
MSFT,2024-04-22,400.9599914550781,402.8500061035156,395.75,400.0799865722656,20286900.0,1.839996337890625,0.0,1.839996337890625,26.214094277271982,395.75,429.3699951171875,15.496704972496051,-84.50329502750394,-2.9599140857429234,0.23267693297905925,-0.059397596407820163,804958100.0,1.0
MSFT,2024-04-23,407.5700073242188,408.2000122070313,403.05999755859375,404.239990234375,15734500.0,6.610015869140682,0.0,6.610015869140682,41.32961758359645,395.75,429.3699951171875,35.15767115080895,-64.84232884919106,-3.1099241252556453,-0.43584327866788186,-0.03706941851202605,820692600.0,1.0
MSFT,2024-04-24,409.05999755859375,412.4700012207031,406.7799987792969,409.55999755859375,15065300.0,1.4899902343749432,0.0,1.4899902343749432,44.29754280737601,395.75,429.3699951171875,39.5895285296734,-60.4104714703266,-3.073153007883775,-0.9633052245110606,-0.044095986353273164,835757900.0,1.0
MSFT,2024-04-25,399.0400085449219,399.8900146484375,388.0299987792969,394.0299987792969,40586500.0,-10.019989013671875,10.019989013671875,0.0,31.810981888615714,388.0299987792969,429.3699951171875,26.632827143077552,-73.36717285692245,-3.8086374041060935,-1.5323716604300675,-0.05418342185890468,795171400.0,-1.0
MSFT,2024-04-26,406.3200073242188,413.0,405.760009765625,412.1700134277344,29694700.0,7.279998779296932,0.0,7.279998779296932,44.84455675111496,388.0299987792969,429.3699951171875,44.24288864331133,-55.75711135668867,-3.7607276990473792,-1.9780428681535303,-0.01769656480270687,824866100.0,1.0
MSFT,2024-04-29,402.25,406.3200073242188,399.1900024414063,405.25,19582100.0,-4.070007324218807,4.070007324218807,0.0,39.92217694735904,388.0299987792969,429.3699951171875,34.39768379386533,-65.60231620613467,-4.0050072585653425,-2.383435746235893,-0.029740911215250798,805284000.0,-1.0
MSFT,2024-04-30,389.3299865722656,402.1600036621094,389.1700134277344,401.489990234375,28781400.0,-12.920013427734375,12.920013427734375,0.0,28.474127608670656,388.0299987792969,429.3699951171875,3.1446248382398427,-96.85537516176016,-5.181409611299614,-2.9430305192486377,-0.05465717260534564,776502600.0,-1.0
MSFT,2024-05-01,394.9400024414063,401.7200012207031,390.30999755859375,392.6099853515625,23562500.0,5.610015869140682,0.0,5.610015869140682,37.459347624083364,388.0299987792969,426.8200073242188,17.813875070708207,-82.1861249292918,-5.596522329877416,-3.4737288813743943,-0.02307860297774922,800065100.0,1.0
MSFT,2024-05-02,397.8399963378906,399.9299926757813,394.6499938964844,397.6600036621094,17709400.0,2.899993896484318,0.0,2.899993896484318,41.818773759001104,388.0299987792969,426.8200073242188,25.290011336896175,-74.70998866310383,-5.626636515597625,-3.904310408219041,-0.003207052502897101,817774500.0,1.0
MSFT,2024-05-03,406.6600036621094,407.1499938964844,401.8599853515625,402.2799987792969,17446700.0,8.82000732421875,0.0,8.82000732421875,53.253711831128655,388.0299987792969,418.8800048828125,60.388982810247974,-39.611017189752026,-4.882518709137628,-4.099952068402759,0.014215912630948457,835221200.0,1.0
MSFT,2024-05-06,413.5400085449219,413.9299926757813,406.3699951171875,408.760009765625,16996600.0,6.8800048828125,0.0,6.8800048828125,60.28002661930928,388.0299987792969,418.8800048828125,82.69045289659736,-17.309547103402632,-3.6950468905285447,-4.018971032827916,0.014647793295432532,852217800.0,1.0
MSFT,2024-05-07,409.3399963378906,414.6700134277344,409.0899963378906,414.6600036621094,20018200.0,-4.20001220703125,4.20001220703125,0.0,54.50893606187914,388.0299987792969,414.6700134277344,79.99243934291017,-20.007560657089833,-3.0576263894380986,-3.8267021041499523,0.0006844931818510425,832199600.0,-1.0
MSFT,2024-05-08,410.5400085449219,412.2300109863281,406.7099914550781,408.1700134277344,11792300.0,1.20001220703125,0.0,1.20001220703125,55.900804349291455,388.0299987792969,414.6700134277344,84.4969871927051,-15.503012807294889,-2.4276506482571563,-3.5468918129713933,0.028819165381271272,843991900.0,1.0
MSFT,2024-05-09,412.3200073242188,412.7200012207031,409.1000061035156,410.5700073242188,14689700.0,1.7799987792969318,0.0,1.7799987792969318,58.09521359493493,388.0299987792969,414.6700134277344,91.17866061814121,-8.821339381858792,-1.7644201717953933,-3.1903974847361933,0.014766686089401349,858681600.0,1.0
MSFT,2024-05-10,414.739990234375,415.3800048828125,411.7999877929688,412.9400024414063,13402300.0,2.419982910156193,0.0,2.419982910156193,61.1294417595929,388.0299987792969,415.3800048828125,97.65991039996429,-2.3400896000357063,-1.0316407324833108,-2.758646134285617,0.03105031754972032,872083900.0,1.0
MSFT,2024-05-13,413.7200012207031,418.3500061035156,410.8200073242188,418.010009765625,15440200.0,-1.019989013671875,1.019989013671875,0.0,59.05005158739331,388.0299987792969,418.3500061035156,84.72953903571724,-15.270460964282767,-0.5271358425746371,-2.3123440759434213,0.06264612408402392,856643700.0,-1.0
MSFT,2024-05-14,416.55999755859375,417.489990234375,411.5499877929688,412.0199890136719,15109300.0,2.839996337890625,0.0,2.839996337890625,63.084335349064766,388.0299987792969,418.3500061035156,94.09627931226761,-5.903720687732379,0.10069118180183523,-1.82973702439437,0.054742479828679746,871753000.0,1.0
MSFT,2024-05-15,423.0799865722656,423.80999755859375,417.2699890136719,417.8999938964844,22239500.0,6.519989013671875,0.0,6.519989013671875,70.72438388438566,389.1700134277344,423.80999755859375,97.89257701859688,-2.107422981403122,1.1115440574688478,-1.2414808080217263,0.06344256602329734,893992500.0,1.0
MSFT,2024-05-16,420.989990234375,425.4200134277344,420.3500061035156,421.7999877929688,17530100.0,-2.089996337890625,2.089996337890625,0.0,65.6955429409361,389.1700134277344,425.4200134277344,87.77924636314656,-12.220753636853448,1.7241322828751322,-0.6483581898423545,0.0352382492579042,876462400.0,-1.0
MSFT,2024-05-17,420.2099914550781,422.9200134277344,418.0299987792969,422.5400085449219,15352200.0,-0.779998779296875,0.779998779296875,0.0,63.74375480712268,389.1700134277344,425.4200134277344,85.62752559267241,-14.372474407327587,2.1222099667352836,-0.09424455852682673,0.016128990599060034,861110200.0,-1.0
MSFT,2024-05-20,425.3399963378906,426.7699890136719,419.989990234375,420.2099914550781,16272100.0,5.1300048828125,0.0,5.1300048828125,70.41416272844937,390.30999755859375,426.7699890136719,96.07791275117789,-3.92208724882211,2.819140621759118,0.48843247753036245,0.03908731163126489,877382300.0,1.0
MSFT,2024-05-21,429.0400085449219,432.9700012207031,424.8500061035156,426.8299865722656,21453300.0,3.70001220703125,0.0,3.70001220703125,74.34256607702659,394.6499938964844,432.9700012207031,89.7442799461642,-10.255720053835802,3.6281996230166556,1.1163859066276214,0.04506259953949332,898835600.0,1.0
MSFT,2024-05-22,430.5199890136719,432.4100036621094,427.1300048828125,430.0899963378906,18073700.0,1.47998046875,0.0,1.47998046875,75.82411283450575,401.8599853515625,432.9700012207031,92.1246835188486,-7.875316481151408,4.338791873668356,1.7608671000357687,0.044140428226035366,916909300.0,1.0
MSFT,2024-05-23,427.0,433.6000061035156,425.4200134277344,432.9700012207031,17211700.0,-3.519989013671875,3.519989013671875,0.0,65.45218424242663,406.3699951171875,433.6000061035156,75.76201454039291,-24.237985459607092,4.565281927946785,2.3217500656179726,0.029560712866624428,899697600.0,-1.0
MSFT,2024-05-24,430.1600036621094,431.05999755859375,424.4100036621094,427.1900024414063,11845800.0,3.160003662109375,0.0,3.160003662109375,69.73981989674434,406.7099914550781,433.6000061035156,87.20713809054716,-12.79286190945284,4.94278546000902,2.8459571444961824,0.03973702599076456,911543400.0,1.0
MSFT,2024-05-28,430.3200073242188,430.8200073242188,426.6000061035156,429.6300048828125,15718000.0,0.16000366210943184,0.0,0.16000366210943184,69.95765175607784,406.7099914550781,433.6000061035156,87.80216812010026,-12.197831879899736,5.194986121023646,3.3157629398016755,0.03303247994591607,927261400.0,1.0
MSFT,2024-05-29,429.1700134277344,430.9400024414063,425.6900024414063,425.6900024414063,15517100.0,-1.1499938964844318,1.1499938964844318,0.0,66.01656211153755,409.1000061035156,433.6000061035156,81.91839724170919,-18.081602758290817,5.241639705620173,3.7009382929653754,0.01439450470065795,911744300.0,-1.0
MSFT,2024-05-30,414.6700134277344,424.2999877929688,414.239990234375,424.2999877929688,28424800.0,-14.5,14.5,0.0,36.280828411707674,410.8200073242188,433.6000061035156,16.90081786577871,-83.0991821342213,4.061762716849671,3.7731031777422346,-0.015012178325480297,883319500.0,-1.0
MSFT,2024-05-31,415.1300048828125,416.75,404.510009765625,416.75,47995300.0,0.459991455078125,0.0,0.459991455078125,37.31435937439,404.510009765625,433.6000061035156,36.507378666647085,-63.492621333352915,3.1277642495075497,3.6440353920952977,-0.012089161789501812,931314800.0,1.0
MSFT,2024-06-03,413.5199890136719,416.4299926757813,408.9200134277344,415.5299987792969,17484700.0,-1.610015869140625,1.610015869140625,0.0,35.02031547609977,404.510009765625,433.6000061035156,30.972775463402506,-69.0272245365975,2.231920717162666,3.3616124571087713,-0.027789550538362517,913830100.0,-1.0
MSFT,2024-06-04,416.0700073242188,416.4400024414063,409.6799926757813,412.4299926757813,14348900.0,2.550018310546932,0.0,2.550018310546932,41.58360463272164,404.510009765625,433.6000061035156,39.738738445754116,-60.261261554245884,1.7080342739484422,3.0308968204767055,-0.0302302838019477,928179000.0,1.0
MSFT,2024-06-05,424.010009765625,424.0799865722656,416.2999877929688,417.80999755859375,16988000.0,7.940002441406193,0.0,7.940002441406193,57.137697313162285,404.510009765625,433.6000061035156,67.0333532307828,-32.96664676921721,1.9115076624945573,2.807018988880276,-0.015121200906283883,945167000.0,1.0
MSFT,2024-06-06,424.5199890136719,425.30999755859375,420.5799865722656,424.010009765625,14861300.0,0.509979248046875,0.0,0.509979248046875,57.967125506505056,404.510009765625,433.6000061035156,68.78646190127998,-31.213538098720022,2.0898226771541886,2.6635797265350587,-0.005807988258379693,960028300.0,1.0
MSFT,2024-06-07,423.8500061035156,426.2799987792969,423.0,426.2000122070313,13621700.0,-0.66998291015625,0.66998291015625,0.0,56.31520889118004,404.510009765625,433.6000061035156,66.48332338460861,-33.5166766153914,2.1522665997706554,2.561317101182178,-0.014668954586373517,946406600.0,-1.0
MSFT,2024-06-10,427.8699951171875,428.0799865722656,423.8900146484375,424.7000122070313,14003000.0,4.019989013671875,0.0,4.019989013671875,63.51375200613986,404.510009765625,433.6000061035156,80.30246920703593,-19.697530792964066,2.4973455305491825,2.548522787055579,-0.005693465712332979,960409600.0,1.0
MSFT,2024-06-11,432.6799926757813,432.8200073242188,425.25,425.4800109863281,14551100.0,4.809997558593807,0.0,4.809997558593807,70.27597973232905,404.510009765625,433.6000061035156,96.83735461136524,-3.162645388634759,3.1229502470236525,2.663408279049194,0.008178528644191774,974960700.0,1.0
MSFT,2024-06-12,441.05999755859375,443.3999938964844,433.25,435.3200073242188,22366200.0,8.380004882812443,0.0,8.380004882812443,78.34425948080805,404.510009765625,443.3999938964844,93.98303601766239,-6.016963982337621,4.245997633807406,2.9799261500008365,0.0636409271862104,997326900.0,1.0
MSFT,2024-06-13,441.5799865722656,443.3900146484375,439.3699951171875,440.8500061035156,15960600.0,0.519989013671875,0.0,0.519989013671875,78.75710250961706,404.510009765625,443.3999938964844,95.32011296766109,-4.6798870323389155,5.118971232705235,3.4077351665417166,0.06371493599196643,1013287500.0,1.0
MSFT,2024-06-14,442.5700073242188,443.1400146484375,436.7200012207031,438.2799987792969,13582000.0,0.9900207519531818,0.0,0.9900207519531818,79.61100026803223,404.510009765625,443.3999938964844,97.86580892017652,-2.134191079823481,5.823565066952426,3.8909011466238588,0.07025057816391667,1026869500.0,1.0
MSFT,2024-06-17,448.3699951171875,450.9400024414063,440.7200012207031,442.5899963378906,20790000.0,5.799987792968693,0.0,5.799987792968693,83.96739245257591,404.510009765625,450.9400024414063,94.46476905097732,-5.535230949022672,6.771908948300904,4.467102706959269,0.07763113712688074,1047659500.0,1.0
MSFT,2024-06-18,446.3399963378906,450.1400146484375,444.8900146484375,449.7099914550781,17112500.0,-2.029998779296875,2.029998779296875,0.0,77.29758100012876,404.510009765625,450.9400024414063,90.09259782650122,-9.907402173498781,7.275803437637933,5.028842853095002,0.05266381938626563,1030547000.0,-1.0
MSFT,2024-06-20,445.7000122070313,446.5299987792969,441.2699890136719,446.2999877929688,19877400.0,-0.6399841308593182,0.6399841308593182,0.0,75.1267849178549,404.510009765625,450.9400024414063,88.71421266213494,-11.285787337865056,7.5366245634301094,5.5303991951620235,0.04989169825093276,1010669600.0,-1.0
MSFT,2024-06-21,449.7799987792969,450.5799865722656,446.510009765625,447.3800048828125,34486200.0,4.079986572265568,0.0,4.079986572265568,79.385376316207,408.9200134277344,450.9400024414063,97.23940036792489,-2.7605996320751167,7.980553154206746,6.020429986970969,0.061177285130080694,1045155800.0,1.0
MSFT,2024-06-24,447.6700134277344,452.75,446.4100036621094,449.7999877929688,15913700.0,-2.1099853515625,2.1099853515625,0.0,72.02675414831569,409.6799926757813,452.75,88.20528045415702,-11.79471954584298,8.069096060198092,6.430163201616394,0.046275781280535666,1029242100.0,-1.0
MSFT,2024-06-25,450.9500122070313,451.4200134277344,446.75,448.25,16747500.0,3.279998779296932,0.0,3.279998779296932,76.01465313083727,416.2999877929688,452.75,95.06176353866495,-4.938236461335056,8.308164096457801,6.805763380584676,0.04222524692732943,1045989600.0,1.0
MSFT,2024-06-26,452.1600036621094,453.6000061035156,448.1900024414063,449.0,16507000.0,1.2099914550780682,0.0,1.2099914550780682,77.38685730967154,420.5799865722656,453.6000061035156,95.63900184842883,-4.360998151571165,8.497311715625244,7.144073047592789,0.025166657971608553,1062496600.0,1.0
MSFT,2024-06-27,452.8500061035156,456.1700134277344,451.7699890136719,452.1799926757813,14806300.0,0.69000244140625,0.0,0.69000244140625,78.20721217008825,423.0,456.1700134277344,89.99093765381838,-10.009062346181624,8.60371176339703,7.4360007907536385,0.02552203422698751,1077302900.0,1.0
MSFT,2024-06-28,446.9500122070313,455.3800048828125,446.4100036621094,453.0700073242188,28362300.0,-5.899993896484318,5.899993896484318,0.0,57.59325748231596,423.8900146484375,456.1700134277344,71.43741769093121,-28.562582309068784,8.1183708431181,7.572474801226531,0.009896750367911267,1048940600.0,-1.0
MSFT,2024-07-01,456.7300109863281,457.3699951171875,445.6600036621094,448.6600036621094,17662800.0,9.779998779296818,0.0,9.779998779296818,71.80661932452198,425.25,457.3699951171875,98.00752108297515,-1.9924789170248587,8.425771781497417,7.743134197280709,0.01864535084903629,1066603400.0,1.0
MSFT,2024-07-02,459.2799987792969,459.5899963378906,453.1099853515625,453.2000122070313,13979800.0,2.54998779296875,0.0,2.54998779296875,74.38908307473221,433.25,459.5899963378906,98.82309186904551,-1.1769081309544913,8.774010610931782,7.949309480010925,0.028991357591916067,1080583200.0,1.0
MSFT,2024-07-03,460.7699890136719,461.0199890136719,457.8800048828125,458.1900024414063,9932800.0,1.489990234375,0.0,1.489990234375,75.87872073308185,436.7200012207031,461.0199890136719,98.97119289881974,-1.0288071011802649,9.06571819558485,8.17259122312571,0.0338119281891347,1090516000.0,1.0
MSFT,2024-07-05,467.55999755859375,468.3500061035156,458.9700012207031,459.6099853515625,16000300.0,6.790008544921875,0.0,6.790008544921875,81.52811153600717,436.7200012207031,468.3500061035156,97.50234453693948,-2.497655463060518,9.732604099445382,8.484593798389644,0.03953043449586868,1106516300.0,1.0
MSFT,2024-07-08,466.239990234375,467.7000122070313,464.4599914550781,466.5499877929688,12962300.0,-1.32000732421875,1.32000732421875,0.0,77.45875518905922,440.7200012207031,468.3500061035156,92.36331706023991,-7.6366829397601,10.038880458664039,8.795451130444524,0.0414813953350448,1093554000.0,-1.0
MSFT,2024-07-09,459.5400085449219,467.3299865722656,458.0,467.0,17207200.0,-6.699981689453125,6.699981689453125,0.0,59.93759582707146,441.2699890136719,468.3500061035156,67.46679468714994,-32.53320531285006,9.629965899250351,8.96235408420569,0.019048666382887047,1076346800.0,-1.0
MSFT,2024-07-10,466.25,466.4599914550781,458.8599853515625,461.2200012207031,18196100.0,6.709991455078125,0.0,6.709991455078125,68.23947270939226,441.2699890136719,468.3500061035156,92.24518176429356,-7.754818235706446,9.73511801693246,9.116906870751045,0.03116152738803457,1094542900.0,1.0
MSFT,2024-07-11,454.7000122070313,464.7799987792969,451.5499877929688,462.9800109863281,23111200.0,-11.549987792968693,11.549987792968693,0.0,48.342861983988165,445.6600036621094,468.3500061035156,39.84137316982,-60.158626830180005,8.785194091267783,9.050564314854393,0.004085251360453235,1071431700.0,-1.0
MSFT,2024-07-12,453.5499877929688,456.3599853515625,450.6499938964844,454.3299865722656,16324300.0,-1.1500244140625,1.1500244140625,0.0,46.7759678147737,445.6600036621094,468.3500061035156,34.77295408510515,-65.22704591489486,7.849095688086663,8.810270589500847,0.014766697406152662,1055107400.0,-1.0
MSFT,2024-07-15,453.9599914550781,457.260009765625,451.4299926757813,453.2999877929688,14429400.0,0.41000366210931816,0.0,0.41000366210931816,47.47627949629368,445.6600036621094,468.3500061035156,36.57993345043617,-63.42006654956383,7.058943719174692,8.460005215435617,-0.006064894937094278,1069536800.0,1.0
MSFT,2024-07-16,449.5199890136719,454.2999877929688,446.6600036621094,454.2200012207031,17175700.0,-4.44000244140625,4.44000244140625,0.0,40.77283673256538,445.6600036621094,468.3500061035156,17.011833125758233,-82.98816687424177,6.00524675425487,7.9690535231994675,-0.021250674515689294,1052361100.0,-1.0
MSFT,2024-07-17,443.5199890136719,444.8500061035156,439.1799926757813,442.5899963378906,21778000.0,-6.0,6.0,0.0,33.41599277892077,439.1799926757813,468.3500061035156,14.87828021965934,-85.12171978034067,4.632632360038372,7.301769290567249,-0.03743733405234462,1030583100.0,-1.0
MSFT,2024-07-18,440.3699951171875,444.6499938964844,434.3999938964844,444.3399963378906,20794800.0,-3.149993896484375,3.149993896484375,0.0,30.123448167960774,434.3999938964844,468.3500061035156,17.584680630738337,-82.41531936926167,3.2531471265590426,6.492044857765609,-0.05815296985067431,1009788300.0,-1.0
MSFT,2024-07-19,437.1099853515625,441.1400146484375,432.0,433.1000061035156,20940400.0,-3.260009765625,3.260009765625,0.0,26.952210542174683,432.0,468.3500061035156,14.057729005630847,-85.94227099436915,1.8752231916571986,5.568680524543927,-0.06247856360019455,988847900.0,-1.0
MSFT,2024-07-22,442.9400024414063,444.6000061035156,438.9100036621094,441.7900085449219,15808800.0,5.830017089843807,0.0,5.830017089843807,39.98858441734373,432.0,468.3500061035156,30.096287770219206,-69.90371222978081,1.2393556806912898,4.7028155557734,-0.036123092211443164,1004656700.0,1.0
MSFT,2024-07-23,444.8500061035156,448.3900146484375,443.1000061035156,443.8999938964844,13107100.0,1.9100036621093182,0.0,1.9100036621093182,43.781238894573946,432.0,468.3500061035156,35.35076738892989,-64.64923261107012,0.8794101373884473,3.9381344720964093,-0.04589811023374668,1017763800.0,1.0
MSFT,2024-07-24,428.8999938964844,441.4800109863281,427.5899963378906,440.4500122070313,26805800.0,-15.95001220703125,15.95001220703125,0.0,27.211003157948554,427.5899963378906,468.3500061035156,3.213928470887016,-96.78607152911299,-0.684985893251735,3.0135103990267806,-0.05674074690545605,990958000.0,-1.0
MSFT,2024-07-25,418.3999938964844,429.7999877929688,417.510009765625,428.7999877929688,29943800.0,-10.5,10.5,0.0,21.13498818312347,417.510009765625,467.7000122070313,1.7732299015095205,-98.22677009849048,-2.7404530295852965,1.862717713304365,-0.07749971302508174,961014200.0,-1.0
MSFT,2024-07-26,425.2699890136719,428.9200134277344,417.2699890136719,418.2000122070313,23583800.0,6.8699951171875,0.0,6.8699951171875,32.511723545722376,417.2699890136719,467.3299865722656,15.980823791763546,-84.01917620823646,-3.771597722155434,0.735854626212405,-0.06319940739589447,984598000.0,1.0
MSFT,2024-07-29,426.7300109863281,432.1499938964844,424.7000122070313,431.5799865722656,15125800.0,1.46002197265625,0.0,1.46002197265625,34.81748957332695,417.2699890136719,466.4599914550781,19.231594842721876,-80.76840515727812,-4.4200244581491575,-0.29532119065990775,-0.05069847522765136,999723800.0,1.0
MSFT,2024-07-30,422.9200134277344,429.0499877929688,417.3599853515625,427.7200012207031,32687600.0,-3.80999755859375,3.80999755859375,0.0,31.56981741922391,417.2699890136719,464.7799987792969,11.892282156823448,-88.10771784317654,-5.181611883238247,-1.272579329175576,-0.046446555050988936,967036200.0,-1.0
MSFT,2024-07-31,418.3500061035156,421.7799987792969,412.2099914550781,420.5,42891400.0,-4.57000732421875,4.57000732421875,0.0,27.960244661888098,412.2099914550781,457.260009765625,13.629327753236522,-86.37067224676348,-6.083806468550733,-2.234824757050608,-0.05000338183306996,924144800.0,-1.0
MSFT,2024-08-01,417.1099853515625,427.4599914550781,413.0899963378906,420.7900085449219,30296400.0,-1.240020751953125,1.240020751953125,0.0,26.993948812919825,412.2099914550781,457.260009765625,10.876785582431637,-89.12321441756836,-6.8202419846231805,-3.151908202565123,-0.045755074627074066,893848400.0,-1.0
MSFT,2024-08-02,408.489990234375,415.0,404.3399963378906,412.489990234375,29437900.0,-8.6199951171875,8.6199951171875,0.0,21.135235877484533,404.3399963378906,454.2999877929688,8.306634520175741,-91.69336547982427,-8.007132760300351,-4.122953114112169,-0.07777579811520519,864410500.0,-1.0
MSFT,2024-08-05,395.1499938964844,401.0400085449219,385.5799865722656,389.1700134277344,40709200.0,-13.339996337890625,13.339996337890625,0.0,15.232007929872623,385.5799865722656,448.3900146484375,15.236432170692352,-84.76356782930765,-9.909942816513876,-5.280351054592511,-0.11172307862229447,823701300.0,-1.0
MSFT,2024-08-06,399.6099853515625,405.6700134277344,398.5,400.0,24946500.0,4.459991455078125,0.0,4.459991455078125,23.477178630257583,385.5799865722656,448.3900146484375,22.337195522794886,-77.66280447720511,-10.932031800703271,-6.410687203814664,-0.06829099781239689,848647800.0,1.0
MSFT,2024-08-07,398.4299926757813,410.0799865722656,397.4700012207031,408.6400146484375,20650900.0,-1.1799926757811932,1.1799926757811932,0.0,22.80016269188009,385.5799865722656,448.3900146484375,20.45852628489839,-79.5414737151016,-11.702362679253497,-7.4690222989024315,-0.047729449120507916,827996900.0,-1.0
MSFT,2024-08-08,402.6900024414063,405.8599853515625,399.9400024414063,402.4400024414063,20203000.0,4.260009765625,0.0,4.260009765625,31.07924507667147,385.5799865722656,448.3900146484375,27.240898297944998,-72.75910170205499,-11.832708170555009,-8.341759473232948,-0.05309565018833162,848199900.0,1.0
MSFT,2024-08-09,406.0199890136719,408.0499877929688,402.260009765625,404.0299987792969,19276700.0,3.329986572265568,0.0,3.329986572265568,37.15775723356896,385.5799865722656,448.3900146484375,32.542578100137064,-67.45742189986294,-11.534345074834903,-8.98027659355334,-0.04853190879354341,867476600.0,1.0
MSFT,2024-08-12,406.80999755859375,408.760009765625,404.239990234375,407.05999755859375,16762900.0,0.790008544921875,0.0,0.790008544921875,38.639168732706935,385.5799865722656,441.4800109863281,37.978536161403525,-62.02146383859648,-11.106118662070855,-9.405445007256843,-0.03809234691583918,884239500.0,1.0
MSFT,2024-08-13,414.010009765625,414.9500122070313,409.5700073242188,409.5899963378906,19414300.0,7.20001220703125,0.0,7.20001220703125,50.828656608424836,385.5799865722656,432.1499938964844,61.04792510645437,-38.952074893545635,-10.069688234847888,-9.538293652775053,-0.010374079776675704,903653800.0,1.0
MSFT,2024-08-14,416.8599853515625,417.7200012207031,412.4500122070313,414.7999877929688,18267000.0,2.8499755859375,0.0,2.8499755859375,54.9188602098106,385.5799865722656,432.1499938964844,67.1676913459056,-32.83230865409442,-8.915567332192722,-9.413748388658588,-0.0005993622995845715,921920800.0,1.0
MSFT,2024-08-15,421.0299987792969,421.1099853515625,417.6600036621094,419.7999877929688,20752100.0,4.170013427734375,0.0,4.170013427734375,60.47024348803352,385.5799865722656,432.1499938964844,76.12198117176473,-23.878018828235277,-7.577089003031745,-9.04641651153322,0.03069844756226936,942672900.0,1.0
MSFT,2024-08-16,418.4700012207031,421.3399963378906,417.2999877929688,420.6000061035156,22775600.0,-2.55999755859375,2.55999755859375,0.0,55.61872841412782,385.5799865722656,429.0499877929688,75.66140723449803,-24.338592765501968,-6.646291382260301,-8.566391485678636,0.059015583156829754,919897300.0,-1.0
MSFT,2024-08-19,421.5299987792969,421.75,416.4599914550781,418.9599914550781,15234000.0,3.05999755859375,0.0,3.05999755859375,60.040397734288064,385.5799865722656,427.4599914550781,85.84051579656116,-14.159484203438838,-5.597190405388972,-7.972551269620704,0.05485351775794567,935131300.0,1.0
MSFT,2024-08-20,424.7999877929688,425.8599853515625,421.6400146484375,421.7000122070313,16387600.0,3.269989013671932,0.0,3.269989013671932,64.41220241797642,385.5799865722656,427.4599914550781,93.64851157598365,-6.351488424016351,-4.450605725491641,-7.268162160794892,0.06618476420435004,951518900.0,1.0
MSFT,2024-08-21,424.1400146484375,426.3999938964844,421.7200012207031,424.0799865722656,16067300.0,-0.6599731445313068,0.6599731445313068,0.0,62.811873624328264,385.5799865722656,426.3999938964844,94.46355011625386,-5.53644988374614,-3.554212671853918,-6.525372263006698,0.05326681088923313,935451600.0,-1.0
MSFT,2024-08-22,415.5499877929688,426.7900085449219,414.6099853515625,424.3599853515625,19361900.0,-8.590026855468693,8.590026855468693,0.0,45.74365785062205,385.5799865722656,426.7900085449219,72.72503091745239,-27.274969082547607,-3.4966508812992743,-5.919627986665214,0.02347174778869321,916089700.0,-1.0
MSFT,2024-08-23,416.7900085449219,419.260009765625,412.0899963378906,416.9800109863281,18493800.0,1.2400207519530682,0.0,1.2400207519530682,48.09304333596636,397.4700012207031,426.7900085449219,65.89359651441883,-34.106403485581176,-3.3127857047112457,-5.39825953027442,0.024532364116470973,934583500.0,1.0
MSFT,2024-08-26,413.489990234375,417.2799987792969,411.3399963378906,416.3699951171875,13152800.0,-3.300018310546875,3.300018310546875,0.0,42.44881420184482,397.4700012207031,426.7900085449219,54.63842091348706,-45.36157908651294,-3.3942285717048435,-4.997453338560505,-0.001256055455143179,921430700.0,-1.0
MSFT,2024-08-27,413.8399963378906,414.3599853515625,410.25,412.8599853515625,13492900.0,0.350006103515625,0.0,0.350006103515625,43.26368855404409,399.9400024414063,426.7900085449219,51.769053023285316,-48.230946976714684,-3.391435703436912,-4.6762498115357864,-0.007244612387358185,934923600.0,1.0
MSFT,2024-08-28,410.6000061035156,415.0,407.30999755859375,414.8800048828125,14882700.0,-3.239990234375,3.239990234375,0.0,37.58024024132788,402.260009765625,426.7900085449219,33.9991714346497,-66.00082856535029,-3.609059478294739,-4.462811744887577,-0.024772564202126257,920040900.0,-1.0
MSFT,2024-08-29,413.1199951171875,422.0499877929688,410.6000061035156,414.9400024414063,17045200.0,2.519989013671875,0.0,2.519989013671875,44.16307179594403,404.239990234375,426.7900085449219,39.379147105433745,-60.62085289456625,-3.537408788237485,-4.277731153557559,-0.012784682505100342,937086100.0,1.0
MSFT,2024-08-30,417.1400146484375,417.489990234375,412.1300048828125,415.6000061035156,24298300.0,4.02001953125,0.0,4.02001953125,53.240064306565586,407.30999755859375,426.7900085449219,50.46207159093935,-49.53792840906065,-3.1202745381129375,-4.046239830468634,-0.010414405009304795,961384400.0,1.0
MSFT,2024-09-03,409.4400024414063,419.8800048828125,407.0299987792969,417.989990234375,19788534.0,-7.700012207031193,7.700012207031193,0.0,39.16787601127773,407.0299987792969,426.7900085449219,12.196368780656847,-87.80363121934315,-3.3721472585123706,-3.9114213160773814,-0.036158158646295346,941595866.0,-1.0
